,item_id,rank,price,del_price,rating,rating_count,time,coupon,real_price
0,3163296,1,62300,89000,0.0,0,2023-03-24T20:08,-6230,56070
1,3162405,2,62300,89000,0.0,0,2023-03-24T20:08,-6230,56070
2,3163289,3,62300,89000,0.0,0,2023-03-24T20:08,-6230,56070
3,3163293,4,62300,89000,0.0,0,2023-03-24T20:08,-6230,56070
4,2272830,5,35910,39900,97.0,17964,2023-03-24T20:08,-7182,28728
5,3071087,6,84550,89000,95.0,260,2023-03-24T20:08,-16910,67640
6,2086653,7,16900,0,97.0,38197,2023-03-24T20:08,0,16900
7,2660716,8,50400,72000,96.0,1884,2023-03-24T20:08,0,50400
8,1848166,9,34300,49000,97.0,40560,2023-03-24T20:08,0,34300
9,2392759,10,39680,49600,95.0,3834,2023-03-24T20:08,-7936,31744
10,2453556,11,39900,42000,97.0,6100,2023-03-24T20:08,-7980,31920
11,345889,12,29900,47900,95.0,9441,2023-03-24T20:08,0,29900
12,1503352,13,39900,42000,97.0,8272,2023-03-24T20:08,-7980,31920
13,2149254,14,37800,0,97.0,31928,2023-03-24T20:08,-5670,32130
14,2453552,15,39900,42000,97.0,2852,2023-03-24T20:08,-7980,31920
15,2375962,16,59000,62000,98.0,4986,2023-03-24T20:08,-8850,50150
16,1782641,17,39900,42000,97.0,2566,2023-03-24T20:08,-7980,31920
17,2396645,18,39900,59000,96.0,22838,2023-03-24T20:08,0,39900
18,3033496,19,129000,149000,99.0,47,2023-03-24T20:08,-12900,116100
19,2313388,20,85000,0,96.0,2029,2023-03-24T20:08,0,85000
20,1817394,21,59900,150000,93.0,6971,2023-03-24T20:08,0,59900
21,3071084,22,51300,54000,95.0,78,2023-03-24T20:08,-10260,41040
22,2392775,23,39680,49600,96.0,1246,2023-03-24T20:08,-7936,31744
23,1782647,24,39900,42000,97.0,3434,2023-03-24T20:08,-7980,31920
24,2038497,25,36000,45000,95.0,16057,2023-03-24T20:08,-7200,28800
25,2204747,26,71250,75000,97.0,2062,2023-03-24T20:08,-14250,57000
26,1582356,27,49200,82000,96.0,15881,2023-03-24T20:08,0,49200
27,1939099,28,29400,49000,97.0,11533,2023-03-24T20:08,0,29400
28,1549281,29,71250,75000,97.0,5695,2023-03-24T20:08,-14250,57000
29,2730861,30,39900,57000,94.0,167,2023-03-24T20:08,0,39900
30,2326935,31,55300,79000,96.0,12724,2023-03-24T20:08,-5530,49770
31,2562821,32,72800,91000,97.0,72,2023-03-24T20:08,0,72800
32,1828538,33,39900,69900,95.0,2846,2023-03-24T20:08,0,39900
33,1943792,34,34400,43000,96.0,5160,2023-03-24T20:08,0,34400
34,2122566,35,33800,0,97.0,14996,2023-03-24T20:08,-6760,27040
35,2354252,36,71250,75000,97.0,1728,2023-03-24T20:08,-14250,57000
36,2160438,37,44000,62000,95.0,232,2023-03-24T20:08,-6600,37400
37,2314616,38,39000,43000,97.0,7917,2023-03-24T20:08,0,39000
38,1706633,39,199000,0,97.0,2352,2023-03-24T20:08,0,199000
39,1498105,40,189000,0,97.0,1942,2023-03-24T20:08,0,189000
40,3061224,41,29500,59000,96.0,72,2023-03-24T20:08,0,29500
41,3034895,42,101150,119000,98.0,291,2023-03-24T20:08,0,101150
42,2442409,43,31200,78000,96.0,8612,2023-03-24T20:08,0,31200
43,2646350,44,59800,94000,95.0,3839,2023-03-24T20:08,-11960,47840
44,3160073,45,69000,98000,93.0,3,2023-03-24T20:08,-13800,55200
45,1620270,46,189000,0,95.0,52,2023-03-24T20:08,0,189000
46,3150516,47,79800,126000,92.0,8,2023-03-24T20:08,-15960,63840
47,996177,48,15900,0,95.0,77040,2023-03-24T20:08,0,15900
48,3071089,49,84550,89000,98.0,79,2023-03-24T20:08,-16910,67640
49,3080626,50,62100,69000,100.0,3,2023-03-24T20:08,-6210,55890
50,2377269,51,45000,0,97.0,3706,2023-03-24T20:08,0,45000
51,1417691,52,13900,0,97.0,18140,2023-03-24T20:08,0,13900
52,1201421,53,199000,0,93.0,85,2023-03-24T20:08,0,199000
53,3034894,54,87200,109000,98.0,69,2023-03-24T20:08,0,87200
54,2034137,55,31800,0,97.0,16515,2023-03-24T20:08,-4770,27030
55,2403601,56,32500,50000,96.0,2122,2023-03-24T20:08,0,32500
56,854337,57,33900,0,95.0,17048,2023-03-24T20:08,-3390,30510
57,2305840,58,59700,0,97.0,3795,2023-03-24T20:08,0,59700
58,2702542,59,178000,0,98.0,189,2023-03-24T20:08,-17800,160200
59,2996536,60,39900,59000,96.0,350,2023-03-24T20:08,0,39900
60,1382658,61,16900,0,94.0,47015,2023-03-24T20:08,0,16900
61,1944612,62,35800,59700,97.0,2745,2023-03-24T20:08,-1790,34010
62,2065712,63,59000,62000,98.0,6530,2023-03-24T20:08,-8850,50150
63,3163483,64,59000,0,0.0,0,2023-03-24T20:08,0,59000
64,1848855,65,169000,0,97.0,82,2023-03-24T20:08,0,169000
65,3011214,66,82900,117900,98.0,19,2023-03-24T20:08,0,82900
66,2877493,67,59800,92000,95.0,1276,2023-03-24T20:08,0,59800
67,1884943,68,29900,39000,96.0,18759,2023-03-24T20:08,0,29900
68,2065708,69,59000,62000,98.0,6376,2023-03-24T20:08,-8850,50150
69,1336398,70,40200,67000,96.0,18933,2023-03-24T20:08,0,40200
70,2758254,71,31050,69000,97.0,562,2023-03-24T20:08,0,31050
71,407067,72,29250,39000,95.0,21323,2023-03-24T20:08,-2925,26325
72,994588,73,39900,53000,93.0,5911,2023-03-24T20:08,-3990,35910
73,1763157,74,49400,52000,95.0,2574,2023-03-24T20:08,0,49400
74,2673212,75,71250,75000,97.0,858,2023-03-24T20:08,-14250,57000
75,2374814,76,62400,104000,98.0,1126,2023-03-24T20:08,-3120,59280
76,3135529,77,51300,54000,100.0,10,2023-03-24T20:08,-10260,41040
77,1848797,78,169000,0,97.0,57,2023-03-24T20:08,0,169000
78,1201419,79,199000,0,92.0,210,2023-03-24T20:08,0,199000
79,1841764,80,31200,39000,96.0,12941,2023-03-24T20:08,-3120,28080
80,2684358,81,109000,0,97.0,3142,2023-03-24T20:08,0,109000
81,3052036,82,59400,66000,95.0,94,2023-03-24T20:08,-5940,53460
82,1870700,83,39900,42000,93.0,1423,2023-03-24T20:08,-7980,31920
83,2851485,84,66900,68900,96.0,402,2023-03-24T20:08,-6690,60210
84,2065703,85,59000,62000,98.0,5298,2023-03-24T20:08,-8850,50150
85,1437470,86,169000,0,98.0,59,2023-03-24T20:08,0,169000
86,1608272,87,39800,65590,96.0,3995,2023-03-24T20:08,0,39800
87,2364804,88,239000,0,98.0,77,2023-03-24T20:08,0,239000
88,2194649,89,63000,79000,96.0,4195,2023-03-24T20:08,-6300,56700
89,3141464,90,42000,53000,100.0,2,2023-03-24T20:08,-8400,33600
90,1778404,1,42000,45000,96.0,66186,2023-03-24T20:08,0,42000
91,1856181,2,35910,39900,97.0,6765,2023-03-24T20:08,-7182,28728
92,2723218,3,69900,109000,97.0,1848,2023-03-24T20:08,-6990,62910
93,1558197,4,81900,0,97.0,31860,2023-03-24T20:08,-8190,73710
94,1576700,5,89000,129000,97.0,16238,2023-03-24T20:08,0,89000
95,2343198,6,119000,129000,97.0,4808,2023-03-24T20:08,0,119000
96,1790383,7,59000,86000,95.0,5041,2023-03-24T20:08,-5900,53100
97,1576682,8,245000,339000,97.0,8447,2023-03-24T20:08,-49000,196000
98,1593755,9,89360,111700,97.0,14328,2023-03-24T20:08,-17872,71488
99,2064545,10,74900,94000,97.0,10754,2023-03-24T20:08,-14980,59920
100,1530516,11,69900,79000,96.0,2112,2023-03-24T20:08,0,69900
101,945355,12,40250,57500,92.0,3943,2023-03-24T20:08,-8050,32200
102,1283757,13,75390,83900,96.0,26387,2023-03-24T20:08,-7539,67851
103,1817381,14,47900,69000,96.0,890,2023-03-24T20:08,0,47900
104,1530517,15,69900,79000,96.0,1912,2023-03-24T20:08,0,69900
105,3029209,16,78000,97500,98.0,43,2023-03-24T20:08,-23400,54600
106,2496650,17,43900,109000,96.0,625,2023-03-24T20:08,0,43900
107,1571879,18,79900,112900,96.0,6938,2023-03-24T20:08,-7990,71910
108,841230,19,154000,172000,96.0,7171,2023-03-24T20:08,0,154000
109,1618312,20,75390,83900,97.0,6920,2023-03-24T20:08,0,75390
110,1195307,21,87550,103000,96.0,12444,2023-03-24T20:08,-8755,78795
111,1571878,22,79900,112900,96.0,4533,2023-03-24T20:08,-7990,71910
112,3012082,23,59900,79000,97.0,741,2023-03-24T20:08,-5990,53910
113,3098417,24,189000,199000,97.0,427,2023-03-24T20:08,0,189000
114,2086731,25,95000,129000,97.0,2118,2023-03-24T20:08,-19000,76000
115,3025206,26,34900,49000,97.0,86,2023-03-24T20:08,0,34900
116,2352895,27,69520,86900,97.0,3423,2023-03-24T20:08,-13904,55616
117,2788216,28,146000,159000,98.0,75,2023-03-24T20:08,-7300,138700
118,2752332,29,84200,105300,95.0,2340,2023-03-24T20:08,0,84200
119,2718413,30,126650,149000,97.0,1315,2023-03-24T20:08,0,126650
120,3042936,31,90900,105000,97.0,261,2023-03-24T20:08,0,90900
121,2788219,32,146000,159000,96.0,234,2023-03-24T20:08,-7300,138700
122,3036129,33,79800,94000,95.0,1471,2023-03-24T20:08,-15960,63840
123,3010527,34,237150,279000,97.0,136,2023-03-24T20:08,0,237150
124,1108007,35,71790,79900,95.0,47742,2023-03-24T20:08,-7179,64611
125,1337094,36,69900,0,95.0,5193,2023-03-24T20:08,-6990,62910
126,3163607,37,189000,0,0.0,0,2023-03-24T20:08,0,189000
127,3019679,38,223200,248000,96.0,66,2023-03-24T20:08,-22320,200880
128,2288704,39,121000,132000,97.0,3108,2023-03-24T20:08,0,121000
129,2471405,40,99000,138000,97.0,1920,2023-03-24T20:08,0,99000
130,1833230,41,108800,136000,97.0,5321,2023-03-24T20:08,0,108800
131,2715055,42,159000,189000,97.0,1904,2023-03-24T20:08,0,159000
132,1778408,43,42000,45000,95.0,11466,2023-03-24T20:08,0,42000
133,2284220,44,79900,112900,96.0,1587,2023-03-24T20:08,0,79900
134,2683549,45,126650,149000,97.0,2476,2023-03-24T20:08,0,126650
135,3030665,46,139200,174000,96.0,137,2023-03-24T20:08,-13920,125280
136,2288426,47,79000,109000,94.0,758,2023-03-24T20:08,-7900,71100
137,2110493,48,389000,0,96.0,599,2023-03-24T20:08,0,389000
138,3029811,49,63200,79000,98.0,169,2023-03-24T20:08,-6320,56880
139,3079071,50,64900,87000,97.0,35,2023-03-24T20:08,-12980,51920
140,1337096,51,69900,0,96.0,2809,2023-03-24T20:08,-6990,62910
141,1139192,52,71100,94900,97.0,14246,2023-03-24T20:08,-7110,63990
142,2343199,53,119000,129000,98.0,1693,2023-03-24T20:08,0,119000
143,3090584,54,90000,119000,0.0,0,2023-03-24T20:08,-13500,76500
144,1633664,55,76300,109000,97.0,4032,2023-03-24T20:08,0,76300
145,1751722,56,53910,59900,97.0,3237,2023-03-24T20:08,-10782,43128
146,3058495,57,198000,220000,99.0,48,2023-03-24T20:08,0,198000
147,3031561,58,139200,174000,99.0,53,2023-03-24T20:08,-13920,125280
148,2732486,59,74000,179000,98.0,519,2023-03-24T20:08,0,74000
149,943145,60,49910,71300,93.0,6762,2023-03-24T20:08,-9982,39928
150,2102252,61,69900,129000,94.0,6180,2023-03-24T20:08,-13980,55920
151,3037473,62,69900,85900,97.0,87,2023-03-24T20:08,-6990,62910
152,3033224,63,59900,74000,97.0,442,2023-03-24T20:08,-5990,53910
153,3078900,64,148000,0,98.0,127,2023-03-24T20:08,0,148000
154,1280576,65,37200,62000,96.0,24973,2023-03-24T20:08,-7440,29760
155,2286964,66,66300,110500,97.0,4746,2023-03-24T20:08,-9945,56355
156,3030712,67,99200,124000,96.0,46,2023-03-24T20:08,-9920,89280
157,621582,68,225000,339000,96.0,4328,2023-03-24T20:08,-45000,180000
158,1776552,69,60000,69000,94.0,6008,2023-03-24T20:08,-6000,54000
159,2357957,70,126650,149000,97.0,2082,2023-03-24T20:08,0,126650
160,2297046,71,149000,199000,97.0,1627,2023-03-24T20:08,-7450,141550
161,2740342,72,148000,0,88.0,225,2023-03-24T20:08,-29600,118400
162,2723216,73,47900,109000,97.0,922,2023-03-24T20:08,0,47900
163,2668986,74,35910,39900,96.0,3268,2023-03-24T20:08,-7182,28728
164,3056018,75,62300,89000,97.0,211,2023-03-24T20:08,0,62300
165,2712632,76,107000,0,97.0,1245,2023-03-24T20:08,0,107000
166,3042244,77,159200,199000,97.0,36,2023-03-24T20:08,-31840,127360
167,1291017,78,67900,96000,95.0,12804,2023-03-24T20:08,0,67900
168,3029205,79,78000,97500,99.0,34,2023-03-24T20:08,-23400,54600
169,2293391,80,98000,124000,95.0,1712,2023-03-24T20:08,-19600,78400
170,406537,81,245000,339000,95.0,4392,2023-03-24T20:08,-49000,196000
171,2697873,82,107000,0,97.0,770,2023-03-24T20:08,0,107000
172,1737051,83,62300,89000,96.0,5005,2023-03-24T20:08,0,62300
173,2803667,84,597000,0,92.0,5,2023-03-24T20:08,0,597000
174,401149,85,38500,55000,93.0,24749,2023-03-24T20:08,-7700,30800
175,2375909,86,76290,89900,97.0,1450,2023-03-24T20:08,0,76290
176,3071114,87,131100,138000,89.0,52,2023-03-24T20:08,-26220,104880
177,2284226,88,69900,79000,96.0,406,2023-03-24T20:08,0,69900
178,1776365,89,71200,89000,96.0,4536,2023-03-24T20:08,-7120,64080
179,3081572,90,109000,0,97.0,18,2023-03-24T20:08,0,109000
180,3163311,1,63700,98000,0.0,0,2023-03-24T20:08,-5450,58250
181,3163314,2,63700,98000,0.0,0,2023-03-24T20:08,-5450,58250
182,3163309,3,63700,98000,0.0,0,2023-03-24T20:08,-5450,58250
183,3163360,4,63700,98000,0.0,0,2023-03-24T20:08,-5450,58250
184,2678417,5,33900,69000,96.0,274,2023-03-24T20:08,0,33900
185,1149329,6,39900,0,96.0,85084,2023-03-24T20:08,-3990,35910
186,1551840,7,39000,0,97.0,82428,2023-03-24T20:08,-3900,35100
187,2678415,8,33900,69000,97.0,284,2023-03-24T20:08,0,33900
188,750908,9,33900,54000,96.0,83213,2023-03-24T20:08,0,33900
189,1168906,10,41900,0,97.0,70268,2023-03-24T20:08,-4190,37710
190,2112059,11,33900,52000,97.0,41836,2023-03-24T20:08,0,33900
191,2678399,12,33900,69000,96.0,390,2023-03-24T20:08,0,33900
192,1149328,13,39900,0,96.0,94074,2023-03-24T20:08,-3990,35910
193,2060719,14,47800,69000,96.0,4723,2023-03-24T20:08,-4780,43020
194,2060717,15,55200,69000,95.0,3541,2023-03-24T20:08,-5520,49680
195,858911,16,39000,49000,95.0,66427,2023-03-24T20:08,-3900,35100
196,2112061,17,36400,52000,97.0,14120,2023-03-24T20:08,-3640,32760
197,1568057,18,43400,62000,96.0,21775,2023-03-24T20:08,0,43400
198,2028327,19,49900,0,96.0,8668,2023-03-24T20:08,-4990,44910
199,1552753,20,63960,78000,97.0,27878,2023-03-24T20:08,-6396,57564
200,1370101,21,39000,89000,96.0,22314,2023-03-24T20:08,0,39000
201,3065643,22,57600,72000,85.0,11,2023-03-24T20:08,-11520,46080
202,1222184,23,41900,0,97.0,47989,2023-03-24T20:08,-4190,37710
203,2261213,24,121500,135000,98.0,4017,2023-03-24T20:08,-6075,115425
204,3091296,25,129000,0,100.0,1,2023-03-24T20:08,0,129000
205,1555407,26,63960,78000,97.0,11317,2023-03-24T20:08,-6396,57564
206,2723714,27,49300,58000,96.0,1323,2023-03-24T20:08,0,49300
207,2569078,28,79000,0,96.0,2325,2023-03-24T20:08,0,79000
208,2028326,29,49900,0,97.0,5873,2023-03-24T20:08,-4990,44910
209,1551839,30,39000,0,97.0,22893,2023-03-24T20:08,-3900,35100
210,2060759,31,59800,74800,97.0,6999,2023-03-24T20:08,-8970,50830
211,1568032,32,43400,62000,96.0,5921,2023-03-24T20:08,0,43400
212,2060720,33,55200,69000,95.0,2394,2023-03-24T20:08,-5520,49680
213,890521,34,39800,63000,94.0,10817,2023-03-24T20:08,0,39800
214,2107115,35,121500,135000,98.0,11563,2023-03-24T20:08,-6075,115425
215,1736085,36,39900,59800,96.0,35983,2023-03-24T20:08,0,39900
216,2184087,37,49000,89000,96.0,3887,2023-03-24T20:08,-4900,44100
217,1582583,38,30380,43400,96.0,12290,2023-03-24T20:08,-6076,24304
218,3011537,39,44910,49900,97.0,133,2023-03-24T20:08,-8982,35928
219,2789091,40,84150,99000,96.0,592,2023-03-24T20:08,0,84150
220,2737165,41,59800,79000,96.0,2485,2023-03-24T20:08,-8970,50830
221,2069525,42,41900,0,96.0,3595,2023-03-24T20:08,-4190,37710
222,2358429,43,135150,159000,98.0,2522,2023-03-24T20:08,-13515,121635
223,890338,44,39000,49000,95.0,47370,2023-03-24T20:08,-3900,35100
224,3070909,45,125100,139000,100.0,3,2023-03-24T20:08,0,125100
225,2060743,46,33000,55000,95.0,3361,2023-03-24T20:08,-1650,31350
226,2351467,47,39800,54000,96.0,5762,2023-03-24T20:08,-3980,35820
227,2049103,48,63960,78000,97.0,7005,2023-03-24T20:08,-6396,57564
228,3098372,49,109000,139000,97.0,629,2023-03-24T20:08,0,109000
229,1168922,50,43900,0,96.0,17973,2023-03-24T20:08,-4390,39510
230,2678410,51,33900,69000,96.0,153,2023-03-24T20:08,0,33900
231,1666442,52,49900,0,97.0,10753,2023-03-24T20:08,0,49900
232,732703,53,116100,129000,97.0,3876,2023-03-24T20:08,0,116100
233,1924274,54,49900,66000,95.0,22335,2023-03-24T20:08,-4990,44910
234,1212776,55,28690,31900,96.0,22964,2023-03-24T20:08,0,28690
235,2032901,56,39900,0,97.0,6605,2023-03-24T20:08,-3990,35910
236,1985223,57,39000,89000,96.0,1469,2023-03-24T20:08,0,39000
237,3050854,58,229000,0,96.0,5,2023-03-24T20:08,0,229000
238,3022892,59,39000,49000,96.0,261,2023-03-24T20:08,-3900,35100
239,1477272,60,44200,68000,96.0,17539,2023-03-24T20:08,-2210,41990
240,1224095,61,35890,39900,97.0,24169,2023-03-24T20:08,-3589,32301
241,2789111,62,84150,99000,97.0,684,2023-03-24T20:08,0,84150
242,3046898,63,69900,89000,95.0,8,2023-03-24T20:08,-6990,62910
243,3043508,64,75650,89000,98.0,58,2023-03-24T20:08,-7565,68085
244,2092849,65,42000,52800,96.0,9568,2023-03-24T20:08,-4200,37800
245,2028329,66,49900,0,95.0,6308,2023-03-24T20:08,-4990,44910
246,3065628,67,57600,72000,97.0,9,2023-03-24T20:08,-11520,46080
247,1595607,68,57900,89000,97.0,5551,2023-03-24T20:08,-5790,52110
248,2562527,69,29400,42000,97.0,3813,2023-03-24T20:08,-4410,24990
249,3034429,70,75650,89000,98.0,59,2023-03-24T20:08,-3783,71867
250,3141395,71,49900,73900,97.0,32,2023-03-24T20:08,-4990,44910
251,2980254,72,44910,49900,97.0,88,2023-03-24T20:08,-8982,35928
252,2678414,73,33900,69000,96.0,91,2023-03-24T20:08,0,33900
253,3098405,74,119000,149000,97.0,619,2023-03-24T20:08,0,119000
254,1627892,75,43900,0,97.0,10227,2023-03-24T20:08,0,43900
255,1582589,76,30380,43400,96.0,2698,2023-03-24T20:08,-6076,24304
256,2150457,77,119250,159000,97.0,3644,2023-03-24T20:08,-11925,107325
257,2706287,78,39800,54000,95.0,3406,2023-03-24T20:08,-3980,35820
258,2131950,79,39000,49000,97.0,3538,2023-03-24T20:08,-3900,35100
259,3053919,80,122000,144000,98.0,53,2023-03-24T20:08,-12200,109800
260,1926048,81,32000,0,97.0,14464,2023-03-24T20:08,-3200,28800
261,2340396,82,68600,98000,96.0,3171,2023-03-24T20:08,-6860,61740
262,2569079,83,59250,79000,96.0,1049,2023-03-24T20:08,0,59250
263,3034428,84,75650,89000,98.0,43,2023-03-24T20:08,-3783,71867
264,2709031,85,36700,52800,96.0,3344,2023-03-24T20:08,-3670,33030
265,1740894,86,143100,159000,97.0,1066,2023-03-24T20:08,0,143100
266,1100326,87,57900,89000,95.0,36907,2023-03-24T20:08,-5790,52110
267,3163603,88,139000,0,0.0,0,2023-03-24T20:08,0,139000
268,1539028,89,44500,89000,95.0,4657,2023-03-24T20:08,0,44500
269,3090588,90,60000,79000,0.0,0,2023-03-24T20:08,-9000,51000
270,2911059,1,440000,650000,98.0,41,2023-03-24T20:08,-30000,410000
271,1789507,2,79000,0,98.0,25468,2023-03-24T20:08,0,79000
272,1969507,3,88000,0,98.0,5201,2023-03-24T20:08,0,88000
273,1034480,4,135000,150000,97.0,17840,2023-03-24T20:08,0,135000
274,2235274,5,145000,0,97.0,614,2023-03-24T20:08,0,145000
275,2344538,6,119000,0,98.0,6196,2023-03-24T20:08,0,119000
276,1264107,7,65000,90000,97.0,6158,2023-03-24T20:08,0,65000
277,2344540,8,96000,0,98.0,8997,2023-03-24T20:08,0,96000
278,2584181,9,57600,72000,98.0,737,2023-03-24T20:08,0,57600
279,2911052,10,239000,400000,100.0,8,2023-03-24T20:08,-30000,209000
280,1969488,11,88000,0,98.0,1663,2023-03-24T20:08,0,88000
281,1835080,12,98000,0,97.0,2657,2023-03-24T20:08,0,98000
282,2956514,13,2499000,3610000,80.0,1,2023-03-24T20:08,-30000,2469000
283,2343665,14,89000,0,97.0,4432,2023-03-24T20:08,0,89000
284,2789785,15,140600,148000,97.0,528,2023-03-24T20:08,-28120,112480
285,2789786,16,150100,158000,97.0,201,2023-03-24T20:08,-30020,120080
286,3045584,17,130500,145000,97.0,3735,2023-03-24T20:08,0,130500
287,3038000,18,66400,83000,97.0,215,2023-03-24T20:08,-9960,56440
288,2408317,19,145800,162000,97.0,328,2023-03-24T20:08,0,145800
289,3034751,20,61200,72000,97.0,282,2023-03-24T20:08,0,61200
290,3024801,21,138000,0,100.0,11,2023-03-24T20:08,0,138000
291,2271789,22,71100,79000,97.0,2418,2023-03-24T20:08,0,71100
292,3050557,23,2027000,3290000,0.0,0,2023-03-24T20:08,-30000,1997000
293,342189,24,39500,52000,95.0,15583,2023-03-24T20:08,0,39500
294,2998775,25,142200,158000,96.0,400,2023-03-24T20:08,-28440,113760
295,2066837,26,79000,119000,97.0,6308,2023-03-24T20:08,-7900,71100
296,1744101,27,103500,109000,98.0,2780,2023-03-24T20:08,0,103500
297,1842449,28,84000,99000,97.0,5255,2023-03-24T20:08,0,84000
298,693318,29,79000,110000,96.0,13078,2023-03-24T20:08,0,79000
299,2754080,30,88000,0,97.0,446,2023-03-24T20:08,0,88000
300,2954961,31,95000,0,97.0,333,2023-03-24T20:08,0,95000
301,2320927,32,39000,51000,97.0,1958,2023-03-24T20:08,0,39000
302,1564343,33,92800,119000,98.0,8017,2023-03-24T20:08,0,92800
303,1581689,34,75600,89000,97.0,3877,2023-03-24T20:08,0,75600
304,2911055,35,832000,1340000,100.0,16,2023-03-24T20:08,-30000,802000
305,2668408,36,1680000,2950000,93.0,3,2023-03-24T20:08,-30000,1650000
306,2777025,37,308000,485000,100.0,40,2023-03-24T20:08,-30000,278000
307,2760920,38,80100,89000,97.0,195,2023-03-24T20:08,-16020,64080
308,2558648,39,119000,0,98.0,1190,2023-03-24T20:08,0,119000
309,2812154,40,1535000,2290000,100.0,1,2023-03-24T20:08,-30000,1505000
310,3034749,41,61200,72000,97.0,312,2023-03-24T20:08,0,61200
311,2664933,42,90000,0,96.0,307,2023-03-24T20:08,0,90000
312,2624678,43,145000,0,96.0,130,2023-03-24T20:08,0,145000
313,3061872,44,80100,89000,89.0,11,2023-03-24T20:08,0,80100
314,2789787,45,140600,148000,96.0,304,2023-03-24T20:08,-28120,112480
315,2856863,46,1416000,2167000,0.0,0,2023-03-24T20:08,-30000,1386000
316,2422175,47,137700,162000,98.0,184,2023-03-24T20:08,0,137700
317,2930265,48,91000,0,98.0,495,2023-03-24T20:08,0,91000
318,1576725,49,137000,197000,97.0,5205,2023-03-24T20:08,-27400,109600
319,2630526,50,100000,0,96.0,579,2023-03-24T20:08,0,100000
320,2490327,51,1330000,2400000,0.0,0,2023-03-24T20:08,-30000,1300000
321,3142253,52,39900,49600,0.0,0,2023-03-24T20:08,-7980,31920
322,1447194,53,64900,230000,96.0,2749,2023-03-24T20:08,0,64900
323,3061988,54,80100,89000,0.0,0,2023-03-24T20:08,0,80100
324,1528287,55,46500,49000,96.0,4467,2023-03-24T20:08,0,46500
325,3061969,56,80100,89000,96.0,5,2023-03-24T20:08,0,80100
326,1534526,57,52200,55000,97.0,2346,2023-03-24T20:08,0,52200
327,1263004,58,159000,0,97.0,5218,2023-03-24T20:08,0,159000
328,1758217,59,43900,56000,97.0,13023,2023-03-24T20:08,-8780,35120
329,2110431,60,129000,0,99.0,21,2023-03-24T20:08,0,129000
330,1323612,61,238000,0,97.0,3788,2023-03-24T20:08,-11900,226100
331,2688604,62,159000,0,97.0,793,2023-03-24T20:08,0,159000
332,2514819,63,59000,66000,97.0,739,2023-03-24T20:08,-4130,54870
333,3082387,64,139000,0,97.0,88,2023-03-24T20:08,0,139000
334,2911054,65,1098000,1590000,96.0,27,2023-03-24T20:08,-30000,1068000
335,1456515,66,49500,55000,97.0,8655,2023-03-24T20:08,-4950,44550
336,3048786,67,1458000,3050000,0.0,0,2023-03-24T20:08,-30000,1428000
337,2515050,68,269000,0,0.0,0,2023-03-24T20:08,-26900,242100
338,1320752,69,69800,135000,97.0,4667,2023-03-24T20:08,0,69800
339,2392115,70,78400,98000,96.0,324,2023-03-24T20:08,0,78400
340,913402,71,83000,98000,95.0,7970,2023-03-24T20:08,0,83000
341,1597319,72,89100,99000,97.0,539,2023-03-24T20:08,-4455,84645
342,2702033,73,127200,159000,97.0,367,2023-03-24T20:08,0,127200
343,2325729,74,87200,109000,97.0,743,2023-03-24T20:08,-13080,74120
344,1964770,75,59400,66000,97.0,2419,2023-03-24T20:08,-5940,53460
345,2117334,76,318000,0,99.0,61,2023-03-24T20:08,0,318000
346,3166916,77,79200,88000,0.0,0,2023-03-24T20:08,0,79200
347,3034743,78,71400,84000,96.0,159,2023-03-24T20:08,0,71400
348,1749492,79,89100,99000,98.0,3800,2023-03-24T20:08,0,89100
349,3034750,80,61200,72000,98.0,102,2023-03-24T20:08,0,61200
350,3029920,81,275000,0,98.0,25,2023-03-24T20:08,0,275000
351,3161077,82,169200,188000,0.0,0,2023-03-24T20:08,0,169200
352,2599000,83,129000,0,98.0,76,2023-03-24T20:08,0,129000
353,2261685,84,125000,0,98.0,168,2023-03-24T20:08,0,125000
354,2979860,85,406000,520000,97.0,9,2023-03-24T20:08,-30000,376000
355,1969479,86,88000,0,98.0,1083,2023-03-24T20:08,0,88000
356,2744318,87,159000,0,98.0,258,2023-03-24T20:08,0,159000
357,2131513,88,399000,0,99.0,120,2023-03-24T20:08,0,399000
358,3011494,89,69900,79000,96.0,199,2023-03-24T20:08,-6990,62910
359,2395959,90,115200,128000,97.0,281,2023-03-24T20:08,-23040,92160
360,3136269,1,89100,99000,0.0,0,2023-03-24T20:08,0,89100
361,3136289,2,89100,99000,0.0,0,2023-03-24T20:08,0,89100
362,3136271,3,89100,99000,0.0,0,2023-03-24T20:08,0,89100
363,1622068,4,119000,0,97.0,6315,2023-03-24T20:08,0,119000
364,969541,5,69000,0,97.0,28982,2023-03-24T20:08,0,69000
365,577636,6,99900,139000,95.0,30897,2023-03-24T20:08,0,99900
366,1762407,7,260000,0,97.0,3005,2023-03-24T20:08,0,260000
367,2638067,8,99000,139000,97.0,2806,2023-03-24T20:08,0,99000
368,2293400,9,129000,0,96.0,827,2023-03-24T20:08,0,129000
369,3136286,10,89100,99000,0.0,0,2023-03-24T20:08,0,89100
370,3091287,11,119000,0,98.0,163,2023-03-24T20:08,0,119000
371,810034,12,85500,95000,97.0,44974,2023-03-24T20:08,0,85500
372,3030422,13,139000,0,96.0,732,2023-03-24T20:08,-13900,125100
373,311052,14,53100,59000,97.0,40892,2023-03-24T20:08,0,53100
374,1762406,15,260000,0,98.0,3184,2023-03-24T20:08,0,260000
375,2673444,16,39900,149000,95.0,134,2023-03-24T20:08,0,39900
376,1686571,17,59900,129000,97.0,5246,2023-03-24T20:08,0,59900
377,2741233,18,109000,0,97.0,2554,2023-03-24T20:08,0,109000
378,186610,19,75900,85000,97.0,16381,2023-03-24T20:08,0,75900
379,2320478,20,129000,0,97.0,412,2023-03-24T20:08,0,129000
380,181907,21,89900,119000,97.0,6987,2023-03-24T20:08,0,89900
381,2233180,22,75900,109000,97.0,14036,2023-03-24T20:08,0,75900
382,2383963,23,139000,0,97.0,93,2023-03-24T20:08,0,139000
383,695334,24,78900,99000,96.0,9110,2023-03-24T20:08,0,78900
384,3143330,25,84550,89000,0.0,0,2023-03-24T20:08,0,84550
385,816033,26,70900,89000,96.0,13116,2023-03-24T20:08,0,70900
386,1990244,27,129000,0,98.0,988,2023-03-24T20:08,0,129000
387,1744960,28,119900,149000,97.0,8179,2023-03-24T20:08,0,119900
388,1817778,29,69000,0,97.0,4039,2023-03-24T20:08,0,69000
389,3079037,30,195000,0,97.0,153,2023-03-24T20:08,0,195000
390,2861393,31,109900,139000,93.0,243,2023-03-24T20:08,0,109900
391,2622254,32,109000,0,98.0,818,2023-03-24T20:08,0,109000
392,2992063,33,280000,0,98.0,2048,2023-03-24T20:08,0,280000
393,2778805,34,99000,0,97.0,863,2023-03-24T20:08,0,99000
394,3033248,35,109000,0,97.0,532,2023-03-24T20:08,0,109000
395,3100522,36,129000,0,98.0,115,2023-03-24T20:08,0,129000
396,810033,37,89100,99000,97.0,34124,2023-03-24T20:08,0,89100
397,2161992,38,69900,95000,98.0,3092,2023-03-24T20:08,0,69900
398,1792640,39,99000,0,98.0,3367,2023-03-24T20:08,0,99000
399,2861395,40,109900,139000,96.0,457,2023-03-24T20:08,0,109900
400,2861392,41,124900,139000,97.0,528,2023-03-24T20:08,0,124900
401,2899656,42,109900,159000,94.0,66,2023-03-24T20:08,0,109900
402,2731878,43,67900,79000,96.0,1429,2023-03-24T20:08,0,67900
403,1608838,44,85000,0,97.0,12533,2023-03-24T20:08,0,85000
404,1900410,45,129000,0,97.0,4802,2023-03-24T20:08,0,129000
405,1494180,46,71100,79000,95.0,5183,2023-03-24T20:08,0,71100
406,2737457,47,230000,0,98.0,413,2023-03-24T20:08,0,230000
407,102620,48,69000,0,97.0,17661,2023-03-24T20:08,0,69000
408,490136,49,76000,95000,98.0,1933,2023-03-24T20:08,0,76000
409,2233178,50,75900,109000,97.0,4862,2023-03-24T20:08,0,75900
410,1812247,51,80100,89000,97.0,2992,2023-03-24T20:08,-4005,76095
411,2733049,52,47600,119000,96.0,406,2023-03-24T20:08,0,47600
412,2268512,53,109000,0,97.0,388,2023-03-24T20:08,0,109000
413,2440110,54,53910,59900,97.0,767,2023-03-24T20:08,-4010,49900
414,957758,55,89000,0,97.0,4292,2023-03-24T20:08,0,89000
415,1473136,56,119900,149000,97.0,10733,2023-03-24T20:08,0,119900
416,2996167,57,109900,139000,97.0,109,2023-03-24T20:08,0,109900
417,1296778,58,99000,0,98.0,2016,2023-03-24T20:08,0,99000
418,1798273,59,69000,119000,96.0,1131,2023-03-24T20:08,0,69000
419,2577087,60,89900,139000,96.0,318,2023-03-24T20:08,0,89900
420,3096431,61,139000,0,98.0,13,2023-03-24T20:08,0,139000
421,2229208,62,109000,0,97.0,1583,2023-03-24T20:08,0,109000
422,2493214,63,169000,0,98.0,148,2023-03-24T20:08,0,169000
423,2524840,64,139000,0,96.0,768,2023-03-24T20:08,0,139000
424,2899664,65,109900,159000,97.0,83,2023-03-24T20:08,0,109900
425,1478592,66,75900,95000,97.0,2866,2023-03-24T20:08,0,75900
426,311050,67,53100,59000,97.0,8954,2023-03-24T20:08,0,53100
427,1296776,68,99000,0,98.0,2902,2023-03-24T20:08,0,99000
428,2992069,69,109900,139000,97.0,160,2023-03-24T20:08,0,109900
429,1883698,70,139000,0,97.0,41,2023-03-24T20:08,0,139000
430,104240,71,69000,0,96.0,3817,2023-03-24T20:08,0,69000
431,1493265,72,85500,95000,98.0,4813,2023-03-24T20:08,0,85500
432,1492897,73,75000,0,96.0,2981,2023-03-24T20:08,0,75000
433,1729744,74,76500,85000,97.0,3286,2023-03-24T20:08,0,76500
434,1955217,75,71000,109000,96.0,5078,2023-03-24T20:08,-7100,63900
435,1594352,76,85000,0,97.0,5533,2023-03-24T20:08,0,85000
436,2267008,77,89100,99000,98.0,470,2023-03-24T20:08,0,89100
437,3054526,78,99000,0,95.0,12,2023-03-24T20:08,0,99000
438,2909715,79,119000,0,96.0,65,2023-03-24T20:08,0,119000
439,2631192,80,98100,109000,98.0,321,2023-03-24T20:08,0,98100
440,3091286,81,119000,0,95.0,29,2023-03-24T20:08,0,119000
441,716244,82,69900,95000,98.0,1042,2023-03-24T20:08,0,69900
442,2768319,83,39900,109000,96.0,328,2023-03-24T20:08,0,39900
443,2682873,84,220000,0,97.0,85,2023-03-24T20:08,0,220000
444,3109771,85,133900,149000,90.0,4,2023-03-24T20:08,0,133900
445,2565212,86,119000,0,99.0,402,2023-03-24T20:08,0,119000
446,2312772,87,69900,139800,96.0,1319,2023-03-24T20:08,0,69900
447,311051,88,58500,65000,97.0,19468,2023-03-24T20:08,0,58500
448,3105763,89,139000,0,98.0,100,2023-03-24T20:08,0,139000
449,2970200,90,79000,0,98.0,409,2023-03-24T20:08,0,79000
450,3156676,1,259000,299000,0.0,0,2023-03-24T20:08,-12950,246050
451,3156683,2,259000,299000,0.0,0,2023-03-24T20:08,-12950,246050
452,2430426,3,169000,0,98.0,688,2023-03-24T20:08,0,169000
453,1092992,4,69000,0,97.0,37534,2023-03-24T20:08,0,69000
454,3156658,5,259000,299000,0.0,0,2023-03-24T20:08,-12950,246050
455,2624538,6,40900,59000,97.0,1251,2023-03-24T20:08,0,40900
456,2664372,7,58500,65000,97.0,907,2023-03-24T20:08,0,58500
457,1568047,8,143100,159000,95.0,11955,2023-03-24T20:08,0,143100
458,2091749,9,75650,89000,95.0,6121,2023-03-24T20:08,0,75650
459,2664373,10,58500,65000,97.0,874,2023-03-24T20:08,0,58500
460,2432733,11,44900,59000,97.0,2576,2023-03-24T20:08,0,44900
461,2069832,12,199900,332000,95.0,733,2023-03-24T20:08,-39980,159920
462,1339622,13,42900,59000,97.0,16032,2023-03-24T20:08,0,42900
463,595040,14,210000,0,95.0,8683,2023-03-24T20:08,0,210000
464,2856881,15,489000,1090000,0.0,0,2023-03-24T20:08,-30000,459000
465,2433538,16,86700,102000,96.0,2289,2023-03-24T20:08,-6069,80631
466,2910082,17,265500,295000,98.0,409,2023-03-24T20:08,0,265500
467,1724193,18,251900,280000,98.0,1454,2023-03-24T20:08,0,251900
468,595039,19,210000,0,97.0,3457,2023-03-24T20:08,0,210000
469,3062046,20,78300,87000,96.0,50,2023-03-24T20:08,-3915,74385
470,1890398,21,132000,168000,96.0,2658,2023-03-24T20:08,-9240,122760
471,2210201,22,259000,299000,94.0,191,2023-03-24T20:08,-12950,246050
472,2816812,23,119900,0,92.0,1481,2023-03-24T20:08,0,119900
473,1699941,24,67150,79000,97.0,4720,2023-03-24T20:08,-3358,63792
474,1262092,25,250000,0,96.0,764,2023-03-24T20:08,0,250000
475,2589483,26,58500,65000,97.0,1230,2023-03-24T20:08,0,58500
476,1730340,27,232200,258000,97.0,4086,2023-03-24T20:08,-16254,215946
477,1129750,28,69000,0,97.0,3846,2023-03-24T20:08,0,69000
478,2910086,29,265500,295000,98.0,169,2023-03-24T20:08,0,265500
479,2101924,30,99900,0,96.0,1325,2023-03-24T20:08,-9990,89910
480,2419871,31,44900,59000,97.0,840,2023-03-24T20:08,0,44900
481,2803698,32,9900,49000,92.0,62,2023-03-24T20:08,0,9900
482,2816816,33,159900,0,97.0,1800,2023-03-24T20:08,0,159900
483,3075621,34,339000,0,98.0,50,2023-03-24T20:08,0,339000
484,2143833,35,91800,108000,96.0,2348,2023-03-24T20:08,-6426,85374
485,2210207,36,259000,299000,92.0,113,2023-03-24T20:08,-12950,246050
486,2750309,37,44900,59000,98.0,339,2023-03-24T20:08,0,44900
487,1562990,38,230000,0,96.0,1268,2023-03-24T20:08,0,230000
488,1334438,39,170000,0,96.0,4374,2023-03-24T20:08,0,170000
489,2322211,40,120000,200000,97.0,102,2023-03-24T20:08,0,120000
490,1720827,41,169000,0,98.0,560,2023-03-24T20:08,0,169000
491,3024585,42,59000,0,97.0,71,2023-03-24T20:08,-11800,47200
492,3124961,43,62100,69000,0.0,0,2023-03-24T20:08,-3105,58995
493,1334440,44,100000,170000,96.0,2034,2023-03-24T20:08,0,100000
494,2093156,45,259000,0,90.0,15,2023-03-24T20:08,0,259000
495,2972872,46,65000,0,97.0,270,2023-03-24T20:08,0,65000
496,1720813,47,149000,0,97.0,400,2023-03-24T20:08,0,149000
497,2210246,48,259000,299000,97.0,84,2023-03-24T20:08,-12950,246050
498,2305523,49,139000,198000,96.0,63,2023-03-24T20:08,-9730,129270
499,1021359,50,76000,100000,94.0,5363,2023-03-24T20:08,-5320,70680
500,3103381,51,57900,65000,94.0,23,2023-03-24T20:08,0,57900
501,3084457,52,138000,197000,100.0,5,2023-03-24T20:08,-13800,124200
502,2138190,53,162000,218000,96.0,861,2023-03-24T20:08,0,162000
503,2383245,54,99000,0,98.0,783,2023-03-24T20:08,0,99000
504,1273517,55,14900,34000,97.0,1248,2023-03-24T20:08,0,14900
505,3049313,56,57100,64900,97.0,357,2023-03-24T20:08,0,57100
506,2614276,57,69000,0,97.0,515,2023-03-24T20:08,0,69000
507,2814394,58,120000,240000,0.0,0,2023-03-24T20:08,0,120000
508,2518112,59,89250,105000,96.0,900,2023-03-24T20:08,-6248,83002
509,3062069,60,71100,79000,97.0,14,2023-03-24T20:08,-3555,67545
510,2781406,61,87900,109900,98.0,65,2023-03-24T20:08,-6153,81747
511,2777273,62,249000,450000,0.0,0,2023-03-24T20:08,-30000,219000
512,2340324,63,179100,199000,97.0,170,2023-03-24T20:08,0,179100
513,2355318,64,98790,109900,96.0,626,2023-03-24T20:08,-9879,88911
514,1813898,65,219000,0,97.0,28,2023-03-24T20:08,0,219000
515,1548618,66,152000,198000,96.0,3272,2023-03-24T20:08,-10640,141360
516,1973858,67,125300,179000,98.0,1147,2023-03-24T20:08,0,125300
517,2446608,68,39900,59000,97.0,492,2023-03-24T20:08,0,39900
518,2621831,69,64000,85000,95.0,678,2023-03-24T20:08,-6400,57600
519,1439527,70,44000,0,95.0,13412,2023-03-24T20:08,0,44000
520,1815709,71,132000,168000,96.0,7094,2023-03-24T20:08,-9240,122760
521,3084458,72,138000,197000,90.0,6,2023-03-24T20:08,-13800,124200
522,2818506,73,168000,280000,95.0,112,2023-03-24T20:08,0,168000
523,2972873,74,65000,0,98.0,72,2023-03-24T20:08,0,65000
524,2678262,75,658000,1170000,0.0,0,2023-03-24T20:08,-30000,628000
525,2306631,76,21900,24900,96.0,2000,2023-03-24T20:08,-1533,20367
526,1952910,77,265500,295000,98.0,1717,2023-03-24T20:08,0,265500
527,2098793,78,79200,99000,96.0,1578,2023-03-24T20:08,0,79200
528,3061996,79,88200,98000,97.0,31,2023-03-24T20:08,-4410,83790
529,607298,80,53600,59000,93.0,15534,2023-03-24T20:08,-3752,49848
530,2744907,81,81000,0,96.0,957,2023-03-24T20:08,0,81000
531,2311762,82,624000,781000,0.0,0,2023-03-24T20:08,0,624000
532,636821,83,152100,169000,93.0,2568,2023-03-24T20:08,0,152100
533,3036051,84,69900,0,98.0,44,2023-03-24T20:08,0,69900
534,1010925,85,170000,0,96.0,2082,2023-03-24T20:08,0,170000
535,2630236,86,298000,0,90.0,10,2023-03-24T20:08,0,298000
536,2555608,87,259000,299000,93.0,24,2023-03-24T20:08,-12950,246050
537,1810760,88,105000,150000,96.0,158,2023-03-24T20:08,0,105000
538,2322221,89,175000,350000,91.0,14,2023-03-24T20:08,0,175000
539,2993234,90,779000,1663000,0.0,0,2023-03-24T20:08,-30000,749000
540,3061175,1,89000,0,99.0,77,2023-03-24T20:08,0,89000
541,1214164,2,36000,0,96.0,24752,2023-03-24T20:08,0,36000
542,2280117,3,35100,39000,97.0,6023,2023-03-24T20:08,0,35100
543,1771137,4,26100,29000,97.0,12303,2023-03-24T20:08,0,26100
544,2134140,5,39000,0,97.0,3418,2023-03-24T20:08,0,39000
545,2879419,6,46900,55000,98.0,563,2023-03-24T20:08,0,46900
546,1022014,7,79000,0,96.0,11384,2023-03-24T20:08,0,79000
547,1272626,8,36000,0,96.0,14013,2023-03-24T20:08,0,36000
548,2860837,9,26130,39000,91.0,12,2023-03-24T20:08,-2613,23517
549,1022013,10,79000,0,96.0,6221,2023-03-24T20:08,0,79000
550,1214173,11,36000,0,96.0,5493,2023-03-24T20:08,0,36000
551,1214174,12,36000,0,97.0,14925,2023-03-24T20:08,0,36000
552,1214109,13,36000,0,97.0,7994,2023-03-24T20:08,0,36000
553,1836699,14,79000,0,97.0,224,2023-03-24T20:08,0,79000
554,1771132,15,26100,29000,96.0,5151,2023-03-24T20:08,0,26100
555,2879425,16,46900,55000,97.0,204,2023-03-24T20:08,0,46900
556,2286829,17,24050,37000,95.0,4722,2023-03-24T20:08,0,24050
557,1822717,18,56050,59000,97.0,4241,2023-03-24T20:08,-2803,53247
558,2134158,19,39000,0,97.0,2433,2023-03-24T20:08,0,39000
559,1498091,20,79000,0,97.0,56,2023-03-24T20:08,0,79000
560,2329375,21,34710,39000,97.0,2034,2023-03-24T20:08,0,34710
561,2464070,22,44000,55000,97.0,265,2023-03-24T20:08,-2200,41800
562,2356713,23,39000,0,97.0,1398,2023-03-24T20:08,0,39000
563,1907733,24,29900,39000,96.0,3752,2023-03-24T20:08,0,29900
564,1771133,25,26100,29000,97.0,5616,2023-03-24T20:08,0,26100
565,2123132,26,39000,0,97.0,6311,2023-03-24T20:08,0,39000
566,2221221,27,35100,39000,96.0,1811,2023-03-24T20:08,0,35100
567,2028240,28,39000,0,98.0,3311,2023-03-24T20:08,0,39000
568,1497550,29,29600,37000,95.0,5613,2023-03-24T20:08,0,29600
569,2560668,30,58650,69000,97.0,1204,2023-03-24T20:08,0,58650
570,1925814,31,35100,39000,96.0,1610,2023-03-24T20:08,0,35100
571,1855444,32,37800,42000,97.0,2949,2023-03-24T20:08,0,37800
572,2672186,33,20900,30000,96.0,525,2023-03-24T20:08,-2090,18810
573,1920929,34,39000,0,97.0,3928,2023-03-24T20:08,0,39000
574,2053753,35,33600,42000,98.0,4091,2023-03-24T20:08,0,33600
575,2929166,36,415000,630000,0.0,0,2023-03-24T20:08,-30000,385000
576,2650964,37,46900,53000,98.0,157,2023-03-24T20:08,0,46900
577,2356711,38,39000,0,97.0,1427,2023-03-24T20:08,0,39000
578,2859190,39,37000,0,96.0,379,2023-03-24T20:08,0,37000
579,3163226,40,39000,0,0.0,0,2023-03-24T20:08,0,39000
580,2107999,41,36000,0,97.0,2622,2023-03-24T20:08,0,36000
581,1022015,42,79000,0,96.0,1938,2023-03-24T20:08,0,79000
582,1300684,43,41300,59000,92.0,236,2023-03-24T20:08,0,41300
583,2715565,44,68000,0,95.0,85,2023-03-24T20:08,0,68000
584,1524720,45,36000,0,96.0,3344,2023-03-24T20:08,0,36000
585,3012243,46,27900,39900,97.0,38,2023-03-24T20:08,-1953,25947
586,2591291,47,39200,49000,97.0,990,2023-03-24T20:08,0,39200
587,2356693,48,39000,0,97.0,1497,2023-03-24T20:08,0,39000
588,1939301,49,39000,0,97.0,793,2023-03-24T20:08,0,39000
589,1214317,50,36000,0,97.0,11410,2023-03-24T20:08,0,36000
590,1906772,51,37800,42000,97.0,2989,2023-03-24T20:08,0,37800
591,2921965,52,52000,0,98.0,162,2023-03-24T20:08,-5200,46800
592,2707659,53,37800,42000,97.0,480,2023-03-24T20:08,0,37800
593,3044382,54,98000,0,100.0,6,2023-03-24T20:08,0,98000
594,2287131,55,37000,0,95.0,1549,2023-03-24T20:08,0,37000
595,2998516,56,29000,0,96.0,114,2023-03-24T20:08,0,29000
596,1214106,57,36000,0,96.0,9691,2023-03-24T20:08,0,36000
597,1214169,58,36000,0,97.0,5285,2023-03-24T20:08,0,36000
598,1063518,59,79000,0,96.0,948,2023-03-24T20:08,0,79000
599,2962388,60,31200,39000,96.0,97,2023-03-24T20:08,0,31200
600,2697593,61,99000,0,97.0,130,2023-03-24T20:08,0,99000
601,2507021,62,42000,0,96.0,408,2023-03-24T20:08,0,42000
602,2364344,63,30400,38000,97.0,1652,2023-03-24T20:08,0,30400
603,2715553,64,68000,0,95.0,230,2023-03-24T20:08,0,68000
604,1335132,65,29000,0,95.0,1083,2023-03-24T20:08,0,29000
605,1771121,66,26100,29000,96.0,2246,2023-03-24T20:08,0,26100
606,2778150,67,370000,710000,100.0,1,2023-03-24T20:08,-30000,340000
607,3163318,68,45000,0,0.0,0,2023-03-24T20:08,0,45000
608,1126959,69,29250,39000,91.0,2541,2023-03-24T20:08,0,29250
609,1433907,70,29250,39000,93.0,1464,2023-03-24T20:08,0,29250
610,1602670,71,56050,59000,97.0,730,2023-03-24T20:08,0,56050
611,2879417,72,46900,55000,98.0,159,2023-03-24T20:08,0,46900
612,2051581,73,33000,0,96.0,839,2023-03-24T20:08,0,33000
613,1214193,74,39000,0,97.0,15288,2023-03-24T20:08,0,39000
614,1632175,75,39000,0,97.0,2666,2023-03-24T20:08,0,39000
615,2157077,76,37800,42000,95.0,725,2023-03-24T20:08,0,37800
616,2169131,77,35100,39000,96.0,424,2023-03-24T20:08,0,35100
617,2650965,78,46900,53000,98.0,345,2023-03-24T20:08,0,46900
618,2922336,79,52000,0,97.0,118,2023-03-24T20:08,-5200,46800
619,2573131,80,37800,42000,98.0,671,2023-03-24T20:08,0,37800
620,2134295,81,39000,0,97.0,392,2023-03-24T20:08,0,39000
621,2199172,82,79000,0,91.0,44,2023-03-24T20:08,0,79000
622,2286789,83,37000,0,96.0,637,2023-03-24T20:08,0,37000
623,3163228,84,39000,0,0.0,0,2023-03-24T20:08,0,39000
624,2976590,85,55000,0,96.0,20,2023-03-24T20:08,0,55000
625,2287312,86,24050,37000,95.0,202,2023-03-24T20:08,0,24050
626,1433913,87,31500,42000,94.0,3573,2023-03-24T20:08,0,31500
627,2287158,88,24050,37000,95.0,1123,2023-03-24T20:08,0,24050
628,1760824,89,49700,59000,97.0,290,2023-03-24T20:08,0,49700
629,2315824,90,49000,0,97.0,392,2023-03-24T20:08,0,49000
630,3059119,1,152150,179000,94.0,10,2023-03-24T20:08,-30430,121720
631,2587981,2,293300,419000,0.0,0,2023-03-24T20:08,-43995,249305
632,3129884,3,275000,0,0.0,0,2023-03-24T20:08,-55000,220000
633,3050173,4,166600,238000,0.0,0,2023-03-24T20:08,0,166600
634,3135904,5,92000,0,0.0,0,2023-03-24T20:08,-4600,87400
635,2827957,6,726000,1579000,100.0,2,2023-03-24T20:08,-30000,696000
636,2605850,7,94000,0,97.0,155,2023-03-24T20:08,-4700,89300
637,1455772,8,94000,0,96.0,207,2023-03-24T20:08,-4700,89300
638,3122381,9,151200,168000,100.0,4,2023-03-24T20:08,-22680,128520
639,2815208,10,386100,429000,0.0,0,2023-03-24T20:08,-50193,335907
640,2781048,11,495500,991000,0.0,0,2023-03-24T20:08,-30000,465500
641,3078695,12,365000,0,0.0,0,2023-03-24T20:08,0,365000
642,3136808,13,328000,0,0.0,0,2023-03-24T20:08,-32800,295200
643,3147475,14,159000,0,0.0,0,2023-03-24T20:08,0,159000
644,1863788,15,103200,129000,96.0,119,2023-03-24T20:08,-5160,98040
645,2558807,16,137600,172000,91.0,19,2023-03-24T20:08,0,137600
646,2457512,17,237300,339000,98.0,32,2023-03-24T20:08,0,237300
647,1103286,18,94000,0,94.0,776,2023-03-24T20:08,-4700,89300
648,3085850,19,115200,128000,0.0,0,2023-03-24T20:08,0,115200
649,3106487,20,148000,0,100.0,9,2023-03-24T20:08,0,148000
650,3125342,21,255200,319000,0.0,0,2023-03-24T20:08,0,255200
651,2568529,22,220000,0,100.0,10,2023-03-24T20:08,0,220000
652,2377832,23,195000,0,95.0,171,2023-03-24T20:08,-9750,185250
653,3046091,24,223200,248000,100.0,1,2023-03-24T20:08,-11160,212040
654,2714524,25,48300,69000,95.0,390,2023-03-24T20:08,-4830,43470
655,2555911,26,238800,398000,0.0,0,2023-03-24T20:08,-35820,202980
656,3070522,27,218000,0,0.0,0,2023-03-24T20:08,0,218000
657,3146212,28,69900,0,0.0,0,2023-03-24T20:08,-3495,66405
658,2700731,29,212000,0,100.0,2,2023-03-24T20:08,-42400,169600
659,1622447,30,58700,69000,90.0,185,2023-03-24T20:08,-2935,55765
660,2494158,31,229000,0,0.0,0,2023-03-24T20:08,0,229000
661,3073259,32,196200,218000,100.0,4,2023-03-24T20:08,-29430,166770
662,3102537,33,220000,0,0.0,0,2023-03-24T20:08,0,220000
663,3073257,34,196200,218000,100.0,6,2023-03-24T20:08,-29430,166770
664,3081772,35,189000,0,0.0,0,2023-03-24T20:08,-9450,179550
665,3073253,36,196200,218000,0.0,0,2023-03-24T20:08,-29430,166770
666,2731084,37,208600,298000,0.0,0,2023-03-24T20:08,-31290,177310
667,3120621,38,197100,219000,0.0,0,2023-03-24T20:08,-29565,167535
668,2595417,39,108800,128000,0.0,0,2023-03-24T20:08,0,108800
669,2377835,40,195000,0,97.0,15,2023-03-24T20:08,0,195000
670,2373167,41,189000,0,96.0,21,2023-03-24T20:08,0,189000
671,3083230,42,159000,0,100.0,3,2023-03-24T20:08,-7950,151050
672,2665521,43,198000,0,0.0,0,2023-03-24T20:08,0,198000
673,3147351,44,198000,0,0.0,0,2023-03-24T20:08,0,198000
674,3091290,45,85000,0,0.0,0,2023-03-24T20:08,0,85000
675,2373166,46,189000,0,90.0,4,2023-03-24T20:08,0,189000
676,3146771,47,179100,199000,0.0,0,2023-03-24T20:08,-26865,152235
677,2153636,48,173600,248000,97.0,29,2023-03-24T20:08,-8680,164920
678,3102263,49,165000,0,0.0,0,2023-03-24T20:08,-8250,156750
679,3130633,50,149000,0,100.0,2,2023-03-24T20:08,-7450,141550
680,3055337,51,159000,0,0.0,0,2023-03-24T20:08,0,159000
681,2712722,52,46900,79000,96.0,18,2023-03-24T20:08,0,46900
682,2621820,53,176000,0,0.0,0,2023-03-24T20:08,-35200,140800
683,2489894,54,150100,158000,98.0,98,2023-03-24T20:08,-7505,142595
684,3135497,55,150100,158000,0.0,0,2023-03-24T20:08,-30020,120080
685,3050857,56,129000,0,88.0,5,2023-03-24T20:08,0,129000
686,2631858,57,174000,290000,0.0,0,2023-03-24T20:08,0,174000
687,1754644,58,173600,248000,0.0,0,2023-03-24T20:08,0,173600
688,3066925,59,88500,118000,100.0,2,2023-03-24T20:08,0,88500
689,1850060,60,168000,0,93.0,12,2023-03-24T20:08,0,168000
690,2590379,61,159600,168000,98.0,15,2023-03-24T20:08,0,159600
691,3091291,62,85000,0,0.0,0,2023-03-24T20:08,0,85000
692,3111357,63,158000,0,0.0,0,2023-03-24T20:08,-7900,150100
693,3155822,64,161100,179000,0.0,0,2023-03-24T20:08,0,161100
694,3119222,65,161100,179000,0.0,0,2023-03-24T20:08,-8055,153045
695,2537957,66,153000,219000,100.0,1,2023-03-24T20:08,0,153000
696,3077360,67,98000,0,100.0,1,2023-03-24T20:08,-4900,93100
697,2489892,68,150100,158000,94.0,19,2023-03-24T20:08,0,150100
698,2640260,69,89100,99000,84.0,5,2023-03-24T20:08,0,89100
699,3099002,70,159000,0,0.0,0,2023-03-24T20:08,0,159000
700,2567006,71,1563000,2906000,0.0,0,2023-03-24T20:08,-30000,1533000
701,2983330,72,133200,148000,100.0,5,2023-03-24T20:08,-6660,126540
702,2512635,73,35400,59000,96.0,188,2023-03-24T20:08,0,35400
703,2047153,74,159000,0,0.0,0,2023-03-24T20:08,0,159000
704,1871030,75,133600,167000,94.0,92,2023-03-24T20:08,-6680,126920
705,3144509,76,103200,129000,100.0,2,2023-03-24T20:08,0,103200
706,3149939,77,149000,0,0.0,0,2023-03-24T20:08,0,149000
707,2578224,78,144500,170000,100.0,1,2023-03-24T20:08,0,144500
708,1341924,79,95760,152000,96.0,75,2023-03-24T20:08,-4788,90972
709,2754710,80,143200,179000,95.0,4,2023-03-24T20:08,0,143200
710,3008035,81,65900,75000,95.0,24,2023-03-24T20:08,0,65900
711,2214628,82,56700,189000,86.0,3,2023-03-24T20:08,0,56700
712,2558140,83,143200,179000,0.0,0,2023-03-24T20:08,0,143200
713,2714533,84,48300,69000,93.0,226,2023-03-24T20:08,-4830,43470
714,3135214,85,71100,79000,0.0,0,2023-03-24T20:08,0,71100
715,3153482,86,142200,158000,0.0,0,2023-03-24T20:08,0,142200
716,1918659,87,140400,156000,0.0,0,2023-03-24T20:08,0,140400
717,987352,88,49000,59000,93.0,588,2023-03-24T20:08,0,49000
718,2478652,89,54400,68000,94.0,326,2023-03-24T20:08,-2720,51680
719,3032680,90,139000,0,0.0,0,2023-03-24T20:08,0,139000
720,2867750,1,135000,0,96.0,35,2023-03-24T20:08,-6750,128250
721,2925522,2,54600,65000,95.0,74,2023-03-24T20:08,0,54600
722,2144842,3,65400,109000,95.0,19,2023-03-24T20:08,0,65400
723,2801111,4,78900,105000,93.0,3,2023-03-24T20:08,0,78900
724,3051039,5,95200,119000,100.0,13,2023-03-24T20:08,0,95200
725,2795481,6,1267000,2380000,0.0,0,2023-03-24T20:08,-30000,1237000
726,2377814,7,178200,198000,96.0,68,2023-03-24T20:08,-26730,151470
727,2796166,8,38400,64000,96.0,214,2023-03-24T20:08,-1920,36480
728,3026955,9,86700,102000,0.0,0,2023-03-24T20:08,-4335,82365
729,1931894,10,37900,0,95.0,480,2023-03-24T20:08,0,37900
730,3037452,11,141550,149000,100.0,1,2023-03-24T20:08,-7078,134472
731,2864414,12,69300,99000,93.0,65,2023-03-24T20:08,-3465,65835
732,2756335,13,125400,132000,96.0,43,2023-03-24T20:08,-6270,119130
733,2551406,14,37900,0,95.0,186,2023-03-24T20:08,0,37900
734,2836351,15,49680,72000,96.0,406,2023-03-24T20:08,-4968,44712
735,3035265,16,49600,62000,97.0,7,2023-03-24T20:08,0,49600
736,3130182,17,165000,0,0.0,0,2023-03-24T20:08,-33000,132000
737,3070530,18,168000,0,0.0,0,2023-03-24T20:08,0,168000
738,3130181,19,165000,0,0.0,0,2023-03-24T20:08,-33000,132000
739,2664567,20,173000,0,0.0,0,2023-03-24T20:08,0,173000
740,3073251,21,169200,188000,0.0,0,2023-03-24T20:08,-25380,143820
741,3080576,22,80100,89000,0.0,0,2023-03-24T20:08,-8010,72090
742,3062947,23,110400,138000,100.0,3,2023-03-24T20:08,0,110400
743,3118975,24,318000,0,0.0,0,2023-03-24T20:08,0,318000
744,3100903,25,151200,168000,0.0,0,2023-03-24T20:08,-22680,128520
745,2882570,26,164000,249000,0.0,0,2023-03-24T20:08,-24600,139400
746,2819908,27,319000,0,0.0,0,2023-03-24T20:08,0,319000
747,2848211,28,399000,0,0.0,0,2023-03-24T20:08,0,399000
748,3074720,29,84550,89000,0.0,0,2023-03-24T20:08,0,84550
749,3042376,30,319000,0,0.0,0,2023-03-24T20:08,0,319000
750,2848208,31,399000,0,0.0,0,2023-03-24T20:08,0,399000
751,2551401,32,37900,0,93.0,259,2023-03-24T20:08,0,37900
752,3051192,33,109000,0,98.0,12,2023-03-24T20:08,-5450,103550
753,2316503,34,38400,64000,94.0,305,2023-03-24T20:08,-1920,36480
754,2551400,35,39900,0,93.0,125,2023-03-24T20:08,0,39900
755,3049792,36,67200,79000,100.0,2,2023-03-24T20:08,-6720,60480
756,2300718,37,39390,43900,95.0,230,2023-03-24T20:08,0,39390
757,2806614,38,119000,0,98.0,89,2023-03-24T20:08,0,119000
758,2891918,39,379000,0,100.0,2,2023-03-24T20:08,0,379000
759,2588032,40,279300,399000,0.0,0,2023-03-24T20:08,-41895,237405
760,3088714,41,270000,0,0.0,0,2023-03-24T20:08,0,270000
761,3088704,42,270000,0,0.0,0,2023-03-24T20:08,0,270000
762,3058718,43,81600,96000,97.0,7,2023-03-24T20:08,-16320,65280
763,2850491,44,250600,358000,100.0,4,2023-03-24T20:08,-32578,218022
764,3049791,45,67200,79000,100.0,9,2023-03-24T20:08,-6720,60480
765,2994074,46,243600,348000,0.0,0,2023-03-24T20:08,-31668,211932
766,2448900,47,39490,43900,95.0,78,2023-03-24T20:08,0,39490
767,3070528,48,168000,0,0.0,0,2023-03-24T20:08,-8400,159600
768,2739414,49,118000,0,100.0,4,2023-03-24T20:08,0,118000
769,2478665,50,45500,65000,89.0,38,2023-03-24T20:08,-4550,40950
770,3120565,51,232200,258000,0.0,0,2023-03-24T20:08,-30186,202014
771,2792603,52,43900,0,100.0,31,2023-03-24T20:08,0,43900
772,2737868,53,119400,199000,0.0,0,2023-03-24T20:08,-17910,101490
773,2499645,54,243600,348000,0.0,0,2023-03-24T20:08,-31668,211932
774,3035256,55,49600,62000,100.0,5,2023-03-24T20:08,0,49600
775,2852664,56,223200,279000,0.0,0,2023-03-24T20:08,-33480,189720
776,3000422,57,59000,0,100.0,17,2023-03-24T20:08,0,59000
777,3051036,58,95200,119000,100.0,1,2023-03-24T20:08,0,95200
778,2352881,59,55900,79900,98.0,301,2023-03-24T20:08,0,55900
779,2738716,60,142800,168000,93.0,25,2023-03-24T20:08,-7140,135660
780,2955767,61,107100,119000,93.0,6,2023-03-24T20:08,0,107100
781,2551407,62,37900,0,97.0,149,2023-03-24T20:08,0,37900
782,3080578,63,80100,89000,0.0,0,2023-03-24T20:08,-8010,72090
783,2365329,64,109000,0,94.0,25,2023-03-24T20:08,0,109000
784,2744469,65,202800,338000,100.0,1,2023-03-24T20:08,-30420,172380
785,2377805,66,178200,198000,92.0,17,2023-03-24T20:08,-26730,151470
786,2830762,67,139000,0,99.0,42,2023-03-24T20:08,-6950,132050
787,2830808,68,139000,0,96.0,13,2023-03-24T20:08,-6950,132050
788,2716675,69,39900,59000,96.0,151,2023-03-24T20:08,0,39900
789,3040745,70,88000,110000,93.0,13,2023-03-24T20:08,-4400,83600
790,2448899,71,39490,43900,95.0,117,2023-03-24T20:08,0,39490
791,3073252,72,160200,178000,100.0,1,2023-03-24T20:08,-24030,136170
792,2377812,73,178200,198000,97.0,57,2023-03-24T20:08,-26730,151470
793,3123863,74,160200,178000,0.0,0,2023-03-24T20:08,-20826,139374
794,3092513,75,89000,0,0.0,0,2023-03-24T20:08,-4450,84550
795,3026953,76,86700,102000,100.0,2,2023-03-24T20:08,-4335,82365
796,2664570,77,116000,0,97.0,9,2023-03-24T20:08,0,116000
797,3113294,78,54600,65000,100.0,5,2023-03-24T20:08,0,54600
798,3047742,79,71100,79000,86.0,3,2023-03-24T20:08,-3555,67545
799,2117256,80,37900,0,96.0,236,2023-03-24T20:08,0,37900
800,3070525,81,148000,0,100.0,2,2023-03-24T20:08,-7400,140600
801,3040573,82,169100,178000,100.0,4,2023-03-24T20:08,-33820,135280
802,2801889,83,179400,299000,0.0,0,2023-03-24T20:08,-23322,156078
803,2541402,84,125300,179000,100.0,1,2023-03-24T20:08,0,125300
804,3133082,85,171000,0,70.0,2,2023-03-24T20:08,-51300,119700
805,2503707,86,93100,98000,96.0,50,2023-03-24T20:08,-18620,74480
806,3081768,87,169000,0,0.0,0,2023-03-24T20:08,0,169000
807,3072779,88,179000,0,0.0,0,2023-03-24T20:08,0,179000
808,3040751,89,93800,125000,90.0,2,2023-03-24T20:08,-9380,84420
809,2914815,90,170100,189000,96.0,5,2023-03-24T20:08,0,170100
810,991339,1,17890,19900,97.0,52040,2023-03-24T20:08,0,17890
811,1986031,2,24990,27900,97.0,10235,2023-03-24T20:08,0,24990
812,998051,3,13900,24000,97.0,160511,2023-03-24T20:08,0,13900
813,1094748,4,19900,0,97.0,18886,2023-03-24T20:08,0,19900
814,991340,5,17890,19900,97.0,30502,2023-03-24T20:08,0,17890
815,1477845,6,15400,22000,96.0,9383,2023-03-24T20:08,0,15400
816,763821,7,16900,22000,96.0,31173,2023-03-24T20:08,0,16900
817,1094835,8,14290,15900,97.0,6112,2023-03-24T20:08,0,14290
818,792919,9,15190,16900,96.0,17848,2023-03-24T20:08,0,15190
819,1986029,10,27900,0,98.0,3851,2023-03-24T20:08,0,27900
820,1996705,11,23690,27900,98.0,2626,2023-03-24T20:08,0,23690
821,991570,12,12900,20000,97.0,18909,2023-03-24T20:08,0,12900
822,1443937,13,12900,24000,97.0,7547,2023-03-24T20:08,0,12900
823,2959925,14,22000,27500,99.0,68,2023-03-24T20:08,0,22000
824,734085,15,11900,19800,96.0,64234,2023-03-24T20:08,0,11900
825,746158,16,22900,0,96.0,20445,2023-03-24T20:08,0,22900
826,1986030,17,23690,27900,97.0,1627,2023-03-24T20:08,0,23690
827,1996702,18,23690,27900,97.0,1875,2023-03-24T20:08,0,23690
828,1821485,19,30000,0,96.0,1227,2023-03-24T20:08,0,30000
829,1729576,20,9500,13900,97.0,15760,2023-03-24T20:08,0,9500
830,1094750,21,16890,19900,97.0,3515,2023-03-24T20:08,0,16890
831,1342874,22,16900,33000,97.0,12490,2023-03-24T20:08,0,16900
832,991341,23,16890,19900,96.0,10105,2023-03-24T20:08,0,16890
833,746159,24,20590,22900,95.0,28663,2023-03-24T20:08,0,20590
834,479245,25,15400,22000,93.0,5343,2023-03-24T20:08,0,15400
835,2832613,26,11200,33000,97.0,541,2023-03-24T20:08,0,11200
836,1094749,27,19900,0,96.0,4912,2023-03-24T20:08,0,19900
837,2297277,28,19900,22000,95.0,242,2023-03-24T20:08,0,19900
838,792920,29,15190,16900,96.0,9639,2023-03-24T20:08,0,15190
839,2845854,30,14900,18900,97.0,164,2023-03-24T20:08,-1043,13857
840,1974077,31,42090,46900,97.0,881,2023-03-24T20:08,0,42090
841,2960555,32,14900,19000,92.0,74,2023-03-24T20:08,0,14900
842,1477846,33,15400,22000,96.0,2632,2023-03-24T20:08,0,15400
843,2011852,34,21490,23900,97.0,1289,2023-03-24T20:08,0,21490
844,3009680,35,12590,14900,98.0,82,2023-03-24T20:08,0,12590
845,1573974,36,39790,46900,98.0,1444,2023-03-24T20:08,0,39790
846,1094834,37,21490,23900,96.0,2424,2023-03-24T20:08,0,21490
847,2293399,38,19900,22000,96.0,609,2023-03-24T20:08,0,19900
848,1821487,39,30000,0,97.0,665,2023-03-24T20:08,0,30000
849,2467197,40,30000,0,95.0,124,2023-03-24T20:08,0,30000
850,746161,41,20590,22900,95.0,7720,2023-03-24T20:08,0,20590
851,2821597,42,22900,0,98.0,94,2023-03-24T20:08,0,22900
852,1556773,43,15200,16000,96.0,672,2023-03-24T20:08,-3040,12160
853,752821,44,9900,0,94.0,23649,2023-03-24T20:08,0,9900
854,1346009,45,9900,12000,97.0,6621,2023-03-24T20:08,0,9900
855,1475055,46,16900,22000,96.0,1152,2023-03-24T20:08,0,16900
856,2929635,47,16800,27000,97.0,465,2023-03-24T20:08,0,16800
857,2346958,48,18900,24000,98.0,496,2023-03-24T20:08,0,18900
858,2821588,49,19690,21900,97.0,38,2023-03-24T20:08,0,19690
859,1260388,50,20900,0,96.0,653,2023-03-24T20:08,0,20900
860,3129048,51,19000,0,100.0,4,2023-03-24T20:08,0,19000
861,1647682,52,14900,23600,97.0,932,2023-03-24T20:08,0,14900
862,1777081,53,8000,12800,96.0,1095,2023-03-24T20:08,0,8000
863,2347097,54,15900,24000,98.0,1490,2023-03-24T20:08,0,15900
864,2122868,55,9500,13900,97.0,3761,2023-03-24T20:08,0,9500
865,783120,56,13900,0,96.0,1388,2023-03-24T20:08,0,13900
866,2433154,57,30000,0,95.0,89,2023-03-24T20:08,0,30000
867,2649999,58,12800,16000,93.0,60,2023-03-24T20:08,0,12800
868,1092995,59,20590,22900,96.0,1583,2023-03-24T20:08,0,20590
869,1222903,60,22400,32000,97.0,512,2023-03-24T20:08,0,22400
870,2342849,61,15120,18900,91.0,108,2023-03-24T20:08,0,15120
871,1274401,62,17900,22800,96.0,296,2023-03-24T20:08,0,17900
872,1260384,63,19900,0,95.0,1787,2023-03-24T20:08,0,19900
873,2011850,64,21490,23900,98.0,841,2023-03-24T20:08,0,21490
874,792921,65,15190,16900,95.0,7805,2023-03-24T20:08,0,15190
875,3040532,66,20900,22000,91.0,9,2023-03-24T20:08,-4180,16720
876,1358721,67,14900,22000,96.0,1076,2023-03-24T20:08,0,14900
877,2973952,68,28800,48000,100.0,5,2023-03-24T20:08,0,28800
878,1547562,69,15400,22000,95.0,1348,2023-03-24T20:08,0,15400
879,1094837,70,13490,15900,96.0,1739,2023-03-24T20:08,0,13490
880,472686,71,9900,14800,94.0,694,2023-03-24T20:08,0,9900
881,2821589,72,19690,21900,96.0,28,2023-03-24T20:08,0,19690
882,2821590,73,19690,21900,98.0,37,2023-03-24T20:08,0,19690
883,1556774,74,15200,16000,96.0,463,2023-03-24T20:08,-3040,12160
884,1062063,75,9490,15900,96.0,2102,2023-03-24T20:08,0,9490
885,3113486,76,32000,0,0.0,0,2023-03-24T20:08,0,32000
886,2921285,77,32000,0,100.0,7,2023-03-24T20:08,0,32000
887,1348077,78,10900,16500,97.0,1836,2023-03-24T20:08,0,10900
888,958997,79,16090,17900,95.0,1398,2023-03-24T20:08,0,16090
889,1717607,80,13900,20800,96.0,2124,2023-03-24T20:08,0,13900
890,2971853,81,17100,19000,94.0,37,2023-03-24T20:08,0,17100
891,1286366,82,12900,24000,97.0,9762,2023-03-24T20:08,0,12900
892,1094836,83,14290,15900,97.0,1295,2023-03-24T20:08,0,14290
893,3123102,84,59000,0,0.0,0,2023-03-24T20:08,0,59000
894,1392777,85,16890,19900,96.0,381,2023-03-24T20:08,0,16890
895,2972927,86,21500,30000,100.0,5,2023-03-24T20:08,0,21500
896,2295818,87,19900,22000,94.0,174,2023-03-24T20:08,0,19900
897,3146033,88,48000,0,0.0,0,2023-03-24T20:08,-7200,40800
898,2011851,89,21490,23900,98.0,670,2023-03-24T20:08,0,21490
899,2477854,90,17890,19900,98.0,1429,2023-03-24T20:08,0,17890
