,item_id,rank,price,del_price,rating,rating_count,time,coupon,real_price
0,3163296,1,62300,89000,0.0,0,2023-03-26T00:13,-6230,56070
1,2272830,2,35910,39900,97.0,18120,2023-03-26T00:13,-7182,28728
2,3071087,3,84550,89000,95.0,264,2023-03-26T00:13,-16910,67640
3,2086653,4,16900,0,97.0,38307,2023-03-26T00:13,0,16900
4,3163289,5,62300,89000,0.0,0,2023-03-26T00:13,-6230,56070
5,1848166,6,34300,49000,97.0,40612,2023-03-26T00:13,0,34300
6,3163293,7,62300,89000,0.0,0,2023-03-26T00:13,-6230,56070
7,2453556,8,39900,42000,97.0,6119,2023-03-26T00:13,-7980,31920
8,2313388,9,85000,0,96.0,2040,2023-03-26T00:13,0,85000
9,3135731,10,59000,0,0.0,0,2023-03-26T00:13,0,59000
10,2149254,11,37800,0,97.0,32032,2023-03-26T00:13,-5670,32130
11,3162405,12,62300,89000,0.0,0,2023-03-26T00:13,-6230,56070
12,1848855,13,169000,0,97.0,89,2023-03-26T00:13,0,169000
13,345889,14,29900,47900,95.0,9488,2023-03-26T00:13,0,29900
14,1503352,15,39900,42000,97.0,8279,2023-03-26T00:13,-7980,31920
15,3034895,16,101150,119000,98.0,297,2023-03-26T00:13,0,101150
16,2453552,17,39900,42000,97.0,2858,2023-03-26T00:13,-7980,31920
17,1817394,18,59900,150000,93.0,7006,2023-03-26T00:13,0,59900
18,3034894,19,87200,109000,98.0,69,2023-03-26T00:13,0,87200
19,2646350,20,59800,94000,95.0,3849,2023-03-26T00:13,-11960,47840
20,2375962,21,59000,62000,98.0,5043,2023-03-26T00:13,-8850,50150
21,2326935,22,55300,79000,96.0,12752,2023-03-26T00:13,-5530,49770
22,1549281,23,71250,75000,97.0,5709,2023-03-26T00:13,-14250,57000
23,2396645,24,39900,59000,96.0,22927,2023-03-26T00:13,0,39900
24,2038497,25,36000,45000,95.0,16089,2023-03-26T00:13,-7200,28800
25,1939099,26,29400,49000,97.0,11551,2023-03-26T00:13,0,29400
26,1201421,27,199000,0,94.0,94,2023-03-26T00:13,0,199000
27,1828538,28,39900,69900,95.0,2856,2023-03-26T00:13,0,39900
28,2630449,29,33600,42000,96.0,485,2023-03-26T00:13,-3360,30240
29,2204747,30,71250,75000,97.0,2070,2023-03-26T00:13,-14250,57000
30,2877493,31,59800,92000,95.0,1300,2023-03-26T00:13,0,59800
31,1582356,32,49200,82000,96.0,15899,2023-03-26T00:13,0,49200
32,2314616,33,39000,43000,97.0,7963,2023-03-26T00:13,0,39000
33,1943792,34,34400,43000,96.0,5170,2023-03-26T00:13,0,34400
34,2065708,35,59000,62000,98.0,6393,2023-03-26T00:13,-8850,50150
35,2744370,36,55300,79000,96.0,1062,2023-03-26T00:13,-5530,49770
36,1782641,37,39900,42000,97.0,2568,2023-03-26T00:13,-7980,31920
37,2442409,38,31200,78000,96.0,8664,2023-03-26T00:13,0,31200
38,2711880,39,57400,82000,97.0,1209,2023-03-26T00:13,-5740,51660
39,1757501,40,27900,150000,93.0,2795,2023-03-26T00:13,0,27900
40,956939,41,61750,65000,95.0,13441,2023-03-26T00:13,-12350,49400
41,2660716,42,50400,72000,96.0,2003,2023-03-26T00:13,0,50400
42,1620270,43,189000,0,95.0,55,2023-03-26T00:13,0,189000
43,2996536,44,39900,59000,96.0,354,2023-03-26T00:13,0,39900
44,3135778,45,59000,0,0.0,0,2023-03-26T00:13,0,59000
45,2392759,46,39680,49600,95.0,3841,2023-03-26T00:13,-7936,31744
46,1782647,47,39900,42000,97.0,3445,2023-03-26T00:13,-7980,31920
47,3071089,48,84550,89000,98.0,83,2023-03-26T00:13,-16910,67640
48,996177,49,15900,0,95.0,77107,2023-03-26T00:13,0,15900
49,3114719,50,34300,49000,100.0,6,2023-03-26T00:13,0,34300
50,3160363,51,118000,0,100.0,1,2023-03-26T00:13,-11800,106200
51,2798627,52,1167000,1850000,0.0,0,2023-03-26T00:13,-30000,1137000
52,2562821,53,72800,91000,97.0,73,2023-03-26T00:13,0,72800
53,3056873,54,33120,72000,95.0,48,2023-03-26T00:13,0,33120
54,1763157,55,49400,52000,95.0,2576,2023-03-26T00:13,0,49400
55,2377269,56,45000,0,97.0,3719,2023-03-26T00:13,0,45000
56,3052036,57,59400,66000,95.0,98,2023-03-26T00:13,0,59400
57,1498105,58,189000,0,97.0,1945,2023-03-26T00:13,0,189000
58,1944612,59,35800,59700,97.0,2752,2023-03-26T00:13,-1790,34010
59,2970541,60,62100,69000,96.0,509,2023-03-26T00:13,0,62100
60,1417691,61,13900,0,97.0,18187,2023-03-26T00:13,0,13900
61,1841764,62,31200,39000,96.0,12958,2023-03-26T00:13,-3120,28080
62,2122566,63,33800,0,97.0,15072,2023-03-26T00:13,-6760,27040
63,2637707,64,680000,0,0.0,0,2023-03-26T00:13,-30000,650000
64,3129244,65,72000,0,96.0,6,2023-03-26T00:13,-3600,68400
65,3071084,66,51300,54000,95.0,81,2023-03-26T00:13,-10260,41040
66,3032250,67,44800,64000,95.0,667,2023-03-26T00:13,0,44800
67,2730861,68,39900,57000,94.0,172,2023-03-26T00:13,0,39900
68,994588,69,39900,53000,93.0,5915,2023-03-26T00:13,-3990,35910
69,3150516,70,79800,126000,93.0,12,2023-03-26T00:13,-15960,63840
70,3160073,71,69000,98000,94.0,11,2023-03-26T00:13,-13800,55200
71,2354252,72,71250,75000,97.0,1728,2023-03-26T00:13,-14250,57000
72,1308651,73,61750,65000,96.0,3989,2023-03-26T00:13,-12350,49400
73,2702542,74,178000,0,98.0,189,2023-03-26T00:13,-17800,160200
74,1706633,75,199000,0,97.0,2354,2023-03-26T00:13,0,199000
75,2740193,76,71250,75000,96.0,762,2023-03-26T00:13,-14250,57000
76,2034137,77,31800,0,97.0,16551,2023-03-26T00:13,-4770,27030
77,2065712,78,59000,62000,98.0,6550,2023-03-26T00:13,-8850,50150
78,2354305,79,71250,75000,96.0,1606,2023-03-26T00:13,-14250,57000
79,1336398,80,40200,67000,96.0,18944,2023-03-26T00:13,0,40200
80,854337,81,33900,0,95.0,17071,2023-03-26T00:13,-3390,30510
81,2812146,82,469000,1370000,100.0,4,2023-03-26T00:13,-30000,439000
82,2065703,83,59000,62000,98.0,5320,2023-03-26T00:13,-8850,50150
83,2758252,84,31050,69000,96.0,624,2023-03-26T00:13,0,31050
84,2722805,85,79000,0,96.0,883,2023-03-26T00:13,0,79000
85,2970543,86,62100,69000,97.0,249,2023-03-26T00:13,0,62100
86,1382658,87,16900,0,94.0,47055,2023-03-26T00:13,0,16900
87,2775710,88,29900,49000,93.0,2377,2023-03-26T00:13,-2990,26910
88,3026606,89,47900,64000,96.0,141,2023-03-26T00:13,-4790,43110
89,2684358,90,109000,0,97.0,3156,2023-03-26T00:13,0,109000
90,3135787,1,169000,0,0.0,0,2023-03-26T00:13,0,169000
91,1778404,2,42000,45000,96.0,66286,2023-03-26T00:13,0,42000
92,1856181,3,35910,39900,97.0,6823,2023-03-26T00:13,-7182,28728
93,1790383,4,59000,86000,95.0,5083,2023-03-26T00:13,-5900,53100
94,3054935,5,89900,0,0.0,0,2023-03-26T00:13,-8990,80910
95,1530516,6,69900,79000,96.0,2130,2023-03-26T00:13,0,69900
96,2343198,7,119000,129000,97.0,4832,2023-03-26T00:13,0,119000
97,1558197,8,81900,0,97.0,31899,2023-03-26T00:13,-8190,73710
98,2732486,9,74000,179000,98.0,527,2023-03-26T00:13,0,74000
99,2064545,10,74900,94000,97.0,10786,2023-03-26T00:13,-14980,59920
100,2723218,11,69900,109000,97.0,1892,2023-03-26T00:13,-6990,62910
101,1576700,12,89000,129000,97.0,16294,2023-03-26T00:13,0,89000
102,1683384,13,599000,0,100.0,19,2023-03-26T00:13,0,599000
103,1576682,14,245000,339000,97.0,8459,2023-03-26T00:13,-49000,196000
104,1283757,15,75390,83900,96.0,26407,2023-03-26T00:13,-7539,67851
105,3012082,16,59900,79000,97.0,759,2023-03-26T00:13,-5990,53910
106,2752332,17,84200,105300,95.0,2367,2023-03-26T00:13,0,84200
107,1618312,18,75390,83900,97.0,6939,2023-03-26T00:13,0,75390
108,3135786,19,169000,0,0.0,0,2023-03-26T00:13,0,169000
109,2788216,20,146000,159000,98.0,78,2023-03-26T00:13,-7300,138700
110,1969617,21,162000,0,96.0,2634,2023-03-26T00:13,0,162000
111,2496650,22,43900,109000,96.0,671,2023-03-26T00:13,0,43900
112,1195307,23,87550,103000,96.0,12456,2023-03-26T00:13,-8755,78795
113,1817381,24,47900,69000,96.0,908,2023-03-26T00:13,0,47900
114,2718413,25,126650,149000,97.0,1332,2023-03-26T00:13,0,126650
115,2715055,26,159000,189000,97.0,1909,2023-03-26T00:13,0,159000
116,2992133,27,1922000,5527000,0.0,0,2023-03-26T00:13,-30000,1892000
117,3090584,28,90000,119000,80.0,1,2023-03-26T00:13,-13500,76500
118,2471405,29,99000,138000,97.0,1926,2023-03-26T00:13,0,99000
119,2788219,30,146000,159000,96.0,240,2023-03-26T00:13,-7300,138700
120,1571879,31,79900,112900,96.0,6950,2023-03-26T00:13,-7990,71910
121,3036129,32,79800,94000,95.0,1501,2023-03-26T00:13,-15960,63840
122,2288704,33,121000,132000,97.0,3125,2023-03-26T00:13,0,121000
123,3176109,34,196000,0,0.0,0,2023-03-26T00:13,0,196000
124,3033224,35,59900,74000,97.0,462,2023-03-26T00:13,-5990,53910
125,2713034,36,79000,119000,97.0,27,2023-03-26T00:13,0,79000
126,1620285,37,299000,0,97.0,149,2023-03-26T00:13,0,299000
127,3079071,38,64900,87000,98.0,42,2023-03-26T00:13,-12980,51920
128,1280576,39,37200,62000,96.0,24987,2023-03-26T00:13,-7440,29760
129,3024070,40,143100,159000,98.0,267,2023-03-26T00:13,0,143100
130,1778408,41,42000,45000,95.0,11494,2023-03-26T00:13,0,42000
131,3042936,42,90900,105000,97.0,271,2023-03-26T00:13,0,90900
132,1108007,43,71790,79900,95.0,47756,2023-03-26T00:13,-7179,64611
133,1530517,44,69900,79000,96.0,1928,2023-03-26T00:13,0,69900
134,1593755,45,89360,111700,97.0,14341,2023-03-26T00:13,-17872,71488
135,1776552,46,60000,69000,94.0,6018,2023-03-26T00:13,-6000,54000
136,3031561,47,139200,174000,99.0,67,2023-03-26T00:13,-6960,132240
137,1633664,48,76300,109000,97.0,4052,2023-03-26T00:13,0,76300
138,2329532,49,119200,149000,97.0,3876,2023-03-26T00:13,0,119200
139,1291017,50,67900,96000,95.0,12812,2023-03-26T00:13,0,67900
140,3041963,51,350000,410000,96.0,56,2023-03-26T00:13,-70000,280000
141,3042244,52,159200,199000,96.0,43,2023-03-26T00:13,-31840,127360
142,3044137,53,99000,0,96.0,35,2023-03-26T00:13,-9900,89100
143,3030665,54,139200,174000,96.0,144,2023-03-26T00:13,0,139200
144,2683549,55,126650,149000,97.0,2479,2023-03-26T00:13,0,126650
145,2322836,56,139200,174000,97.0,954,2023-03-26T00:13,0,139200
146,3010527,57,237150,279000,97.0,141,2023-03-26T00:13,0,237150
147,2997428,58,76300,109000,98.0,187,2023-03-26T00:13,0,76300
148,406537,59,245000,339000,95.0,4393,2023-03-26T00:13,-49000,196000
149,1139192,60,71100,94900,97.0,14258,2023-03-26T00:13,-7110,63990
150,3091295,61,169000,0,0.0,0,2023-03-26T00:13,0,169000
151,3039957,62,71910,79900,99.0,82,2023-03-26T00:13,0,71910
152,1571878,63,79900,112900,96.0,4545,2023-03-26T00:13,-7990,71910
153,1337094,64,69900,0,95.0,5204,2023-03-26T00:13,-6990,62910
154,3044143,65,79200,99000,100.0,4,2023-03-26T00:13,0,79200
155,2086731,66,95000,129000,97.0,2132,2023-03-26T00:13,-19000,76000
156,3058495,67,198000,220000,98.0,51,2023-03-26T00:13,0,198000
157,1737051,68,62300,89000,96.0,5019,2023-03-26T00:13,0,62300
158,2288426,69,79000,109000,94.0,772,2023-03-26T00:13,-7900,71100
159,2297046,70,149000,199000,97.0,1629,2023-03-26T00:13,0,149000
160,2723772,71,109900,169000,95.0,936,2023-03-26T00:13,0,109900
161,2712632,72,107000,0,97.0,1264,2023-03-26T00:13,0,107000
162,3047185,73,109650,129000,90.0,8,2023-03-26T00:13,0,109650
163,2701889,74,58200,97000,95.0,4056,2023-03-26T00:13,0,58200
164,1776549,75,51000,69000,94.0,4564,2023-03-26T00:13,0,51000
165,1751722,76,53910,59900,97.0,3262,2023-03-26T00:13,-10782,43128
166,1760177,77,139200,174000,97.0,295,2023-03-26T00:13,0,139200
167,1139262,78,146000,159000,97.0,1828,2023-03-26T00:13,0,146000
168,2284220,79,79900,112900,96.0,1594,2023-03-26T00:13,0,79900
169,2064478,80,79900,138000,95.0,21116,2023-03-26T00:13,-15980,63920
170,3098417,81,189000,199000,96.0,449,2023-03-26T00:13,0,189000
171,2723216,82,47900,109000,97.0,932,2023-03-26T00:13,0,47900
172,2668986,83,35910,39900,96.0,3307,2023-03-26T00:13,-7182,28728
173,2110493,84,389000,0,96.0,600,2023-03-26T00:13,0,389000
174,2172006,85,121000,132000,96.0,2713,2023-03-26T00:13,0,121000
175,2407203,86,148500,165000,97.0,263,2023-03-26T00:13,0,148500
176,2375909,87,76290,89900,97.0,1456,2023-03-26T00:13,0,76290
177,3029811,88,63200,79000,98.0,174,2023-03-26T00:13,-6320,56880
178,2286964,89,66300,110500,97.0,4759,2023-03-26T00:13,-9945,56355
179,3055246,90,159000,0,98.0,32,2023-03-26T00:13,0,159000
180,3163311,1,63700,98000,98.0,21,2023-03-26T00:13,-6370,57330
181,3163314,2,63700,98000,96.0,56,2023-03-26T00:13,-6370,57330
182,1627892,3,43900,0,97.0,10239,2023-03-26T00:13,0,43900
183,2976721,4,168000,0,98.0,354,2023-03-26T00:13,-25200,142800
184,3163360,5,63700,98000,98.0,42,2023-03-26T00:13,-6370,57330
185,3163309,6,63700,98000,97.0,35,2023-03-26T00:13,-6370,57330
186,1627891,7,43900,0,97.0,791,2023-03-26T00:13,0,43900
187,2850706,8,168000,0,98.0,457,2023-03-26T00:13,-25200,142800
188,2112059,9,33900,52000,97.0,41938,2023-03-26T00:13,0,33900
189,1149329,10,39900,0,96.0,85175,2023-03-26T00:13,-3990,35910
190,2611226,11,43900,0,98.0,1026,2023-03-26T00:13,0,43900
191,1627893,12,43900,0,97.0,1862,2023-03-26T00:13,0,43900
192,1551840,13,39000,0,97.0,82564,2023-03-26T00:13,-3900,35100
193,750908,14,35900,54000,96.0,83287,2023-03-26T00:13,0,35900
194,1168906,15,41900,0,97.0,70356,2023-03-26T00:13,-4190,37710
195,3001844,16,128000,0,99.0,107,2023-03-26T00:13,-19200,108800
196,2060719,17,47800,69000,96.0,4771,2023-03-26T00:13,-4780,43020
197,2092852,18,42000,52800,96.0,10679,2023-03-26T00:13,-4200,37800
198,1149328,19,39900,0,96.0,94099,2023-03-26T00:13,-3990,35910
199,1568057,20,43400,62000,96.0,21837,2023-03-26T00:13,0,43400
200,2028327,21,49900,0,96.0,8700,2023-03-26T00:13,-4990,44910
201,2112061,22,36400,52000,97.0,14189,2023-03-26T00:13,-3640,32760
202,2060717,23,55200,69000,95.0,3567,2023-03-26T00:13,-5520,49680
203,2611227,24,43900,0,98.0,299,2023-03-26T00:13,0,43900
204,858911,25,39000,49000,95.0,66464,2023-03-26T00:13,-3900,35100
205,3135792,26,149000,0,0.0,0,2023-03-26T00:13,0,149000
206,1370101,27,39000,89000,96.0,22372,2023-03-26T00:13,0,39000
207,2184087,28,49000,89000,96.0,3912,2023-03-26T00:13,-4900,44100
208,3135781,29,89000,0,0.0,0,2023-03-26T00:13,0,89000
209,2107115,30,121500,135000,98.0,11576,2023-03-26T00:13,-6075,115425
210,3091296,31,129000,0,100.0,2,2023-03-26T00:13,0,129000
211,2723714,32,49300,58000,96.0,1338,2023-03-26T00:13,0,49300
212,1551839,33,39000,0,97.0,22947,2023-03-26T00:13,-3900,35100
213,2611229,34,43900,0,97.0,205,2023-03-26T00:13,0,43900
214,2060720,35,55200,69000,95.0,2413,2023-03-26T00:13,-5520,49680
215,3070909,36,125100,139000,100.0,3,2023-03-26T00:13,0,125100
216,2028326,37,49900,0,97.0,5899,2023-03-26T00:13,-4990,44910
217,1736085,38,39900,59800,96.0,36058,2023-03-26T00:13,0,39900
218,2351467,39,39800,54000,96.0,5810,2023-03-26T00:13,-3980,35820
219,2789111,40,84150,99000,97.0,703,2023-03-26T00:13,0,84150
220,1568032,41,43400,62000,96.0,5941,2023-03-26T00:13,0,43400
221,2261213,42,121500,135000,98.0,4024,2023-03-26T00:13,-6075,115425
222,1552753,43,63960,78000,97.0,27912,2023-03-26T00:13,-6396,57564
223,3141395,44,49900,73900,97.0,46,2023-03-26T00:13,-4990,44910
224,1222184,45,41900,0,97.0,48026,2023-03-26T00:13,-4190,37710
225,2060759,46,59800,74800,97.0,7020,2023-03-26T00:13,-8970,50830
226,890521,47,39800,63000,94.0,10842,2023-03-26T00:13,0,39800
227,2028329,48,49900,0,95.0,6334,2023-03-26T00:13,-4990,44910
228,1477272,49,44200,68000,96.0,17573,2023-03-26T00:13,-2210,41990
229,1573215,50,133200,148000,98.0,9155,2023-03-26T00:13,-6660,126540
230,2060743,51,33000,55000,95.0,3382,2023-03-26T00:13,-1650,31350
231,2789091,52,84150,99000,96.0,604,2023-03-26T00:13,0,84150
232,3103699,53,75650,89000,100.0,3,2023-03-26T00:13,-7565,68085
233,1555407,54,63960,78000,97.0,11333,2023-03-26T00:13,-6396,57564
234,890338,55,39000,49000,95.0,47399,2023-03-26T00:13,-3900,35100
235,732703,56,116100,129000,97.0,3882,2023-03-26T00:13,0,116100
236,3011537,57,44910,49900,97.0,177,2023-03-26T00:13,-8982,35928
237,1212776,58,28690,31900,96.0,23010,2023-03-26T00:13,0,28690
238,2358429,59,135150,159000,98.0,2529,2023-03-26T00:13,-13515,121635
239,2706287,60,39800,54000,95.0,3448,2023-03-26T00:13,-3980,35820
240,3034871,61,88200,126000,98.0,119,2023-03-26T00:13,0,88200
241,2032901,62,39900,0,97.0,6624,2023-03-26T00:13,-3990,35910
242,2678415,63,33900,69000,97.0,357,2023-03-26T00:13,0,33900
243,1539028,64,44500,89000,95.0,4665,2023-03-26T00:13,0,44500
244,2678399,65,33900,69000,96.0,423,2023-03-26T00:13,0,33900
245,1960424,66,43600,59000,95.0,1061,2023-03-26T00:13,0,43600
246,3046898,67,69900,89000,95.0,26,2023-03-26T00:13,-6990,62910
247,2929838,68,69550,107000,96.0,306,2023-03-26T00:13,0,69550
248,890519,69,39800,63000,95.0,6630,2023-03-26T00:13,0,39800
249,2678417,70,33900,69000,96.0,357,2023-03-26T00:13,0,33900
250,3135780,71,89000,0,0.0,0,2023-03-26T00:13,0,89000
251,2569078,72,79000,0,96.0,2343,2023-03-26T00:13,0,79000
252,2131950,73,39000,49000,97.0,3553,2023-03-26T00:13,-3900,35100
253,2069525,74,41900,0,96.0,3610,2023-03-26T00:13,-4190,37710
254,3062950,75,125100,139000,99.0,21,2023-03-26T00:13,0,125100
255,1666442,76,49900,0,97.0,10764,2023-03-26T00:13,0,49900
256,1403480,77,77000,98000,97.0,7627,2023-03-26T00:13,-11550,65450
257,2749153,78,66600,74000,97.0,480,2023-03-26T00:13,0,66600
258,1168922,79,43900,0,96.0,17989,2023-03-26T00:13,-4390,39510
259,2562527,80,29400,42000,97.0,3831,2023-03-26T00:13,-4410,24990
260,1926048,81,32000,0,97.0,14481,2023-03-26T00:13,-3200,28800
261,2744549,82,43400,62000,97.0,4808,2023-03-26T00:13,0,43400
262,3130020,83,175000,0,0.0,0,2023-03-26T00:13,-35000,140000
263,1985223,84,39000,89000,96.0,1498,2023-03-26T00:13,0,39000
264,2569079,85,59250,79000,96.0,1057,2023-03-26T00:13,0,59250
265,1885479,86,39000,49000,96.0,5354,2023-03-26T00:13,-3900,35100
266,2709031,87,36700,52800,96.0,3364,2023-03-26T00:13,-3670,33030
267,3090588,88,60000,79000,0.0,0,2023-03-26T00:13,-9000,51000
268,1595607,89,57900,89000,97.0,5572,2023-03-26T00:13,-5790,52110
269,3022892,90,39000,49000,96.0,276,2023-03-26T00:13,-3900,35100
270,2558648,1,119000,0,98.0,1194,2023-03-26T00:13,0,119000
271,1034480,2,135000,150000,97.0,17856,2023-03-26T00:13,0,135000
272,1789507,3,79000,0,98.0,25502,2023-03-26T00:13,0,79000
273,1969507,4,88000,0,98.0,5211,2023-03-26T00:13,0,88000
274,2235274,5,145000,0,97.0,624,2023-03-26T00:13,0,145000
275,3038000,6,66400,83000,96.0,230,2023-03-26T00:13,-9960,56440
276,2700388,7,583000,0,100.0,7,2023-03-26T00:13,0,583000
277,3050557,8,2027000,3290000,0.0,0,2023-03-26T00:13,-30000,1997000
278,2344538,9,119000,0,98.0,6210,2023-03-26T00:13,0,119000
279,2911059,10,440000,650000,98.0,44,2023-03-26T00:13,-30000,410000
280,2901264,11,2638000,3250000,0.0,0,2023-03-26T00:13,-30000,2608000
281,2344540,12,96000,0,98.0,9018,2023-03-26T00:13,0,96000
282,1842449,13,84000,99000,97.0,5267,2023-03-26T00:13,0,84000
283,2789785,14,140600,148000,97.0,538,2023-03-26T00:13,-28120,112480
284,3061872,15,80100,89000,90.0,16,2023-03-26T00:13,0,80100
285,2271789,16,71100,79000,97.0,2423,2023-03-26T00:13,0,71100
286,2998775,17,142200,158000,96.0,413,2023-03-26T00:13,-28440,113760
287,1264107,18,65000,90000,97.0,6191,2023-03-26T00:13,0,65000
288,2705105,19,756000,0,0.0,0,2023-03-26T00:13,0,756000
289,3017823,20,2365500,3500000,0.0,0,2023-03-26T00:13,-30000,2335500
290,1581689,21,75600,89000,97.0,3892,2023-03-26T00:13,0,75600
291,2066837,22,79000,119000,97.0,6320,2023-03-26T00:13,-7900,71100
292,3034751,23,61200,72000,97.0,301,2023-03-26T00:13,0,61200
293,3034749,24,61200,72000,97.0,331,2023-03-26T00:13,0,61200
294,2343665,25,89000,0,97.0,4451,2023-03-26T00:13,0,89000
295,3024801,26,138000,0,100.0,12,2023-03-26T00:13,0,138000
296,2577899,27,138000,0,97.0,280,2023-03-26T00:13,0,138000
297,2954961,28,95000,0,96.0,339,2023-03-26T00:13,0,95000
298,2637724,29,1030000,0,0.0,0,2023-03-26T00:13,-30000,1000000
299,3061988,30,80100,89000,0.0,0,2023-03-26T00:13,0,80100
300,2584181,31,57600,72000,98.0,750,2023-03-26T00:13,0,57600
301,2979849,32,1852000,2370000,100.0,3,2023-03-26T00:13,-30000,1822000
302,1969488,33,88000,0,98.0,1676,2023-03-26T00:13,0,88000
303,2664933,34,90000,0,96.0,310,2023-03-26T00:13,0,90000
304,2700255,35,1876000,0,0.0,0,2023-03-26T00:13,0,1876000
305,2849890,36,1798000,2550000,100.0,1,2023-03-26T00:13,-30000,1768000
306,2408317,37,145800,162000,96.0,332,2023-03-26T00:13,0,145800
307,3037524,38,79200,88000,95.0,9,2023-03-26T00:13,-15840,63360
308,2320927,39,39000,51000,97.0,1968,2023-03-26T00:13,0,39000
309,1835080,40,98000,0,97.0,2662,2023-03-26T00:13,0,98000
310,2112494,41,105000,0,95.0,95,2023-03-26T00:13,0,105000
311,1576725,42,137000,197000,97.0,5209,2023-03-26T00:13,-27400,109600
312,1758217,43,43900,56000,97.0,13029,2023-03-26T00:13,-8780,35120
313,2698604,44,1550000,0,100.0,1,2023-03-26T00:13,-30000,1520000
314,1744101,45,103500,109000,98.0,2789,2023-03-26T00:13,0,103500
315,2902040,46,390000,600000,100.0,35,2023-03-26T00:13,-30000,360000
316,2777545,47,130000,0,96.0,162,2023-03-26T00:13,0,130000
317,2911052,48,239000,400000,100.0,8,2023-03-26T00:13,-30000,209000
318,3061969,49,80100,89000,97.0,7,2023-03-26T00:13,0,80100
319,2514819,50,59000,66000,97.0,746,2023-03-26T00:13,-4130,54870
320,1263004,51,159000,0,97.0,5224,2023-03-26T00:13,0,159000
321,2954959,52,95000,0,95.0,172,2023-03-26T00:13,0,95000
322,342189,53,39500,52000,95.0,15594,2023-03-26T00:13,0,39500
323,1564343,54,92800,119000,98.0,8024,2023-03-26T00:13,0,92800
324,3142253,55,39900,49600,0.0,0,2023-03-26T00:13,-7980,31920
325,3047568,56,119970,129000,95.0,31,2023-03-26T00:13,0,119970
326,2377589,57,128000,0,97.0,388,2023-03-26T00:13,0,128000
327,2930265,58,91000,0,98.0,504,2023-03-26T00:13,0,91000
328,3161264,59,92700,109000,0.0,0,2023-03-26T00:13,-4635,88065
329,2789786,60,150100,158000,97.0,202,2023-03-26T00:13,-30020,120080
330,3161263,61,92700,109000,0.0,0,2023-03-26T00:13,-4635,88065
331,3034743,62,71400,84000,96.0,162,2023-03-26T00:13,0,71400
332,2657250,63,125400,149000,98.0,89,2023-03-26T00:13,0,125400
333,3029926,64,285000,0,98.0,39,2023-03-26T00:13,0,285000
334,2770504,65,138000,0,95.0,128,2023-03-26T00:13,0,138000
335,693318,66,79000,110000,96.0,13085,2023-03-26T00:13,0,79000
336,2754080,67,88000,0,97.0,448,2023-03-26T00:13,0,88000
337,1969479,68,88000,0,98.0,1084,2023-03-26T00:13,0,88000
338,1835064,69,98000,0,96.0,726,2023-03-26T00:13,0,98000
339,1528287,70,46500,49000,96.0,4485,2023-03-26T00:13,0,46500
340,2911054,71,1098000,1590000,96.0,27,2023-03-26T00:13,-30000,1068000
341,2393881,72,1387000,2650000,100.0,1,2023-03-26T00:13,-30000,1357000
342,2749468,73,1024000,1690000,86.0,12,2023-03-26T00:13,-30000,994000
343,2624678,74,145000,0,96.0,130,2023-03-26T00:13,0,145000
344,2652361,75,138000,0,100.0,3,2023-03-26T00:13,0,138000
345,1964770,76,59400,66000,97.0,2428,2023-03-26T00:13,0,59400
346,1323612,77,238000,0,97.0,3792,2023-03-26T00:13,-11900,226100
347,2911056,78,408000,755000,100.0,10,2023-03-26T00:13,-30000,378000
348,2702033,79,127200,159000,97.0,370,2023-03-26T00:13,0,127200
349,2637722,80,380000,0,100.0,7,2023-03-26T00:13,-30000,350000
350,913402,81,83000,98000,95.0,7976,2023-03-26T00:13,0,83000
351,2042943,82,34000,0,97.0,167,2023-03-26T00:13,0,34000
352,2704382,83,298000,0,100.0,2,2023-03-26T00:13,0,298000
353,3029920,84,275000,0,98.0,25,2023-03-26T00:13,0,275000
354,3099796,85,49000,0,100.0,19,2023-03-26T00:13,-9800,39200
355,2760920,86,80100,89000,97.0,198,2023-03-26T00:13,-16020,64080
356,2828302,87,1170000,2250000,100.0,8,2023-03-26T00:13,-30000,1140000
357,2993947,88,100000,0,96.0,124,2023-03-26T00:13,0,100000
358,2633456,89,664000,0,90.0,4,2023-03-26T00:13,0,664000
359,1910358,90,99000,0,98.0,2429,2023-03-26T00:13,0,99000
360,2705116,1,654000,0,93.0,3,2023-03-26T00:13,-30000,624000
361,577636,2,99900,139000,95.0,30938,2023-03-26T00:13,0,99900
362,3136271,3,89100,99000,0.0,0,2023-03-26T00:13,0,89100
363,2293400,4,129000,0,96.0,837,2023-03-26T00:13,0,129000
364,1622068,5,119000,0,97.0,6352,2023-03-26T00:13,0,119000
365,2638067,6,99000,139000,97.0,2835,2023-03-26T00:13,0,99000
366,969541,7,69000,0,97.0,29021,2023-03-26T00:13,0,69000
367,3136269,8,89100,99000,0.0,0,2023-03-26T00:13,0,89100
368,810034,9,85500,95000,97.0,44997,2023-03-26T00:13,0,85500
369,3091287,10,119000,0,97.0,184,2023-03-26T00:13,0,119000
370,1762407,11,260000,0,97.0,3029,2023-03-26T00:13,0,260000
371,2700384,12,754000,0,100.0,3,2023-03-26T00:13,-30000,724000
372,2320478,13,129000,0,97.0,424,2023-03-26T00:13,0,129000
373,311052,14,53100,59000,97.0,40925,2023-03-26T00:13,0,53100
374,3030422,15,139000,0,96.0,746,2023-03-26T00:13,0,139000
375,186610,16,75900,85000,97.0,16403,2023-03-26T00:13,0,75900
376,1762406,17,260000,0,98.0,3194,2023-03-26T00:13,0,260000
377,2622254,18,109000,0,98.0,823,2023-03-26T00:13,0,109000
378,3005191,19,169000,0,96.0,146,2023-03-26T00:13,-8450,160550
379,695334,20,78900,99000,96.0,9134,2023-03-26T00:13,0,78900
380,1686571,21,59900,129000,97.0,5276,2023-03-26T00:13,0,59900
381,181907,22,89900,119000,97.0,7001,2023-03-26T00:13,0,89900
382,2233180,23,75900,109000,97.0,14047,2023-03-26T00:13,0,75900
383,1900410,24,129000,0,97.0,4807,2023-03-26T00:13,0,129000
384,2861393,25,109900,139000,93.0,247,2023-03-26T00:13,0,109900
385,2918213,26,129000,0,97.0,192,2023-03-26T00:13,-6450,122550
386,2992063,27,280000,0,98.0,2065,2023-03-26T00:13,0,280000
387,810033,28,89100,99000,97.0,34135,2023-03-26T00:13,0,89100
388,2673444,29,39900,149000,95.0,143,2023-03-26T00:13,0,39900
389,2383963,30,139000,0,96.0,117,2023-03-26T00:13,0,139000
390,2861392,31,124900,139000,97.0,534,2023-03-26T00:13,0,124900
391,490136,32,76000,95000,98.0,1975,2023-03-26T00:13,0,76000
392,3079037,33,195000,0,97.0,161,2023-03-26T00:13,0,195000
393,102620,34,69000,0,97.0,17682,2023-03-26T00:13,0,69000
394,816033,35,70900,89000,96.0,13134,2023-03-26T00:13,0,70900
395,3033248,36,109000,0,97.0,550,2023-03-26T00:13,0,109000
396,3136286,37,89100,99000,0.0,0,2023-03-26T00:13,0,89100
397,2861395,38,109900,139000,96.0,459,2023-03-26T00:13,0,109900
398,2524840,39,139000,0,97.0,777,2023-03-26T00:13,0,139000
399,1792640,40,99000,0,98.0,3382,2023-03-26T00:13,0,99000
400,2784034,41,766000,0,90.0,4,2023-03-26T00:13,-30000,736000
401,810032,42,85500,95000,97.0,13670,2023-03-26T00:13,0,85500
402,2778805,43,99000,0,97.0,876,2023-03-26T00:13,0,99000
403,2577087,44,89900,139000,97.0,330,2023-03-26T00:13,0,89900
404,2741233,45,109000,0,97.0,2571,2023-03-26T00:13,0,109000
405,3100522,46,129000,0,98.0,124,2023-03-26T00:13,0,129000
406,1494180,47,71100,79000,95.0,5184,2023-03-26T00:13,0,71100
407,3096431,48,139000,0,98.0,17,2023-03-26T00:13,0,139000
408,957758,49,89000,0,97.0,4307,2023-03-26T00:13,0,89000
409,2161992,50,69900,95000,98.0,3116,2023-03-26T00:13,0,69900
410,2996167,51,109900,139000,98.0,119,2023-03-26T00:13,0,109900
411,1744960,52,119900,149000,97.0,8185,2023-03-26T00:13,0,119900
412,3023097,53,230000,0,98.0,76,2023-03-26T00:13,0,230000
413,3143330,54,84550,89000,0.0,0,2023-03-26T00:13,0,84550
414,2493214,55,169000,0,98.0,152,2023-03-26T00:13,0,169000
415,2970198,56,69900,89000,97.0,178,2023-03-26T00:13,0,69900
416,1493265,57,85500,95000,98.0,4823,2023-03-26T00:13,0,85500
417,311050,58,53100,59000,97.0,8960,2023-03-26T00:13,0,53100
418,1296778,59,99000,0,98.0,2022,2023-03-26T00:13,0,99000
419,1817778,60,69000,0,97.0,4046,2023-03-26T00:13,0,69000
420,1608813,61,59900,75000,97.0,908,2023-03-26T00:13,0,59900
421,311051,62,58500,65000,97.0,19476,2023-03-26T00:13,0,58500
422,2682873,63,220000,0,97.0,89,2023-03-26T00:13,0,220000
423,2268512,64,109000,0,97.0,397,2023-03-26T00:13,0,109000
424,2801304,65,414000,700000,98.0,180,2023-03-26T00:13,-30000,384000
425,2992069,66,109900,139000,97.0,163,2023-03-26T00:13,0,109900
426,2820552,67,832000,0,100.0,7,2023-03-26T00:13,-30000,802000
427,2899656,68,109900,159000,95.0,74,2023-03-26T00:13,0,109900
428,2859857,69,44900,79000,96.0,182,2023-03-26T00:13,0,44900
429,1608838,70,85000,0,97.0,12542,2023-03-26T00:13,0,85000
430,1635193,71,59390,69900,96.0,3614,2023-03-26T00:13,-5939,53451
431,2733049,72,47600,119000,96.0,437,2023-03-26T00:13,0,47600
432,2899664,73,109900,159000,97.0,88,2023-03-26T00:13,0,109900
433,2355071,74,265000,0,97.0,471,2023-03-26T00:13,0,265000
434,2801305,75,443000,700000,99.0,186,2023-03-26T00:13,-30000,413000
435,2622252,76,109000,0,97.0,199,2023-03-26T00:13,0,109000
436,104240,77,69000,0,96.0,3822,2023-03-26T00:13,0,69000
437,1990244,78,129000,0,98.0,1003,2023-03-26T00:13,0,129000
438,490135,79,75900,95000,97.0,3099,2023-03-26T00:13,0,75900
439,2731878,80,67900,79000,97.0,1455,2023-03-26T00:13,0,67900
440,1492897,81,75000,0,96.0,2998,2023-03-26T00:13,0,75000
441,3136289,82,89100,99000,0.0,0,2023-03-26T00:13,0,89100
442,1473136,83,119900,149000,97.0,10736,2023-03-26T00:13,0,119900
443,1296776,84,99000,0,98.0,2907,2023-03-26T00:13,0,99000
444,2440110,85,53910,59900,97.0,799,2023-03-26T00:13,-4010,49900
445,2737460,86,230000,0,98.0,122,2023-03-26T00:13,0,230000
446,1812247,87,80100,89000,97.0,3001,2023-03-26T00:13,-4005,76095
447,490134,88,75900,95000,97.0,1916,2023-03-26T00:13,0,75900
448,1478592,89,75900,95000,97.0,2875,2023-03-26T00:13,0,75900
449,2469965,90,94900,149000,96.0,1077,2023-03-26T00:13,0,94900
450,3156676,1,259000,299000,0.0,0,2023-03-26T00:13,-12950,246050
451,3156683,2,259000,299000,0.0,0,2023-03-26T00:13,-12950,246050
452,2803698,3,9900,49000,94.0,127,2023-03-26T00:13,0,9900
453,1092992,4,69000,0,97.0,37556,2023-03-26T00:13,0,69000
454,3156658,5,259000,299000,0.0,0,2023-03-26T00:13,-12950,246050
455,2624538,6,40900,59000,97.0,1272,2023-03-26T00:13,0,40900
456,595040,7,210000,0,95.0,8694,2023-03-26T00:13,0,210000
457,2432733,8,44900,59000,97.0,2600,2023-03-26T00:13,0,44900
458,2210201,9,259000,299000,94.0,191,2023-03-26T00:13,-12950,246050
459,2430426,10,169000,0,98.0,692,2023-03-26T00:13,0,169000
460,2664372,11,58500,65000,97.0,920,2023-03-26T00:13,0,58500
461,2664373,12,58500,65000,97.0,895,2023-03-26T00:13,0,58500
462,3075621,13,339000,0,98.0,53,2023-03-26T00:13,0,339000
463,2069832,14,199900,332000,95.0,736,2023-03-26T00:13,-39980,159920
464,595039,15,210000,0,97.0,3466,2023-03-26T00:13,0,210000
465,1730340,16,232200,258000,97.0,4096,2023-03-26T00:13,-16254,215946
466,2433538,17,86700,102000,96.0,2298,2023-03-26T00:13,-6069,80631
467,2091749,18,75650,89000,95.0,6130,2023-03-26T00:13,0,75650
468,1339622,19,42900,59000,97.0,16063,2023-03-26T00:13,0,42900
469,3124961,20,62100,69000,85.0,7,2023-03-26T00:13,-3105,58995
470,2910082,21,265500,295000,98.0,415,2023-03-26T00:13,0,265500
471,1334440,22,100000,170000,96.0,2041,2023-03-26T00:13,0,100000
472,1730341,23,180600,258000,96.0,406,2023-03-26T00:13,-12642,167958
473,1129750,24,69000,0,97.0,3851,2023-03-26T00:13,0,69000
474,1568047,25,143100,159000,95.0,11956,2023-03-26T00:13,0,143100
475,2784025,26,1389000,0,0.0,0,2023-03-26T00:13,-30000,1359000
476,2555608,27,259000,299000,93.0,24,2023-03-26T00:13,-12950,246050
477,1699941,28,67150,79000,97.0,4728,2023-03-26T00:13,-3358,63792
478,2419871,29,44900,59000,97.0,846,2023-03-26T00:13,0,44900
479,2143833,30,91800,108000,96.0,2355,2023-03-26T00:13,-6426,85374
480,3061996,31,88200,98000,97.0,36,2023-03-26T00:13,-4410,83790
481,2210246,32,259000,299000,97.0,84,2023-03-26T00:13,-12950,246050
482,1548618,33,152000,198000,96.0,3276,2023-03-26T00:13,-10640,141360
483,2856882,34,518000,1090000,80.0,1,2023-03-26T00:13,-30000,488000
484,2688345,35,1143000,1360000,99.0,37,2023-03-26T00:13,-30000,1113000
485,2589483,36,58500,65000,97.0,1239,2023-03-26T00:13,0,58500
486,2518112,37,89250,105000,96.0,911,2023-03-26T00:13,-6248,83002
487,2929306,38,1084000,1520000,0.0,0,2023-03-26T00:13,-30000,1054000
488,2816816,39,159900,0,97.0,1802,2023-03-26T00:13,0,159900
489,2818506,40,168000,280000,95.0,114,2023-03-26T00:13,0,168000
490,2707264,41,239000,0,99.0,30,2023-03-26T00:13,0,239000
491,2777273,42,249000,450000,0.0,0,2023-03-26T00:13,-30000,219000
492,1262089,43,300000,0,97.0,1578,2023-03-26T00:13,0,300000
493,1815709,44,132000,168000,96.0,7097,2023-03-26T00:13,-9240,122760
494,2910086,45,265500,295000,98.0,169,2023-03-26T00:13,0,265500
495,2816812,46,119900,0,92.0,1486,2023-03-26T00:13,0,119900
496,2363570,47,39900,55000,97.0,911,2023-03-26T00:13,0,39900
497,2750309,48,44900,59000,98.0,351,2023-03-26T00:13,0,44900
498,3084397,49,128000,182000,0.0,0,2023-03-26T00:13,0,128000
499,1334438,50,170000,0,96.0,4375,2023-03-26T00:13,0,170000
500,1087674,51,65100,93000,95.0,1746,2023-03-26T00:13,0,65100
501,3062046,52,78300,87000,95.0,53,2023-03-26T00:13,-3915,74385
502,451851,53,268000,0,97.0,1938,2023-03-26T00:13,0,268000
503,3049313,54,57100,64900,97.0,381,2023-03-26T00:13,0,57100
504,2093153,55,369000,0,97.0,21,2023-03-26T00:13,0,369000
505,3024585,56,59000,0,97.0,74,2023-03-26T00:13,-11800,47200
506,1828555,57,206400,258000,96.0,383,2023-03-26T00:13,-14448,191952
507,2322211,58,120000,200000,97.0,102,2023-03-26T00:13,0,120000
508,2791587,59,150000,300000,91.0,12,2023-03-26T00:13,0,150000
509,607298,60,53600,59000,93.0,15538,2023-03-26T00:13,-3752,49848
510,2727925,61,196000,390000,0.0,0,2023-03-26T00:13,-30000,166000
511,2435822,62,99000,0,97.0,180,2023-03-26T00:13,0,99000
512,2814394,63,120000,240000,0.0,0,2023-03-26T00:13,0,120000
513,2101924,64,99900,0,96.0,1330,2023-03-26T00:13,-9990,89910
514,2684746,65,230000,0,98.0,55,2023-03-26T00:13,0,230000
515,1617116,66,340000,0,97.0,38,2023-03-26T00:13,0,340000
516,1890398,67,132000,168000,96.0,2666,2023-03-26T00:13,-9240,122760
517,1021359,68,76000,100000,94.0,5367,2023-03-26T00:13,-5320,70680
518,2437045,69,157000,218000,97.0,475,2023-03-26T00:13,-10990,146010
519,2972872,70,65000,0,97.0,281,2023-03-26T00:13,0,65000
520,1273517,71,14900,34000,97.0,1273,2023-03-26T00:13,0,14900
521,665782,72,260000,0,95.0,3630,2023-03-26T00:13,0,260000
522,2210207,73,259000,299000,92.0,113,2023-03-26T00:13,-12950,246050
523,1720827,74,169000,0,98.0,561,2023-03-26T00:13,0,169000
524,3103382,75,57900,65000,95.0,9,2023-03-26T00:13,0,57900
525,1262092,76,250000,0,96.0,764,2023-03-26T00:13,0,250000
526,127121,77,141000,152000,95.0,1860,2023-03-26T00:13,-9870,131130
527,3103381,78,57900,65000,95.0,31,2023-03-26T00:13,0,57900
528,1438359,79,98000,0,97.0,1153,2023-03-26T00:13,0,98000
529,2383245,80,99000,0,98.0,786,2023-03-26T00:13,0,99000
530,2921902,81,139000,0,95.0,18,2023-03-26T00:13,0,139000
531,2814390,82,132000,220000,96.0,19,2023-03-26T00:13,0,132000
532,2599641,83,65450,119000,96.0,1948,2023-03-26T00:13,0,65450
533,3124959,84,52200,58000,100.0,12,2023-03-26T00:13,-2610,49590
534,2814378,85,100000,200000,96.0,18,2023-03-26T00:13,0,100000
535,2210153,86,259000,299000,91.0,38,2023-03-26T00:13,-12950,246050
536,3084457,87,138000,197000,100.0,5,2023-03-26T00:13,-13800,124200
537,2614276,88,69000,0,97.0,518,2023-03-26T00:13,0,69000
538,2987731,89,189050,199000,96.0,11,2023-03-26T00:13,-9453,179597
539,1215246,90,54300,110000,95.0,342,2023-03-26T00:13,0,54300
540,3061175,1,89000,0,99.0,96,2023-03-26T00:13,0,89000
541,2286829,2,24050,37000,95.0,4738,2023-03-26T00:13,0,24050
542,1214164,3,36000,0,96.0,24772,2023-03-26T00:13,0,36000
543,2879419,4,46900,55000,98.0,582,2023-03-26T00:13,0,46900
544,2280117,5,35100,39000,97.0,6045,2023-03-26T00:13,0,35100
545,2287158,6,24050,37000,95.0,1126,2023-03-26T00:13,0,24050
546,1022013,7,79000,0,96.0,6223,2023-03-26T00:13,0,79000
547,1822717,8,56050,59000,97.0,4243,2023-03-26T00:13,-2803,53247
548,1214109,9,36000,0,97.0,8004,2023-03-26T00:13,0,36000
549,1771137,10,26100,29000,97.0,12324,2023-03-26T00:13,0,26100
550,3135790,11,69000,0,0.0,0,2023-03-26T00:13,0,69000
551,2810075,12,199000,550000,100.0,1,2023-03-26T00:13,-30000,169000
552,3135789,13,69000,0,0.0,0,2023-03-26T00:13,0,69000
553,2134140,14,39000,0,97.0,3423,2023-03-26T00:13,0,39000
554,1907733,15,29900,39000,96.0,3754,2023-03-26T00:13,0,29900
555,1272626,16,36000,0,96.0,14021,2023-03-26T00:13,0,36000
556,2123132,17,39000,0,97.0,6325,2023-03-26T00:13,0,39000
557,1836699,18,79000,0,97.0,233,2023-03-26T00:13,0,79000
558,2356713,19,39000,0,97.0,1404,2023-03-26T00:13,0,39000
559,2560668,20,58650,69000,97.0,1207,2023-03-26T00:13,0,58650
560,1214174,21,36000,0,97.0,14932,2023-03-26T00:13,0,36000
561,1214317,22,36000,0,97.0,11417,2023-03-26T00:13,0,36000
562,1771132,23,26100,29000,96.0,5157,2023-03-26T00:13,0,26100
563,2464070,24,44000,55000,97.0,271,2023-03-26T00:13,-2200,41800
564,1920929,25,39000,0,97.0,3930,2023-03-26T00:13,0,39000
565,2879425,26,46900,55000,97.0,216,2023-03-26T00:13,0,46900
566,3012243,27,27900,39900,97.0,39,2023-03-26T00:13,-1953,25947
567,1214169,28,36000,0,97.0,5289,2023-03-26T00:13,0,36000
568,1771133,29,26100,29000,97.0,5623,2023-03-26T00:13,0,26100
569,1498091,30,79000,0,97.0,59,2023-03-26T00:13,0,79000
570,1524720,31,36000,0,96.0,3345,2023-03-26T00:13,0,36000
571,2134158,32,39000,0,97.0,2439,2023-03-26T00:13,0,39000
572,2028240,33,39000,0,98.0,3314,2023-03-26T00:13,0,39000
573,1214173,34,36000,0,96.0,5505,2023-03-26T00:13,0,36000
574,2329375,35,34710,39000,97.0,2044,2023-03-26T00:13,0,34710
575,2356711,36,39000,0,97.0,1433,2023-03-26T00:13,0,39000
576,1855444,37,37800,42000,97.0,2954,2023-03-26T00:13,0,37800
577,1906772,38,37800,42000,97.0,3002,2023-03-26T00:13,0,37800
578,1022012,39,79000,0,94.0,2777,2023-03-26T00:13,0,79000
579,2715553,40,68000,0,95.0,231,2023-03-26T00:13,0,68000
580,2287131,41,37000,0,95.0,1555,2023-03-26T00:13,0,37000
581,2591291,42,39200,49000,97.0,993,2023-03-26T00:13,0,39200
582,2859190,43,37000,0,96.0,387,2023-03-26T00:13,0,37000
583,1022014,44,79000,0,96.0,11393,2023-03-26T00:13,0,79000
584,1632175,45,39000,0,97.0,2678,2023-03-26T00:13,0,39000
585,2707659,46,37800,42000,97.0,484,2023-03-26T00:13,0,37800
586,1452917,47,69000,0,96.0,2395,2023-03-26T00:13,0,69000
587,2280146,48,35100,39000,97.0,885,2023-03-26T00:13,0,35100
588,2672186,49,20900,30000,96.0,525,2023-03-26T00:13,-2090,18810
589,2107999,50,36000,0,97.0,2625,2023-03-26T00:13,0,36000
590,3099130,51,54000,0,100.0,9,2023-03-26T00:13,0,54000
591,2929168,52,430000,790000,0.0,0,2023-03-26T00:13,-30000,400000
592,1497550,53,29600,37000,95.0,5618,2023-03-26T00:13,0,29600
593,2286799,54,24050,37000,95.0,768,2023-03-26T00:13,0,24050
594,1214193,55,39000,0,97.0,15297,2023-03-26T00:13,0,39000
595,2980928,56,308000,490000,100.0,12,2023-03-26T00:13,-30000,278000
596,2603392,57,42750,45000,93.0,105,2023-03-26T00:13,-8550,34200
597,2650966,58,46900,53000,97.0,174,2023-03-26T00:13,0,46900
598,2356693,59,39000,0,97.0,1497,2023-03-26T00:13,0,39000
599,1925814,60,35100,39000,96.0,1618,2023-03-26T00:13,0,35100
600,1931716,61,56050,59000,97.0,244,2023-03-26T00:13,0,56050
601,2287312,62,24050,37000,95.0,203,2023-03-26T00:13,0,24050
602,2280141,63,35100,39000,96.0,1099,2023-03-26T00:13,0,35100
603,1126959,64,29250,39000,91.0,2541,2023-03-26T00:13,0,29250
604,2221221,65,35100,39000,96.0,1813,2023-03-26T00:13,0,35100
605,2879417,66,46900,55000,98.0,165,2023-03-26T00:13,0,46900
606,2650964,67,46900,53000,98.0,159,2023-03-26T00:13,0,46900
607,2759077,68,98000,0,100.0,5,2023-03-26T00:13,-17640,80360
608,2974979,69,39000,0,96.0,19,2023-03-26T00:13,0,39000
609,2962388,70,31200,39000,96.0,103,2023-03-26T00:13,0,31200
610,2650965,71,46900,53000,98.0,351,2023-03-26T00:13,0,46900
611,1214106,72,36000,0,96.0,9697,2023-03-26T00:13,0,36000
612,1214316,73,36000,0,97.0,1964,2023-03-26T00:13,0,36000
613,2410318,74,42000,0,95.0,361,2023-03-26T00:13,0,42000
614,2848507,75,119000,0,100.0,8,2023-03-26T00:13,0,119000
615,2244284,76,36000,0,97.0,582,2023-03-26T00:13,0,36000
616,2364344,77,30400,38000,97.0,1656,2023-03-26T00:13,0,30400
617,2051581,78,33000,0,96.0,847,2023-03-26T00:13,0,33000
618,2875048,79,208000,0,86.0,3,2023-03-26T00:13,-30000,178000
619,1907732,80,27900,39000,95.0,765,2023-03-26T00:13,0,27900
620,2287142,81,37000,0,95.0,1104,2023-03-26T00:13,0,37000
621,1063518,82,79000,0,96.0,948,2023-03-26T00:13,0,79000
622,2658143,83,35100,39000,96.0,255,2023-03-26T00:13,0,35100
623,2478349,84,59000,0,97.0,101,2023-03-26T00:13,0,59000
624,2697593,85,99000,0,97.0,130,2023-03-26T00:13,0,99000
625,1433913,86,31500,42000,94.0,3575,2023-03-26T00:13,0,31500
626,363169,87,17900,26000,94.0,4333,2023-03-26T00:13,0,17900
627,2697597,88,62300,89000,100.0,13,2023-03-26T00:13,0,62300
628,1157471,89,49000,0,96.0,924,2023-03-26T00:13,0,49000
629,1300684,90,41300,59000,92.0,237,2023-03-26T00:13,0,41300
630,3059119,1,152150,179000,91.0,12,2023-03-26T00:13,-30430,121720
631,3008189,2,334000,478000,100.0,2,2023-03-26T00:13,-60120,273880
632,2587981,3,293300,419000,0.0,0,2023-03-26T00:13,-52794,240506
633,2392489,4,31900,0,97.0,709,2023-03-26T00:13,0,31900
634,3050173,5,166600,238000,0.0,0,2023-03-26T00:13,0,166600
635,3073257,6,196200,218000,100.0,6,2023-03-26T00:13,-35316,160884
636,3158246,7,278000,0,0.0,0,2023-03-26T00:13,-27800,250200
637,3106487,8,148000,0,100.0,12,2023-03-26T00:13,0,148000
638,3091290,9,85000,0,0.0,0,2023-03-26T00:13,0,85000
639,3122381,10,151200,168000,100.0,4,2023-03-26T00:13,-27216,123984
640,3081771,11,189000,0,100.0,1,2023-03-26T00:13,-9450,179550
641,1579103,12,126400,158000,96.0,96,2023-03-26T00:13,-6320,120080
642,3135904,13,92000,0,0.0,0,2023-03-26T00:13,-4600,87400
643,2464849,14,20800,52000,87.0,41,2023-03-26T00:13,0,20800
644,3091291,15,85000,0,0.0,0,2023-03-26T00:13,0,85000
645,2091668,16,339000,0,80.0,1,2023-03-26T00:13,0,339000
646,3146212,17,69900,0,0.0,0,2023-03-26T00:13,-3495,66405
647,3112829,18,342000,360000,0.0,0,2023-03-26T00:13,-61560,280440
648,3112830,19,342000,360000,0.0,0,2023-03-26T00:13,-61560,280440
649,3066052,20,158100,186000,100.0,1,2023-03-26T00:13,0,158100
650,2615415,21,127000,159000,100.0,4,2023-03-26T00:13,0,127000
651,3100428,22,149000,0,0.0,0,2023-03-26T00:13,-7450,141550
652,3073259,23,196200,218000,100.0,4,2023-03-26T00:13,-35316,160884
653,3085842,24,290000,0,0.0,0,2023-03-26T00:13,-52200,237800
654,3147475,25,159000,0,0.0,0,2023-03-26T00:13,0,159000
655,3158235,26,278000,0,0.0,0,2023-03-26T00:13,-27800,250200
656,3130645,27,119000,0,0.0,0,2023-03-26T00:13,-5950,113050
657,1973413,28,79920,99900,95.0,4,2023-03-26T00:13,0,79920
658,3114528,29,134000,0,0.0,0,2023-03-26T00:13,0,134000
659,3102177,30,230000,0,100.0,1,2023-03-26T00:13,-11500,218500
660,3161937,31,279000,0,0.0,0,2023-03-26T00:13,-13950,265050
661,3070801,32,112100,118000,86.0,3,2023-03-26T00:13,-22420,89680
662,3161727,33,223000,0,0.0,0,2023-03-26T00:13,0,223000
663,3140273,34,239000,0,0.0,0,2023-03-26T00:13,-11950,227050
664,3130633,35,149000,0,100.0,2,2023-03-26T00:13,-7450,141550
665,2912949,36,199000,0,100.0,16,2023-03-26T00:13,0,199000
666,2362380,37,85400,122000,86.0,24,2023-03-26T00:13,-4270,81130
667,3040561,38,175750,185000,100.0,5,2023-03-26T00:13,-35150,140600
668,3154902,39,218000,0,0.0,0,2023-03-26T00:13,0,218000
669,3071478,40,219000,0,0.0,0,2023-03-26T00:13,0,219000
670,2044442,41,70000,0,96.0,170,2023-03-26T00:13,0,70000
671,2605850,42,94000,0,97.0,155,2023-03-26T00:13,-4700,89300
672,1863788,43,103200,129000,96.0,119,2023-03-26T00:13,-5160,98040
673,3063095,44,215100,239000,0.0,0,2023-03-26T00:13,0,215100
674,2714524,45,48300,69000,95.0,390,2023-03-26T00:13,-4830,43470
675,2392491,46,31900,0,96.0,389,2023-03-26T00:13,0,31900
676,2388209,47,94000,0,96.0,152,2023-03-26T00:13,-4700,89300
677,3053225,48,159000,0,100.0,2,2023-03-26T00:13,0,159000
678,3039979,49,282000,564000,0.0,0,2023-03-26T00:13,-30000,252000
679,2153636,50,173600,248000,97.0,29,2023-03-26T00:13,-8680,164920
680,3081770,51,189000,0,100.0,3,2023-03-26T00:13,-9450,179550
681,1784460,52,198000,0,100.0,2,2023-03-26T00:13,0,198000
682,3093948,53,199000,0,0.0,0,2023-03-26T00:13,0,199000
683,3149627,54,198000,0,0.0,0,2023-03-26T00:13,0,198000
684,3131556,55,104000,0,0.0,0,2023-03-26T00:13,-31200,72800
685,3147382,56,96000,0,0.0,0,2023-03-26T00:13,0,96000
686,2499442,57,178000,0,94.0,57,2023-03-26T00:13,-32040,145960
687,3119153,58,169000,0,0.0,0,2023-03-26T00:13,0,169000
688,3130596,59,179100,199000,0.0,0,2023-03-26T00:13,-32238,146862
689,2562085,60,49500,99000,100.0,1,2023-03-26T00:13,0,49500
690,3119223,61,179100,199000,0.0,0,2023-03-26T00:13,-8955,170145
691,3171883,62,149000,0,0.0,0,2023-03-26T00:13,0,149000
692,1875663,63,36900,0,95.0,829,2023-03-26T00:13,0,36900
693,3054308,64,178200,198000,0.0,0,2023-03-26T00:13,-8910,169290
694,1962359,65,177000,0,97.0,67,2023-03-26T00:13,0,177000
695,3055337,66,159000,0,0.0,0,2023-03-26T00:13,0,159000
696,3156576,67,167300,239000,0.0,0,2023-03-26T00:13,0,167300
697,1871030,68,133600,167000,94.0,94,2023-03-26T00:13,-6680,126920
698,3135499,69,150100,158000,0.0,0,2023-03-26T00:13,-30020,120080
699,3168561,70,89000,99000,0.0,0,2023-03-26T00:13,0,89000
700,3153595,71,151200,168000,0.0,0,2023-03-26T00:13,-27216,123984
701,3107001,72,165000,0,0.0,0,2023-03-26T00:13,0,165000
702,2778932,73,62300,89000,97.0,20,2023-03-26T00:13,0,62300
703,3104804,74,160550,169000,0.0,0,2023-03-26T00:13,0,160550
704,1840913,75,143200,179000,92.0,16,2023-03-26T00:13,0,143200
705,2558169,76,159200,199000,100.0,3,2023-03-26T00:13,0,159200
706,2623010,77,162000,0,0.0,0,2023-03-26T00:13,0,162000
707,3152244,78,159000,0,0.0,0,2023-03-26T00:13,0,159000
708,3039222,79,79050,93000,100.0,3,2023-03-26T00:13,0,79050
709,3153251,80,143000,0,0.0,0,2023-03-26T00:13,0,143000
710,3147499,81,154000,0,0.0,0,2023-03-26T00:13,0,154000
711,2634293,82,138600,198000,100.0,6,2023-03-26T00:13,-27720,110880
712,2717734,83,79000,0,98.0,53,2023-03-26T00:13,0,79000
713,2606138,84,154000,0,0.0,0,2023-03-26T00:13,0,154000
714,2721581,85,153300,219000,0.0,0,2023-03-26T00:13,0,153300
715,2823220,86,192000,384000,100.0,2,2023-03-26T00:13,-30000,162000
716,3104789,87,113050,119000,0.0,0,2023-03-26T00:13,-5653,107397
717,2712722,88,46900,79000,96.0,18,2023-03-26T00:13,0,46900
718,3147681,89,139000,0,0.0,0,2023-03-26T00:13,0,139000
719,3131514,90,78000,0,0.0,0,2023-03-26T00:13,-23400,54600
720,2867750,1,135000,0,96.0,35,2023-03-26T00:13,-6750,128250
721,3051039,2,95200,119000,100.0,16,2023-03-26T00:13,0,95200
722,3070528,3,168000,0,0.0,0,2023-03-26T00:13,-8400,159600
723,2925522,4,54600,65000,95.0,77,2023-03-26T00:13,0,54600
724,2850491,5,250600,358000,100.0,4,2023-03-26T00:13,-45108,205492
725,3073254,6,160200,178000,93.0,3,2023-03-26T00:13,-28836,131364
726,3026955,7,86700,102000,0.0,0,2023-03-26T00:13,-4335,82365
727,2378593,8,88200,98000,94.0,69,2023-03-26T00:13,-4410,83790
728,2806614,9,119000,0,98.0,91,2023-03-26T00:13,0,119000
729,2830788,10,139000,0,95.0,24,2023-03-26T00:13,-6950,132050
730,2377814,11,178200,198000,96.0,68,2023-03-26T00:13,-32076,146124
731,3112848,12,247000,260000,100.0,1,2023-03-26T00:13,-44460,202540
732,3077493,13,238000,0,0.0,0,2023-03-26T00:13,-42840,195160
733,3099401,14,439000,0,0.0,0,2023-03-26T00:13,0,439000
734,2968212,15,428000,0,0.0,0,2023-03-26T00:13,-77040,350960
735,2801111,16,78900,105000,93.0,3,2023-03-26T00:13,0,78900
736,3031103,17,55200,69000,100.0,15,2023-03-26T00:13,0,55200
737,3044176,18,378000,0,100.0,1,2023-03-26T00:13,-68040,309960
738,3119334,19,379000,0,0.0,0,2023-03-26T00:13,0,379000
739,3037454,20,149000,0,0.0,0,2023-03-26T00:13,-7450,141550
740,2377804,21,178200,198000,93.0,37,2023-03-26T00:13,-32076,146124
741,3130182,22,165000,0,0.0,0,2023-03-26T00:13,-33000,132000
742,3070530,23,168000,0,0.0,0,2023-03-26T00:13,0,168000
743,3031104,24,55200,69000,98.0,39,2023-03-26T00:13,0,55200
744,3073251,25,169200,188000,0.0,0,2023-03-26T00:13,-30456,138744
745,1324169,26,29900,0,95.0,1315,2023-03-26T00:13,0,29900
746,3164745,27,339000,0,0.0,0,2023-03-26T00:13,0,339000
747,3037452,28,149000,0,100.0,1,2023-03-26T00:13,-7450,141550
748,3073258,29,160200,178000,96.0,6,2023-03-26T00:13,-28836,131364
749,3081768,30,169000,0,0.0,0,2023-03-26T00:13,0,169000
750,3034043,31,148000,0,100.0,1,2023-03-26T00:13,-7400,140600
751,3122278,32,160200,178000,0.0,0,2023-03-26T00:13,-28836,131364
752,3122281,33,160200,178000,0.0,0,2023-03-26T00:13,-28836,131364
753,2478665,34,45500,65000,89.0,38,2023-03-26T00:13,-4550,40950
754,2551401,35,37900,0,93.0,263,2023-03-26T00:13,0,37900
755,3118978,36,318000,0,0.0,0,2023-03-26T00:13,-31800,286200
756,3138263,37,152100,169000,0.0,0,2023-03-26T00:13,-15210,136890
757,3160506,38,308000,0,0.0,0,2023-03-26T00:13,-15400,292600
758,3120257,39,149000,0,0.0,0,2023-03-26T00:13,0,149000
759,2745019,40,152600,218000,92.0,18,2023-03-26T00:13,-27468,125132
760,2588039,41,293300,419000,0.0,0,2023-03-26T00:13,-52794,240506
761,3125453,42,55200,89900,100.0,1,2023-03-26T00:13,0,55200
762,2144842,43,65400,109000,95.0,19,2023-03-26T00:13,0,65400
763,2117253,44,43900,0,94.0,245,2023-03-26T00:13,0,43900
764,2792603,45,43900,0,100.0,31,2023-03-26T00:13,0,43900
765,1645760,46,39390,43900,96.0,330,2023-03-26T00:13,0,39390
766,2551400,47,39900,0,93.0,125,2023-03-26T00:13,0,39900
767,2588036,48,293300,419000,0.0,0,2023-03-26T00:13,-52794,240506
768,3122270,49,124200,138000,100.0,3,2023-03-26T00:13,-22356,101844
769,2836351,50,49680,72000,96.0,409,2023-03-26T00:13,-4968,44712
770,3133860,51,88000,98000,0.0,0,2023-03-26T00:13,-4400,83600
771,1931894,52,37900,0,95.0,485,2023-03-26T00:13,0,37900
772,3062946,53,110400,138000,100.0,2,2023-03-26T00:13,0,110400
773,3099773,54,238000,0,0.0,0,2023-03-26T00:13,0,238000
774,3049791,55,67200,79000,100.0,9,2023-03-26T00:13,-6720,60480
775,3099073,56,226100,238000,0.0,0,2023-03-26T00:13,-40698,185402
776,3085582,57,115200,128000,0.0,0,2023-03-26T00:13,0,115200
777,2836289,58,33630,59000,95.0,194,2023-03-26T00:13,0,33630
778,3000422,59,59000,0,99.0,20,2023-03-26T00:13,0,59000
779,2796166,60,38400,64000,96.0,214,2023-03-26T00:13,-1920,36480
780,3040812,61,74100,78000,100.0,12,2023-03-26T00:13,-14820,59280
781,1944553,62,36900,0,96.0,212,2023-03-26T00:13,0,36900
782,2798672,63,208600,298000,0.0,0,2023-03-26T00:13,-27118,181482
783,3126112,64,63200,79000,96.0,10,2023-03-26T00:13,0,63200
784,2377812,65,178200,198000,97.0,57,2023-03-26T00:13,-32076,146124
785,3133082,66,171000,0,80.0,3,2023-03-26T00:13,-51300,119700
786,3035256,67,58900,62000,96.0,6,2023-03-26T00:13,0,58900
787,2942764,68,189000,0,98.0,11,2023-03-26T00:13,0,189000
788,2756335,69,125400,132000,96.0,47,2023-03-26T00:13,-6270,119130
789,3130181,70,165000,0,0.0,0,2023-03-26T00:13,-33000,132000
790,2830762,71,139000,0,99.0,43,2023-03-26T00:13,-6950,132050
791,2760121,72,194400,216000,0.0,0,2023-03-26T00:13,-34992,159408
792,3101246,73,179000,0,0.0,0,2023-03-26T00:13,0,179000
793,2679920,74,98100,109000,100.0,6,2023-03-26T00:13,0,98100
794,2664573,75,178000,0,92.0,5,2023-03-26T00:13,-32040,145960
795,2448900,76,39490,43900,95.0,80,2023-03-26T00:13,0,39490
796,2416846,77,54000,67900,91.0,77,2023-03-26T00:13,-2700,51300
797,2691996,78,179000,0,0.0,0,2023-03-26T00:13,-32220,146780
798,2725422,79,36900,0,98.0,62,2023-03-26T00:13,0,36900
799,3093403,80,149000,0,100.0,6,2023-03-26T00:13,-7450,141550
800,3151584,81,174000,218000,0.0,0,2023-03-26T00:13,-8700,165300
801,3069510,82,170100,189000,100.0,3,2023-03-26T00:13,-30618,139482
802,1807814,83,65550,69000,97.0,241,2023-03-26T00:13,0,65550
803,3123379,84,93100,98000,0.0,0,2023-03-26T00:13,-4655,88445
804,3065812,85,159000,0,0.0,0,2023-03-26T00:13,0,159000
805,3100903,86,151200,168000,0.0,0,2023-03-26T00:13,-27216,123984
806,3092514,87,89000,0,0.0,0,2023-03-26T00:13,-4450,84550
807,3091304,88,59000,0,0.0,0,2023-03-26T00:13,0,59000
808,2390967,89,36580,59000,93.0,202,2023-03-26T00:13,-3658,32922
809,1984037,90,169150,199000,0.0,0,2023-03-26T00:13,0,169150
810,991339,1,17890,19900,97.0,52099,2023-03-26T00:13,0,17890
811,1986031,2,24990,27900,97.0,10268,2023-03-26T00:13,0,24990
812,998051,3,13900,24000,97.0,160725,2023-03-26T00:13,0,13900
813,991340,4,17890,19900,97.0,30529,2023-03-26T00:13,0,17890
814,1094748,5,19900,0,97.0,18915,2023-03-26T00:13,0,19900
815,1477845,6,15400,22000,96.0,9418,2023-03-26T00:13,0,15400
816,763821,7,16900,22000,96.0,31179,2023-03-26T00:13,0,16900
817,1094835,8,14290,15900,97.0,6124,2023-03-26T00:13,0,14290
818,1342874,9,16900,33000,97.0,12507,2023-03-26T00:13,0,16900
819,1986030,10,23690,27900,97.0,1628,2023-03-26T00:13,0,23690
820,1986029,11,27900,0,98.0,3856,2023-03-26T00:13,0,27900
821,991570,12,12900,20000,97.0,18925,2023-03-26T00:13,0,12900
822,1443937,13,12900,24000,97.0,7578,2023-03-26T00:13,0,12900
823,1996705,14,23690,27900,98.0,2637,2023-03-26T00:13,0,23690
824,734085,15,11900,19800,96.0,64285,2023-03-26T00:13,0,11900
825,1996702,16,23690,27900,97.0,1882,2023-03-26T00:13,0,23690
826,792919,17,15190,16900,96.0,17854,2023-03-26T00:13,0,15190
827,991341,18,16890,19900,96.0,10120,2023-03-26T00:13,0,16890
828,1729576,19,9500,13900,97.0,15798,2023-03-26T00:13,0,9500
829,2959925,20,22000,27500,99.0,69,2023-03-26T00:13,0,22000
830,746158,21,22900,0,96.0,20453,2023-03-26T00:13,0,22900
831,2297277,22,19900,22000,95.0,245,2023-03-26T00:13,0,19900
832,1094749,23,19900,0,96.0,4916,2023-03-26T00:13,0,19900
833,2845854,24,14900,18900,97.0,168,2023-03-26T00:13,-1043,13857
834,2832613,25,11200,33000,97.0,555,2023-03-26T00:13,0,11200
835,746159,26,20590,22900,95.0,28669,2023-03-26T00:13,0,20590
836,1821485,27,30000,0,96.0,1227,2023-03-26T00:13,0,30000
837,1974077,28,42090,46900,97.0,882,2023-03-26T00:13,0,42090
838,1996704,29,22290,27900,97.0,687,2023-03-26T00:13,0,22290
839,1094750,30,16890,19900,97.0,3524,2023-03-26T00:13,0,16890
840,1346009,31,9900,12000,97.0,6626,2023-03-26T00:13,0,9900
841,2973952,32,28800,48000,100.0,5,2023-03-26T00:13,-5184,23616
842,1647682,33,14900,23600,97.0,934,2023-03-26T00:13,0,14900
843,479245,34,15400,22000,93.0,5350,2023-03-26T00:13,0,15400
844,1777081,35,8000,12800,96.0,1101,2023-03-26T00:13,0,8000
845,792920,36,15190,16900,96.0,9640,2023-03-26T00:13,0,15190
846,1260384,37,19900,0,95.0,1789,2023-03-26T00:13,0,19900
847,746161,38,20590,22900,95.0,7721,2023-03-26T00:13,0,20590
848,2011851,39,21490,23900,98.0,670,2023-03-26T00:13,0,21490
849,2649999,40,12800,16000,93.0,63,2023-03-26T00:13,0,12800
850,1556773,41,15200,16000,96.0,672,2023-03-26T00:13,-3040,12160
851,752821,42,9900,0,94.0,23670,2023-03-26T00:13,0,9900
852,2467197,43,30000,0,95.0,126,2023-03-26T00:13,0,30000
853,1094836,44,14290,15900,97.0,1295,2023-03-26T00:13,0,14290
854,3065854,45,25000,0,100.0,13,2023-03-26T00:13,0,25000
855,2477854,46,17890,19900,98.0,1431,2023-03-26T00:13,0,17890
856,1360044,47,19900,0,97.0,1750,2023-03-26T00:13,0,19900
857,2011852,48,21490,23900,97.0,1289,2023-03-26T00:13,0,21490
858,3147709,49,49000,0,0.0,0,2023-03-26T00:13,0,49000
859,1348077,50,10900,16500,97.0,1836,2023-03-26T00:13,0,10900
860,3118094,51,28800,32000,0.0,0,2023-03-26T00:13,-1440,27360
861,2960555,52,14900,19000,93.0,83,2023-03-26T00:13,0,14900
862,3122410,53,59000,0,100.0,2,2023-03-26T00:13,0,59000
863,1821487,54,30000,0,97.0,666,2023-03-26T00:13,0,30000
864,2618262,55,39200,49000,100.0,22,2023-03-26T00:13,-1960,37240
865,2821598,56,19390,22900,97.0,130,2023-03-26T00:13,0,19390
866,2798430,57,29000,0,96.0,38,2023-03-26T00:13,0,29000
867,2346958,58,18900,24000,98.0,501,2023-03-26T00:13,0,18900
868,3009680,59,12590,14900,98.0,85,2023-03-26T00:13,0,12590
869,1286366,60,12900,24000,97.0,9768,2023-03-26T00:13,0,12900
870,2667555,61,27000,0,100.0,7,2023-03-26T00:13,0,27000
871,1392773,62,16890,19900,95.0,1469,2023-03-26T00:13,0,16890
872,792921,63,15190,16900,95.0,7805,2023-03-26T00:13,0,15190
873,2347097,64,15900,24000,98.0,1505,2023-03-26T00:13,0,15900
874,2509300,65,19900,0,96.0,385,2023-03-26T00:13,0,19900
875,1547562,66,15400,22000,95.0,1351,2023-03-26T00:13,0,15400
876,1886679,67,69000,0,96.0,6,2023-03-26T00:13,0,69000
877,472686,68,9900,14800,94.0,694,2023-03-26T00:13,0,9900
878,2477852,69,17890,19900,98.0,662,2023-03-26T00:13,0,17890
879,3123102,70,59000,0,0.0,0,2023-03-26T00:13,0,59000
880,924947,71,15300,19800,96.0,3577,2023-03-26T00:13,0,15300
881,2821597,72,22900,0,98.0,98,2023-03-26T00:13,0,22900
882,1475055,73,16900,22000,96.0,1153,2023-03-26T00:13,0,16900
883,2990345,74,27900,0,99.0,40,2023-03-26T00:13,0,27900
884,2610916,75,17000,0,97.0,105,2023-03-26T00:13,-3060,13940
885,3047676,76,14250,15000,96.0,17,2023-03-26T00:13,0,14250
886,1477846,77,15400,22000,96.0,2641,2023-03-26T00:13,0,15400
887,1556774,78,15200,16000,96.0,465,2023-03-26T00:13,-3040,12160
888,2858173,79,59000,0,0.0,0,2023-03-26T00:13,0,59000
889,768442,80,12500,0,96.0,1219,2023-03-26T00:13,0,12500
890,2610915,81,17000,0,94.0,91,2023-03-26T00:13,-3060,13940
891,1246150,82,17800,33600,95.0,3509,2023-03-26T00:13,0,17800
892,2832593,83,11500,27800,96.0,46,2023-03-26T00:13,0,11500
893,2738094,84,19900,0,96.0,166,2023-03-26T00:13,0,19900
894,2821588,85,19690,21900,97.0,38,2023-03-26T00:13,0,19690
895,2821589,86,19690,21900,96.0,28,2023-03-26T00:13,0,19690
896,1296443,87,17900,23800,97.0,913,2023-03-26T00:13,0,17900
897,2122868,88,9500,13900,97.0,3777,2023-03-26T00:13,0,9500
898,1094837,89,13490,15900,96.0,1740,2023-03-26T00:13,0,13490
899,2477851,90,19900,0,98.0,626,2023-03-26T00:13,0,19900
