,item_id,rank,price,del_price,rating,rating_count,time,coupon,real_price
0,3214285,1,47778,82000,0.0,0,2023-04-21T21:35,-4778,43000
1,3214275,2,47778,82000,0.0,0,2023-04-21T21:35,-4778,43000
2,3214281,3,47778,82000,0.0,0,2023-04-21T21:35,-4778,43000
3,3214271,4,47778,82000,0.0,0,2023-04-21T21:35,-4778,43000
4,3214274,5,47778,82000,0.0,0,2023-04-21T21:35,-4778,43000
5,3214284,6,47778,82000,0.0,0,2023-04-21T21:35,-4778,43000
6,3214279,7,37778,69000,0.0,0,2023-04-21T21:35,-3778,34000
7,3214282,8,47778,82000,0.0,0,2023-04-21T21:35,-4778,43000
8,3214276,9,37778,69000,0.0,0,2023-04-21T21:35,-3778,34000
9,3214277,10,37778,69000,0.0,0,2023-04-21T21:35,-3778,34000
10,3227697,11,47778,82000,0.0,0,2023-04-21T21:35,-4778,43000
11,3214273,12,47778,82000,0.0,0,2023-04-21T21:35,-4778,43000
12,3214278,13,37778,69000,0.0,0,2023-04-21T21:35,-3778,34000
13,1848166,14,44100,49000,97.0,41488,2023-04-21T21:35,-4410,39690
14,1388775,15,17890,19900,97.0,11657,2023-04-21T21:35,0,17890
15,1763157,16,49400,52000,95.0,2846,2023-04-21T21:35,0,49400
16,2272830,17,35910,39900,97.0,20462,2023-04-21T21:35,-10773,25137
17,3214272,18,47778,82000,0.0,0,2023-04-21T21:35,-4778,43000
18,2376229,19,36000,0,97.0,3903,2023-04-21T21:35,0,36000
19,345889,20,29900,47900,95.0,10287,2023-04-21T21:35,0,29900
20,1944612,21,35800,59700,97.0,3088,2023-04-21T21:35,0,35800
21,2376233,22,36000,0,97.0,2290,2023-04-21T21:35,0,36000
22,1388776,23,17890,19900,96.0,8683,2023-04-21T21:35,0,17890
23,2442409,24,39000,78000,96.0,9243,2023-04-21T21:35,-5850,33150
24,2086653,25,16900,0,97.0,40656,2023-04-21T21:35,0,16900
25,2479911,26,49400,76000,97.0,4552,2023-04-21T21:35,0,49400
26,2646350,27,59800,94000,95.0,4879,2023-04-21T21:35,-5980,53820
27,1921901,28,36900,70500,96.0,7714,2023-04-21T21:35,0,36900
28,2623779,29,88200,98000,98.0,53,2023-04-21T21:35,0,88200
29,2285512,30,49400,52000,96.0,1813,2023-04-21T21:35,0,49400
30,3105468,31,79000,0,98.0,124,2023-04-21T21:35,-11850,67150
31,2034137,32,31800,0,97.0,18093,2023-04-21T21:35,-4770,27030
32,2623778,33,88200,98000,99.0,23,2023-04-21T21:35,0,88200
33,2623777,34,88200,98000,98.0,30,2023-04-21T21:35,0,88200
34,1996130,35,36000,0,97.0,168,2023-04-21T21:35,0,36000
35,3187851,36,49900,110000,97.0,354,2023-04-21T21:35,0,49900
36,1939099,37,29400,49000,97.0,12069,2023-04-21T21:35,0,29400
37,2453556,38,39900,42000,97.0,6379,2023-04-21T21:35,0,39900
38,1884943,39,29900,39000,96.0,19070,2023-04-21T21:35,-4485,25415
39,996177,40,15900,0,95.0,78003,2023-04-21T21:35,0,15900
40,2377269,41,45000,0,97.0,4261,2023-04-21T21:35,0,45000
41,3227613,42,37778,69000,0.0,0,2023-04-21T21:35,-3778,34000
42,1763123,43,84550,89000,96.0,1694,2023-04-21T21:35,0,84550
43,2015684,44,39000,0,95.0,6524,2023-04-21T21:35,0,39000
44,2623767,45,88200,98000,97.0,28,2023-04-21T21:35,0,88200
45,2375962,46,59000,62000,98.0,5799,2023-04-21T21:35,0,59000
46,2149254,47,37800,0,97.0,34392,2023-04-21T21:35,-5670,32130
47,2623786,48,88200,98000,98.0,43,2023-04-21T21:35,0,88200
48,3043740,49,49700,59000,98.0,23,2023-04-21T21:35,0,49700
49,3105520,50,118150,139000,98.0,17,2023-04-21T21:35,0,118150
50,3219911,51,69900,118000,97.0,35,2023-04-21T21:35,0,69900
51,2575342,52,39900,59000,96.0,948,2023-04-21T21:35,0,39900
52,1955452,53,39800,69990,95.0,2718,2023-04-21T21:35,0,39800
53,1706633,54,199000,0,97.0,2476,2023-04-21T21:35,0,199000
54,1899755,55,29900,39000,96.0,5077,2023-04-21T21:35,-4485,25415
55,2560614,56,97300,139000,97.0,727,2023-04-21T21:35,0,97300
56,1779737,57,27200,32000,96.0,7449,2023-04-21T21:35,-4080,23120
57,2341450,58,16090,17900,97.0,1659,2023-04-21T21:35,0,16090
58,3064420,59,61500,69000,98.0,120,2023-04-21T21:35,0,61500
59,1882578,60,35910,39900,97.0,10667,2023-04-21T21:35,0,35910
60,2341451,61,16090,17900,97.0,1860,2023-04-21T21:35,0,16090
61,1498103,62,199000,0,96.0,900,2023-04-21T21:35,0,199000
62,1763218,63,84550,89000,96.0,1536,2023-04-21T21:35,0,84550
63,2364807,64,219000,0,96.0,737,2023-04-21T21:35,0,219000
64,2035287,65,39800,0,97.0,9049,2023-04-21T21:35,-5970,33830
65,2398380,66,22500,45000,96.0,1712,2023-04-21T21:35,0,22500
66,1842348,67,79200,99000,96.0,3044,2023-04-21T21:35,-15840,63360
67,2492701,68,37800,42000,96.0,778,2023-04-21T21:35,-7560,30240
68,1503352,69,39900,42000,97.0,8552,2023-04-21T21:35,0,39900
69,3208410,70,52900,68000,97.0,47,2023-04-21T21:35,-7935,44965
70,1417691,71,13900,0,97.0,18903,2023-04-21T21:35,0,13900
71,2623783,72,88200,98000,98.0,56,2023-04-21T21:35,0,88200
72,3155032,73,24750,45000,96.0,40,2023-04-21T21:35,0,24750
73,1782647,74,39900,42000,97.0,3585,2023-04-21T21:35,0,39900
74,3042516,75,42000,65000,96.0,190,2023-04-21T21:35,0,42000
75,2409894,76,39000,78000,97.0,5262,2023-04-21T21:35,-5850,33150
76,2453552,77,39900,42000,97.0,3086,2023-04-21T21:35,0,39900
77,3046818,78,46000,0,98.0,60,2023-04-21T21:35,-4600,41400
78,854337,79,30490,33900,95.0,17539,2023-04-21T21:35,0,30490
79,3203720,80,40500,45000,99.0,49,2023-04-21T21:35,-8100,32400
80,1031260,81,35700,42000,96.0,13261,2023-04-21T21:35,-5355,30345
81,1005680,82,17500,35000,95.0,9459,2023-04-21T21:35,0,17500
82,2032983,83,89250,119000,98.0,1470,2023-04-21T21:35,0,89250
83,2623772,84,88200,98000,98.0,20,2023-04-21T21:35,0,88200
84,2032985,85,89250,119000,97.0,1869,2023-04-21T21:35,0,89250
85,2471760,86,35100,39000,97.0,6609,2023-04-21T21:35,-7020,28080
86,1911516,87,48900,81900,95.0,6213,2023-04-21T21:35,0,48900
87,2313388,88,68000,85000,96.0,2265,2023-04-21T21:35,0,68000
88,3143791,89,45900,68000,98.0,646,2023-04-21T21:35,-6885,39015
89,2403601,90,32500,50000,96.0,2344,2023-04-21T21:35,-4875,27625
90,1558197,1,69590,81900,97.0,32949,2023-04-21T21:35,0,69590
91,1778404,2,39000,45000,96.0,68183,2023-04-21T21:35,-5850,33150
92,2723218,3,69900,109000,97.0,2888,2023-04-21T21:35,-10485,59415
93,2343198,4,116000,129000,97.0,5256,2023-04-21T21:35,-23200,92800
94,3054935,5,80890,89900,97.0,89,2023-04-21T21:35,0,80890
95,2061715,6,79900,105000,97.0,2839,2023-04-21T21:35,0,79900
96,2020732,7,56900,89000,95.0,958,2023-04-21T21:35,0,56900
97,1856181,8,35910,39900,97.0,8148,2023-04-21T21:35,-10773,25137
98,1283757,9,71290,83900,96.0,26903,2023-04-21T21:35,0,71290
99,1571879,10,79900,112900,96.0,7249,2023-04-21T21:35,0,79900
100,3092774,11,139900,0,98.0,11,2023-04-21T21:35,-20985,118915
101,3092777,12,139900,0,92.0,10,2023-04-21T21:35,-20985,118915
102,1776552,13,59000,69000,94.0,6252,2023-04-21T21:35,-8850,50150
103,2110493,14,389000,0,96.0,659,2023-04-21T21:35,0,389000
104,1790383,15,54700,86000,95.0,5854,2023-04-21T21:35,-8205,46495
105,2732486,16,99000,179000,98.0,820,2023-04-21T21:35,-9900,89100
106,3048143,17,109200,182000,96.0,510,2023-04-21T21:35,-21840,87360
107,3012082,18,59900,79000,96.0,1214,2023-04-21T21:35,-5990,53910
108,1108007,19,67890,79900,95.0,48006,2023-04-21T21:35,0,67890
109,3092776,20,139900,0,0.0,0,2023-04-21T21:35,-20985,118915
110,2375909,21,76390,89900,98.0,1648,2023-04-21T21:35,0,76390
111,1778408,22,39000,45000,95.0,11928,2023-04-21T21:35,-5850,33150
112,3092775,23,139900,0,100.0,1,2023-04-21T21:35,-20985,118915
113,1576700,24,89000,129000,97.0,17105,2023-04-21T21:35,-13350,75650
114,2329532,25,119200,149000,97.0,4090,2023-04-21T21:35,-11920,107280
115,2611814,26,69490,159900,97.0,197,2023-04-21T21:35,0,69490
116,2343199,27,116000,129000,98.0,1915,2023-04-21T21:35,-23200,92800
117,2444808,28,75490,83900,97.0,720,2023-04-21T21:35,0,75490
118,3048205,29,139200,232000,97.0,122,2023-04-21T21:35,-27840,111360
119,3033224,30,59900,74000,97.0,852,2023-04-21T21:35,-5990,53910
120,3100493,31,139000,0,97.0,76,2023-04-21T21:35,0,139000
121,2471405,32,89000,138000,97.0,2204,2023-04-21T21:35,-8900,80100
122,1530517,33,69900,79000,96.0,2216,2023-04-21T21:35,0,69900
123,3037473,34,69900,85900,95.0,337,2023-04-21T21:35,-10485,59415
124,3055246,35,159000,0,97.0,91,2023-04-21T21:35,0,159000
125,3170200,36,196200,218000,97.0,9,2023-04-21T21:35,0,196200
126,1139192,37,66400,94900,97.0,14532,2023-04-21T21:35,-9960,56440
127,1530516,38,69900,79000,96.0,2477,2023-04-21T21:35,0,69900
128,2123924,39,247000,309000,98.0,933,2023-04-21T21:35,-49400,197600
129,1571878,40,79900,112900,96.0,4805,2023-04-21T21:35,0,79900
130,841230,41,154000,172000,96.0,7364,2023-04-21T21:35,0,154000
131,946995,42,106250,125000,94.0,2900,2023-04-21T21:35,-15938,90312
132,1195307,43,87550,103000,96.0,12777,2023-04-21T21:35,-13133,74417
133,1576682,44,228050,339000,97.0,8685,2023-04-21T21:35,-34208,193842
134,1558683,45,69590,81900,97.0,6326,2023-04-21T21:35,0,69590
135,2381781,46,186750,249000,98.0,872,2023-04-21T21:35,0,186750
136,3046899,47,79900,105000,97.0,143,2023-04-21T21:35,0,79900
137,2403367,48,138700,146000,97.0,690,2023-04-21T21:35,-27740,110960
138,1618312,49,83900,0,97.0,7268,2023-04-21T21:35,-8390,75510
139,2835447,50,1737000,3150000,0.0,0,2023-04-21T21:35,0,1737000
140,2064545,51,59800,94000,97.0,11403,2023-04-21T21:35,-2990,56810
141,2712632,52,107000,0,97.0,1396,2023-04-21T21:35,0,107000
142,3010441,53,186750,249000,98.0,123,2023-04-21T21:35,0,186750
143,3100486,54,139000,0,96.0,20,2023-04-21T21:35,0,139000
144,2718413,55,134100,149000,97.0,1486,2023-04-21T21:35,0,134100
145,2723216,56,69900,109000,97.0,1227,2023-04-21T21:35,-10485,59415
146,2752332,57,74200,105300,95.0,2694,2023-04-21T21:35,-11130,63070
147,3029811,58,63200,79000,97.0,309,2023-04-21T21:35,0,63200
148,3161383,59,179000,0,90.0,4,2023-04-21T21:35,0,179000
149,1337094,60,69900,0,95.0,5518,2023-04-21T21:35,0,69900
150,2788216,61,143000,159000,98.0,177,2023-04-21T21:35,-28600,114400
151,2159724,62,29900,32000,95.0,2432,2023-04-21T21:35,0,29900
152,3051559,63,39000,93000,96.0,31,2023-04-21T21:35,-5850,33150
153,1873073,64,67090,83900,97.0,4120,2023-04-21T21:35,0,67090
154,3048144,65,109200,182000,96.0,237,2023-04-21T21:35,-21840,87360
155,1776365,66,53400,89000,96.0,4680,2023-04-21T21:35,-8010,45390
156,2978698,67,378000,815000,100.0,3,2023-04-21T21:35,-30000,348000
157,1558671,68,81900,0,97.0,3021,2023-04-21T21:35,0,81900
158,2284220,69,79900,112900,96.0,1746,2023-04-21T21:35,0,79900
159,1969617,70,162000,0,96.0,2708,2023-04-21T21:35,0,162000
160,3098417,71,159000,199000,97.0,630,2023-04-21T21:35,0,159000
161,1882525,72,139000,0,98.0,1884,2023-04-21T21:35,0,139000
162,3037472,73,69900,85900,96.0,241,2023-04-21T21:35,-10485,59415
163,1280576,74,39900,62000,96.0,25392,2023-04-21T21:35,-5985,33915
164,2683549,75,111750,149000,97.0,2632,2023-04-21T21:35,0,111750
165,3167989,76,119000,0,96.0,11,2023-04-21T21:35,0,119000
166,864404,77,114750,135000,95.0,13421,2023-04-21T21:35,-17213,97537
167,3033083,78,69900,109000,97.0,68,2023-04-21T21:35,0,69900
168,1833230,79,95200,136000,97.0,5511,2023-04-21T21:35,-14280,80920
169,2288426,80,69000,109000,94.0,859,2023-04-21T21:35,-10350,58650
170,3125740,81,268000,0,0.0,0,2023-04-21T21:35,0,268000
171,3137506,82,46800,72000,97.0,50,2023-04-21T21:35,-2340,44460
172,3026952,83,70400,128000,94.0,49,2023-04-21T21:35,-10560,59840
173,3109424,84,199000,0,98.0,134,2023-04-21T21:35,0,199000
174,2357957,85,111750,149000,97.0,2247,2023-04-21T21:35,0,111750
175,2668986,86,39900,0,96.0,3687,2023-04-21T21:35,-11970,27930
176,3051572,87,39000,93000,97.0,50,2023-04-21T21:35,-5850,33150
177,3010527,88,237150,279000,97.0,273,2023-04-21T21:35,0,237150
178,3096449,89,124200,138000,98.0,64,2023-04-21T21:35,-18630,105570
179,1567183,90,71175,94900,97.0,7528,2023-04-21T21:35,-10677,60498
180,1573215,1,111000,148000,98.0,9529,2023-04-21T21:35,-16650,94350
181,2112059,2,36400,52000,97.0,44087,2023-04-21T21:35,-5460,30940
182,1168906,3,35590,41900,97.0,71811,2023-04-21T21:35,0,35590
183,3246357,4,159000,198000,100.0,7,2023-04-21T21:35,0,159000
184,750908,5,34900,54000,96.0,84866,2023-04-21T21:35,0,34900
185,1551840,6,35100,39000,97.0,84752,2023-04-21T21:35,0,35100
186,1149329,7,39900,0,96.0,86891,2023-04-21T21:35,0,39900
187,2060719,8,55200,69000,96.0,5541,2023-04-21T21:35,-5520,49680
188,1926048,9,32000,0,97.0,15071,2023-04-21T21:35,0,32000
189,1924274,10,49900,66000,95.0,22782,2023-04-21T21:35,0,49900
190,3240542,11,71200,89000,0.0,0,2023-04-21T21:35,0,71200
191,1440874,12,39900,0,95.0,15232,2023-04-21T21:35,0,39900
192,1149328,13,35890,39900,96.0,94898,2023-04-21T21:35,0,35890
193,3180706,14,112000,0,0.0,0,2023-04-21T21:35,-16800,95200
194,2028327,15,42390,49900,97.0,9416,2023-04-21T21:35,0,42390
195,2028326,16,49900,0,97.0,6455,2023-04-21T21:35,0,49900
196,2060717,17,55200,69000,95.0,4075,2023-04-21T21:35,-5520,49680
197,1370101,18,39000,89000,96.0,23531,2023-04-21T21:35,-1950,37050
198,2112061,19,36400,52000,97.0,15218,2023-04-21T21:35,-5460,30940
199,1436504,20,41900,0,95.0,9316,2023-04-21T21:35,0,41900
200,1222184,21,37690,41900,97.0,48754,2023-04-21T21:35,0,37690
201,2358429,22,119250,159000,98.0,2693,2023-04-21T21:35,0,119250
202,1627892,23,43900,0,97.0,11456,2023-04-21T21:35,0,43900
203,2664737,24,45490,56900,98.0,435,2023-04-21T21:35,0,45490
204,2150457,25,119250,159000,97.0,4095,2023-04-21T21:35,-17888,101362
205,3220911,26,89000,129000,97.0,125,2023-04-21T21:35,0,89000
206,2664735,27,39790,56900,98.0,918,2023-04-21T21:35,0,39790
207,858911,28,39000,49000,95.0,67349,2023-04-21T21:35,-5850,33150
208,2060720,29,55200,69000,95.0,2703,2023-04-21T21:35,-5520,49680
209,2092852,30,42000,52800,96.0,11572,2023-04-21T21:35,-4200,37800
210,2569078,31,59250,79000,96.0,2521,2023-04-21T21:35,-8888,50362
211,2723714,32,46400,58000,96.0,1771,2023-04-21T21:35,0,46400
212,3134710,33,79900,0,96.0,6,2023-04-21T21:35,-11985,67915
213,1551839,34,39000,0,97.0,24039,2023-04-21T21:35,0,39000
214,2495075,35,49800,72000,95.0,12213,2023-04-21T21:35,-4980,44820
215,3043508,36,71200,89000,98.0,277,2023-04-21T21:35,0,71200
216,2720861,37,76300,109000,97.0,1340,2023-04-21T21:35,0,76300
217,1568057,38,49600,62000,96.0,22798,2023-04-21T21:35,-7440,42160
218,2310242,39,43450,79000,97.0,276,2023-04-21T21:35,-6518,36932
219,2725611,40,89600,128000,98.0,2258,2023-04-21T21:35,-13440,76160
220,3098372,41,89000,139000,97.0,1137,2023-04-21T21:35,0,89000
221,2281982,42,87120,99000,98.0,554,2023-04-21T21:35,-17424,69696
222,2703599,43,95200,119000,97.0,82,2023-04-21T21:35,-19040,76160
223,1436218,44,39900,68000,95.0,19669,2023-04-21T21:35,-3990,35910
224,2107115,45,98500,135000,98.0,11797,2023-04-21T21:35,-14775,83725
225,2060759,46,59800,74800,97.0,7442,2023-04-21T21:35,-5980,53820
226,3141395,47,49900,73900,97.0,239,2023-04-21T21:35,-4990,44910
227,2402843,48,39900,0,96.0,1338,2023-04-21T21:35,0,39900
228,3134713,49,79900,0,94.0,15,2023-04-21T21:35,-11985,67915
229,2789111,50,79200,99000,97.0,1021,2023-04-21T21:35,-11880,67320
230,1666442,51,44890,49900,97.0,11074,2023-04-21T21:35,0,44890
231,1736085,52,39900,59800,96.0,37386,2023-04-21T21:35,0,39900
232,1926034,53,32000,0,97.0,3192,2023-04-21T21:35,0,32000
233,2789091,54,79200,99000,97.0,987,2023-04-21T21:35,-11880,67320
234,1552753,55,70200,78000,97.0,28382,2023-04-21T21:35,-10530,59670
235,2084435,56,98000,109000,97.0,1369,2023-04-21T21:35,-19600,78400
236,3044076,57,80100,89000,97.0,69,2023-04-21T21:35,-12015,68085
237,1555407,58,70200,78000,97.0,11793,2023-04-21T21:35,-10530,59670
238,3034850,59,135150,159000,98.0,143,2023-04-21T21:35,0,135150
239,2032901,60,35890,39900,97.0,7060,2023-04-21T21:35,0,35890
240,1854665,61,139000,0,97.0,1138,2023-04-21T21:35,0,139000
241,1224095,62,35890,39900,97.0,24663,2023-04-21T21:35,0,35890
242,2192777,63,104250,139000,97.0,2327,2023-04-21T21:35,-15638,88612
243,1989228,64,43900,0,97.0,5528,2023-04-21T21:35,0,43900
244,2569079,65,59250,79000,96.0,1178,2023-04-21T21:35,-8888,50362
245,2706287,66,39800,54000,95.0,4226,2023-04-21T21:35,-5970,33830
246,2503133,67,42000,52800,96.0,3201,2023-04-21T21:35,-4200,37800
247,2184087,68,47200,89000,96.0,4249,2023-04-21T21:35,-2360,44840
248,1885631,69,39000,49000,96.0,23895,2023-04-21T21:35,-5850,33150
249,3134711,70,79900,0,100.0,1,2023-04-21T21:35,-11985,67915
250,1778523,71,39000,49000,96.0,3500,2023-04-21T21:35,-5850,33150
251,1323090,72,64400,92000,96.0,6114,2023-04-21T21:35,-12880,51520
252,3037465,73,45500,56900,95.0,353,2023-04-21T21:35,-6825,38675
253,2574822,74,19900,27800,96.0,1738,2023-04-21T21:35,0,19900
254,2028329,75,42390,49900,96.0,6687,2023-04-21T21:35,0,42390
255,2060743,76,33000,55000,95.0,3718,2023-04-21T21:35,-3300,29700
256,3134712,77,79900,0,100.0,4,2023-04-21T21:35,-11985,67915
257,1961498,78,62250,83000,98.0,2133,2023-04-21T21:35,-9338,52912
258,890338,79,39000,49000,95.0,47972,2023-04-21T21:35,-5850,33150
259,2261213,80,98550,135000,98.0,4185,2023-04-21T21:35,-14783,83767
260,1246215,81,49000,65000,96.0,6433,2023-04-21T21:35,-9800,39200
261,2503134,82,42000,52800,96.0,5447,2023-04-21T21:35,-4200,37800
262,2069525,83,37690,41900,96.0,3891,2023-04-21T21:35,0,37690
263,1414743,84,34300,49000,96.0,1140,2023-04-21T21:35,0,34300
264,2711142,85,29000,54000,96.0,1111,2023-04-21T21:35,0,29000
265,763134,86,16690,23900,95.0,24325,2023-04-21T21:35,0,16690
266,1212776,87,27090,31900,96.0,23684,2023-04-21T21:35,0,27090
267,3155551,88,65400,109000,93.0,9,2023-04-21T21:35,-3270,62130
268,2381406,89,103500,138000,98.0,2346,2023-04-21T21:35,-15525,87975
269,1477272,90,44200,68000,96.0,18072,2023-04-21T21:35,-2210,41990
270,1740936,1,39000,0,97.0,1585,2023-04-21T21:35,0,39000
271,1789507,2,71100,79000,98.0,26249,2023-04-21T21:35,0,71100
272,1034480,3,135000,150000,97.0,18295,2023-04-21T21:35,0,135000
273,2702033,4,127200,159000,97.0,455,2023-04-21T21:35,0,127200
274,3000157,5,142200,158000,96.0,165,2023-04-21T21:35,-21330,120870
275,3034751,6,64800,72000,96.0,620,2023-04-21T21:35,0,64800
276,1744101,7,103500,109000,98.0,3026,2023-04-21T21:35,0,103500
277,1969507,8,88000,0,98.0,5554,2023-04-21T21:35,0,88000
278,2235274,9,145000,0,98.0,775,2023-04-21T21:35,0,145000
279,2770508,10,138000,0,97.0,373,2023-04-21T21:35,0,138000
280,2558648,11,119000,0,98.0,1343,2023-04-21T21:35,0,119000
281,3038000,12,74700,83000,96.0,487,2023-04-21T21:35,0,74700
282,2066837,13,69000,119000,97.0,6640,2023-04-21T21:35,-10350,58650
283,2967335,14,1415000,2605000,88.0,7,2023-04-21T21:35,-30000,1385000
284,2105328,15,55300,79000,97.0,568,2023-04-21T21:35,-8295,47005
285,1264107,16,62000,90000,97.0,6513,2023-04-21T21:35,-9300,52700
286,2931071,17,2050000,2380000,0.0,0,2023-04-21T21:35,-30000,2020000
287,2393864,18,1950000,3130000,100.0,1,2023-04-21T21:35,-20000,1930000
288,2344540,19,96000,0,98.0,9438,2023-04-21T21:35,0,96000
289,2343665,20,89000,0,97.0,4728,2023-04-21T21:35,0,89000
290,2422175,21,145800,162000,98.0,234,2023-04-21T21:35,-21870,123930
291,1835080,22,98000,0,97.0,2920,2023-04-21T21:35,0,98000
292,1910358,23,99000,0,98.0,2550,2023-04-21T21:35,-14850,84150
293,2344538,24,119000,0,98.0,6548,2023-04-21T21:35,0,119000
294,1564343,25,92800,119000,98.0,8169,2023-04-21T21:35,-13920,78880
295,2657250,26,125400,149000,98.0,147,2023-04-21T21:35,0,125400
296,1842449,27,84000,99000,97.0,5518,2023-04-21T21:35,-16800,67200
297,2789785,28,140600,148000,97.0,702,2023-04-21T21:35,0,140600
298,2654166,29,82000,108000,95.0,139,2023-04-21T21:35,-12300,69700
299,3047568,30,109650,129000,96.0,103,2023-04-21T21:35,-10965,98685
300,2271789,31,71100,79000,97.0,2608,2023-04-21T21:35,0,71100
301,2514819,32,54000,66000,97.0,912,2023-04-21T21:35,0,54000
302,913402,33,83300,98000,95.0,8112,2023-04-21T21:35,-16660,66640
303,2320927,34,39000,51000,97.0,2359,2023-04-21T21:35,0,39000
304,2245952,35,46000,69000,96.0,205,2023-04-21T21:35,0,46000
305,3082387,36,139000,0,97.0,165,2023-04-21T21:35,-13900,125100
306,1581689,37,75600,89000,97.0,4090,2023-04-21T21:35,0,75600
307,3034745,38,75600,84000,97.0,219,2023-04-21T21:35,0,75600
308,342189,39,39500,52000,95.0,15874,2023-04-21T21:35,0,39500
309,3101111,40,161100,179000,95.0,56,2023-04-21T21:35,0,161100
310,3206841,41,142200,158000,0.0,0,2023-04-21T21:35,-21330,120870
311,2777025,42,335000,485000,100.0,62,2023-04-21T21:35,-30000,305000
312,1320752,43,67800,135000,97.0,4796,2023-04-21T21:35,0,67800
313,693318,44,75000,110000,96.0,13268,2023-04-21T21:35,-11250,63750
314,3029905,45,395000,0,99.0,51,2023-04-21T21:35,0,395000
315,2502052,46,98100,109000,96.0,152,2023-04-21T21:35,-4905,93195
316,2754080,47,88000,0,97.0,526,2023-04-21T21:35,0,88000
317,2295291,48,80100,89000,96.0,457,2023-04-21T21:35,0,80100
318,1969488,49,88000,0,98.0,1816,2023-04-21T21:35,0,88000
319,2998775,50,142200,158000,96.0,549,2023-04-21T21:35,0,142200
320,3149665,51,98000,0,93.0,26,2023-04-21T21:35,-14700,83300
321,1323612,52,238000,0,97.0,3864,2023-04-21T21:35,-11900,226100
322,1447194,53,59900,230000,96.0,2945,2023-04-21T21:35,0,59900
323,1528287,54,46500,49000,96.0,4733,2023-04-21T21:35,0,46500
324,3034749,55,64800,72000,97.0,539,2023-04-21T21:35,0,64800
325,2664933,56,90000,0,96.0,395,2023-04-21T21:35,0,90000
326,2757112,57,359000,0,93.0,104,2023-04-21T21:35,-53850,305150
327,1576725,58,127150,197000,97.0,5269,2023-04-21T21:35,-19073,108077
328,2914924,59,369000,439000,97.0,14,2023-04-21T21:35,0,369000
329,2630526,60,100000,0,97.0,703,2023-04-21T21:35,0,100000
330,2577899,61,138000,0,98.0,354,2023-04-21T21:35,0,138000
331,2940844,62,1422000,2750000,80.0,2,2023-04-21T21:35,0,1422000
332,2767263,63,72800,112000,95.0,424,2023-04-21T21:35,0,72800
333,2408317,64,145800,162000,96.0,419,2023-04-21T21:35,0,145800
334,2954961,65,95000,0,96.0,394,2023-04-21T21:35,0,95000
335,1597319,66,89100,99000,97.0,637,2023-04-21T21:35,-4455,84645
336,3161058,67,188000,0,95.0,4,2023-04-21T21:35,-28200,159800
337,1745100,68,103500,109000,97.0,1038,2023-04-21T21:35,0,103500
338,1960578,69,47200,59000,97.0,119,2023-04-21T21:35,0,47200
339,1408898,70,44100,49000,97.0,1386,2023-04-21T21:35,0,44100
340,3045584,71,130500,145000,97.0,3805,2023-04-21T21:35,0,130500
341,3029922,72,295000,0,96.0,105,2023-04-21T21:35,0,295000
342,1453531,73,53000,59000,96.0,3033,2023-04-21T21:35,0,53000
343,2333662,74,48300,69000,95.0,44,2023-04-21T21:35,-7245,41055
344,1456515,75,49500,55000,97.0,8821,2023-04-21T21:35,-7425,42075
345,2888946,76,79000,0,98.0,199,2023-04-21T21:35,0,79000
346,3187993,77,395000,0,100.0,4,2023-04-21T21:35,0,395000
347,3011494,78,69900,79000,96.0,285,2023-04-21T21:35,-6990,62910
348,1534526,79,52200,55000,97.0,2526,2023-04-21T21:35,0,52200
349,2993947,80,100000,0,96.0,174,2023-04-21T21:35,0,100000
350,1247560,81,71100,79000,96.0,4317,2023-04-21T21:35,0,71100
351,2117344,82,288000,0,97.0,174,2023-04-21T21:35,0,288000
352,693525,83,42000,65000,96.0,4078,2023-04-21T21:35,-6300,35700
353,3020963,84,379000,0,98.0,32,2023-04-21T21:35,0,379000
354,2668835,85,95200,119000,98.0,929,2023-04-21T21:35,-14280,80920
355,3008810,86,87000,0,100.0,12,2023-04-21T21:35,0,87000
356,938746,87,80100,89000,95.0,12589,2023-04-21T21:35,0,80100
357,1766527,88,136000,169000,97.0,1368,2023-04-21T21:35,0,136000
358,3077448,89,273600,288000,97.0,20,2023-04-21T21:35,0,273600
359,2902044,90,394000,695000,96.0,31,2023-04-21T21:35,-30000,364000
360,1762407,1,260000,0,97.0,3460,2023-04-21T21:35,0,260000
361,1762406,2,260000,0,98.0,3502,2023-04-21T21:35,0,260000
362,2638067,3,99000,139000,97.0,3292,2023-04-21T21:35,0,99000
363,969541,4,69000,0,97.0,30259,2023-04-21T21:35,0,69000
364,2545799,5,149000,0,98.0,2343,2023-04-21T21:35,0,149000
365,3026310,6,99000,0,99.0,935,2023-04-21T21:35,0,99000
366,2293400,7,129000,0,96.0,1093,2023-04-21T21:35,0,129000
367,186610,8,59900,85000,97.0,16735,2023-04-21T21:35,0,59900
368,810034,9,85500,95000,97.0,45454,2023-04-21T21:35,0,85500
369,2233180,10,64900,109000,97.0,14425,2023-04-21T21:35,0,64900
370,1622068,11,119000,0,97.0,6857,2023-04-21T21:35,0,119000
371,311052,12,53100,59000,97.0,41480,2023-04-21T21:35,0,53100
372,3122130,13,219000,0,100.0,10,2023-04-21T21:35,-65700,153300
373,1296778,14,99000,0,98.0,2206,2023-04-21T21:35,0,99000
374,181907,15,79900,119000,97.0,7255,2023-04-21T21:35,0,79900
375,2430426,16,169000,0,98.0,775,2023-04-21T21:35,0,169000
376,3033248,17,109000,0,97.0,730,2023-04-21T21:35,-10900,98100
377,1622069,18,119000,0,98.0,5979,2023-04-21T21:35,0,119000
378,3030422,19,117900,139000,96.0,934,2023-04-21T21:35,0,117900
379,2981033,20,99900,199000,97.0,41,2023-04-21T21:35,0,99900
380,695334,21,78900,99000,96.0,9584,2023-04-21T21:35,0,78900
381,2785168,22,179000,0,98.0,74,2023-04-21T21:35,0,179000
382,2233178,23,64900,109000,97.0,5057,2023-04-21T21:35,0,64900
383,1955217,24,69000,109000,96.0,5311,2023-04-21T21:35,-10350,58650
384,2493214,25,169000,0,98.0,214,2023-04-21T21:35,0,169000
385,1900410,26,129000,0,97.0,4974,2023-04-21T21:35,0,129000
386,577636,27,99900,139000,95.0,31333,2023-04-21T21:35,0,99900
387,2565212,28,119000,0,99.0,460,2023-04-21T21:35,0,119000
388,3172975,29,260000,0,96.0,12,2023-04-21T21:35,0,260000
389,2673444,30,49900,149000,95.0,459,2023-04-21T21:35,0,49900
390,490136,31,76000,95000,98.0,2681,2023-04-21T21:35,0,76000
391,2631192,32,98100,109000,98.0,441,2023-04-21T21:35,0,98100
392,3079037,33,195000,0,98.0,322,2023-04-21T21:35,0,195000
393,2524840,34,139000,0,96.0,904,2023-04-21T21:35,0,139000
394,2899663,35,59900,159000,95.0,44,2023-04-21T21:35,0,59900
395,2809006,36,728000,1130000,99.0,38,2023-04-21T21:35,0,728000
396,2161992,37,69900,95000,97.0,3514,2023-04-21T21:35,0,69900
397,2469965,38,69900,149000,96.0,1144,2023-04-21T21:35,0,69900
398,3155556,39,109000,0,0.0,0,2023-04-21T21:35,-21800,87200
399,2815898,40,52900,139000,97.0,74,2023-04-21T21:35,0,52900
400,816033,41,70900,89000,96.0,13460,2023-04-21T21:35,0,70900
401,2622254,42,109000,0,98.0,984,2023-04-21T21:35,0,109000
402,490135,43,59900,95000,98.0,3473,2023-04-21T21:35,0,59900
403,102620,44,69000,0,97.0,18044,2023-04-21T21:35,0,69000
404,810032,45,85500,95000,97.0,13823,2023-04-21T21:35,0,85500
405,3155557,46,109000,0,0.0,0,2023-04-21T21:35,-21800,87200
406,2320478,47,129000,0,97.0,582,2023-04-21T21:35,0,129000
407,2855992,48,142900,159000,97.0,648,2023-04-21T21:35,0,142900
408,1473136,49,119900,149000,97.0,10828,2023-04-21T21:35,0,119900
409,2737457,50,230000,0,98.0,491,2023-04-21T21:35,0,230000
410,1478592,51,59900,95000,97.0,3153,2023-04-21T21:35,0,59900
411,2070761,52,329000,0,98.0,375,2023-04-21T21:35,0,329000
412,3024528,53,132050,139000,96.0,118,2023-04-21T21:35,0,132050
413,3167965,54,119000,0,97.0,8,2023-04-21T21:35,0,119000
414,810033,55,89100,99000,97.0,34373,2023-04-21T21:35,0,89100
415,1900420,56,129000,0,96.0,1522,2023-04-21T21:35,0,129000
416,3122128,57,219000,0,97.0,35,2023-04-21T21:35,-43800,175200
417,1494180,58,71100,79000,95.0,5311,2023-04-21T21:35,0,71100
418,3214963,59,98100,109000,0.0,0,2023-04-21T21:35,0,98100
419,2909092,60,89000,0,96.0,404,2023-04-21T21:35,-8900,80100
420,2741233,61,109000,0,97.0,2832,2023-04-21T21:35,-10900,98100
421,3091287,62,119000,0,97.0,384,2023-04-21T21:35,0,119000
422,3023103,63,260000,0,98.0,98,2023-04-21T21:35,0,260000
423,3096431,64,139000,0,98.0,73,2023-04-21T21:35,0,139000
424,1744960,65,79900,149000,97.0,8277,2023-04-21T21:35,0,79900
425,1231944,66,119000,0,97.0,1424,2023-04-21T21:35,0,119000
426,2622252,67,109000,0,97.0,250,2023-04-21T21:35,0,109000
427,490134,68,59900,95000,97.0,2108,2023-04-21T21:35,0,59900
428,2440110,69,56900,59900,97.0,1277,2023-04-21T21:35,-8535,48365
429,2469964,70,59900,149000,95.0,270,2023-04-21T21:35,0,59900
430,2854904,71,49900,109000,97.0,1503,2023-04-21T21:35,0,49900
431,1798273,72,65000,119000,96.0,1227,2023-04-21T21:35,-6500,58500
432,1493265,73,85500,95000,98.0,5021,2023-04-21T21:35,0,85500
433,311051,74,58500,65000,97.0,19647,2023-04-21T21:35,0,58500
434,2731878,75,67900,79000,97.0,1937,2023-04-21T21:35,0,67900
435,1376278,76,59200,74000,95.0,1989,2023-04-21T21:35,-8880,50320
436,2899664,77,69900,159000,97.0,141,2023-04-21T21:35,0,69900
437,2670459,78,39900,99000,97.0,255,2023-04-21T21:35,0,39900
438,1812247,79,80100,89000,97.0,3091,2023-04-21T21:35,-12015,68085
439,1739446,80,109900,129000,97.0,841,2023-04-21T21:35,0,109900
440,1354129,81,69000,99000,95.0,8774,2023-04-21T21:35,-10350,58650
441,1017974,82,63200,79000,95.0,2984,2023-04-21T21:35,0,63200
442,2861393,83,96900,139000,93.0,319,2023-04-21T21:35,0,96900
443,957758,84,89000,0,97.0,4612,2023-04-21T21:35,0,89000
444,2981031,85,99900,199000,97.0,14,2023-04-21T21:35,0,99900
445,3034470,86,115000,129000,98.0,77,2023-04-21T21:35,0,115000
446,2050302,87,49900,129000,96.0,3026,2023-04-21T21:35,0,49900
447,2678412,88,39900,99000,94.0,243,2023-04-21T21:35,0,39900
448,3053324,89,129000,0,99.0,71,2023-04-21T21:35,0,129000
449,3008384,90,59900,75000,98.0,157,2023-04-21T21:35,0,59900
450,1092992,1,69000,0,97.0,38381,2023-04-21T21:35,0,69000
451,3134606,2,125100,139000,98.0,51,2023-04-21T21:35,0,125100
452,3062046,3,78300,87000,97.0,249,2023-04-21T21:35,0,78300
453,3061996,4,88200,98000,97.0,186,2023-04-21T21:35,0,88200
454,3134621,5,136800,152000,97.0,38,2023-04-21T21:35,0,136800
455,3124961,6,65550,69000,97.0,295,2023-04-21T21:35,0,65550
456,1720822,7,209000,0,97.0,317,2023-04-21T21:35,0,209000
457,2383245,8,99000,0,98.0,897,2023-04-21T21:35,0,99000
458,1568047,9,143100,159000,95.0,12061,2023-04-21T21:35,-21465,121635
459,2091749,10,75650,89000,95.0,6371,2023-04-21T21:35,0,75650
460,1334438,11,170000,0,96.0,4453,2023-04-21T21:35,0,170000
461,3161736,12,67900,158000,98.0,301,2023-04-21T21:35,-10185,57715
462,2432733,13,44900,59000,97.0,2957,2023-04-21T21:35,0,44900
463,595040,14,210000,0,95.0,8757,2023-04-21T21:35,0,210000
464,1339622,15,42900,59000,97.0,16474,2023-04-21T21:35,0,42900
465,451851,16,268000,0,97.0,1963,2023-04-21T21:35,0,268000
466,2910082,17,265500,295000,98.0,519,2023-04-21T21:35,0,265500
467,2816812,18,119900,0,93.0,1584,2023-04-21T21:35,0,119900
468,2101924,19,99900,0,97.0,1424,2023-04-21T21:35,0,99900
469,1419869,20,70300,74000,95.0,10596,2023-04-21T21:35,-10545,59755
470,1439535,21,49000,0,96.0,16394,2023-04-21T21:35,0,49000
471,2816816,22,159900,0,97.0,1900,2023-04-21T21:35,0,159900
472,1720813,23,149000,0,97.0,522,2023-04-21T21:35,0,149000
473,3134563,24,88200,98000,94.0,29,2023-04-21T21:35,0,88200
474,2664373,25,65000,0,97.0,1104,2023-04-21T21:35,0,65000
475,3242240,26,159000,0,100.0,2,2023-04-21T21:35,0,159000
476,3062069,27,71100,79000,97.0,89,2023-04-21T21:35,0,71100
477,2433538,28,84660,102000,96.0,2489,2023-04-21T21:35,0,84660
478,636821,29,160500,169000,93.0,2590,2023-04-21T21:35,-24075,136425
479,1439527,30,49000,0,95.0,13457,2023-04-21T21:35,0,49000
480,2621831,31,64400,92000,95.0,767,2023-04-21T21:35,-9660,54740
481,3223241,32,119000,0,97.0,17,2023-04-21T21:35,0,119000
482,3124959,33,55100,58000,97.0,67,2023-04-21T21:35,0,55100
483,2363570,34,39900,55000,97.0,1151,2023-04-21T21:35,0,39900
484,2114461,35,384900,428000,98.0,183,2023-04-21T21:35,0,384900
485,2624538,36,40900,59000,97.0,1609,2023-04-21T21:35,0,40900
486,3049313,37,57100,64900,97.0,781,2023-04-21T21:35,0,57100
487,1730341,38,180600,258000,96.0,452,2023-04-21T21:35,0,180600
488,3132471,39,79000,0,97.0,48,2023-04-21T21:35,0,79000
489,2957149,40,34900,59000,99.0,63,2023-04-21T21:35,0,34900
490,3142573,41,132300,189000,80.0,3,2023-04-21T21:35,0,132300
491,2664372,42,65000,0,97.0,1134,2023-04-21T21:35,0,65000
492,501198,43,129270,139000,95.0,2758,2023-04-21T21:35,0,129270
493,1815709,44,132000,168000,96.0,7186,2023-04-21T21:35,-13200,118800
494,2355318,45,98890,109900,96.0,667,2023-04-21T21:35,0,98890
495,2435822,46,94500,99000,97.0,287,2023-04-21T21:35,0,94500
496,3130687,47,152100,169000,100.0,1,2023-04-21T21:35,-22815,129285
497,1810760,48,135000,150000,96.0,183,2023-04-21T21:35,0,135000
498,2440524,49,69000,0,97.0,1621,2023-04-21T21:35,0,69000
499,2814379,50,120000,200000,98.0,28,2023-04-21T21:35,0,120000
500,1129750,51,69000,0,97.0,3990,2023-04-21T21:35,0,69000
501,2736221,52,110000,0,96.0,307,2023-04-21T21:35,0,110000
502,1021359,53,61000,100000,94.0,5397,2023-04-21T21:35,-9150,51850
503,1438359,54,99000,0,97.0,1216,2023-04-21T21:35,0,99000
504,2200821,55,259000,0,99.0,124,2023-04-21T21:35,0,259000
505,2356342,56,103890,129900,94.0,470,2023-04-21T21:35,0,103890
506,1699941,57,67150,79000,97.0,4943,2023-04-21T21:35,-10073,57077
507,1828166,58,126000,210000,94.0,855,2023-04-21T21:35,0,126000
508,1562990,59,230000,0,96.0,1289,2023-04-21T21:35,0,230000
509,685185,60,139000,198000,95.0,12515,2023-04-21T21:35,-20850,118150
510,3024585,61,59000,0,97.0,168,2023-04-21T21:35,-8850,50150
511,1890398,62,132000,168000,96.0,2777,2023-04-21T21:35,-13200,118800
512,1828555,63,232200,258000,96.0,416,2023-04-21T21:35,0,232200
513,607298,64,44700,59000,93.0,15619,2023-04-21T21:35,-6705,37995
514,2542100,65,138000,0,100.0,2,2023-04-21T21:35,-20700,117300
515,2032683,66,210000,0,96.0,184,2023-04-21T21:35,0,210000
516,2425751,67,225000,485000,98.0,11,2023-04-21T21:35,-20000,205000
517,2919224,68,670000,1000000,0.0,0,2023-04-21T21:35,0,670000
518,2419871,69,44900,59000,97.0,982,2023-04-21T21:35,0,44900
519,2910086,70,265500,295000,98.0,226,2023-04-21T21:35,0,265500
520,2143833,71,89640,108000,96.0,2462,2023-04-21T21:35,0,89640
521,1928038,72,84600,94000,96.0,1198,2023-04-21T21:35,-12690,71910
522,3172972,73,138000,0,98.0,12,2023-04-21T21:35,0,138000
523,1548618,74,152000,198000,96.0,3312,2023-04-21T21:35,-22800,129200
524,1334440,75,102000,170000,96.0,2066,2023-04-21T21:35,0,102000
525,2257887,76,109000,119000,96.0,2361,2023-04-21T21:35,-16350,92650
526,2101922,77,101890,119900,96.0,1898,2023-04-21T21:35,0,101890
527,2379000,78,151500,159000,98.0,134,2023-04-21T21:35,0,151500
528,1952910,79,265500,295000,98.0,1748,2023-04-21T21:35,0,265500
529,2340324,80,169000,199000,98.0,200,2023-04-21T21:35,0,169000
530,3132539,81,69000,0,100.0,13,2023-04-21T21:35,0,69000
531,1730340,82,232200,258000,97.0,4283,2023-04-21T21:35,0,232200
532,2732152,83,289000,0,92.0,25,2023-04-21T21:35,0,289000
533,1334813,84,134000,168000,95.0,1732,2023-04-21T21:35,-13400,120600
534,2735953,85,230000,0,98.0,454,2023-04-21T21:35,0,230000
535,3119471,86,129900,0,0.0,0,2023-04-21T21:35,-12990,116910
536,3188391,87,119000,170000,0.0,0,2023-04-21T21:35,0,119000
537,1762562,88,95100,109000,95.0,316,2023-04-21T21:35,0,95100
538,2555608,89,268000,299000,93.0,26,2023-04-21T21:35,-13400,254600
539,1300861,90,183600,204000,95.0,299,2023-04-21T21:35,0,183600
540,2134140,1,39000,0,97.0,3688,2023-04-21T21:35,-5850,33150
541,1822717,2,56050,59000,97.0,4383,2023-04-21T21:35,0,56050
542,2356713,3,39000,0,97.0,1531,2023-04-21T21:35,-5850,33150
543,1214164,4,36000,0,96.0,25102,2023-04-21T21:35,0,36000
544,2134158,5,39000,0,97.0,2586,2023-04-21T21:35,-5850,33150
545,2280117,6,35100,39000,97.0,6502,2023-04-21T21:35,0,35100
546,1920929,7,39000,0,97.0,4082,2023-04-21T21:35,-5850,33150
547,1771137,8,26100,29000,97.0,12682,2023-04-21T21:35,0,26100
548,1272626,9,36000,0,96.0,14253,2023-04-21T21:35,0,36000
549,2879419,10,48900,55000,98.0,849,2023-04-21T21:35,-7335,41565
550,2356711,11,39000,0,97.0,1553,2023-04-21T21:35,-5850,33150
551,1022014,12,79000,0,96.0,11496,2023-04-21T21:35,0,79000
552,1214174,13,36000,0,97.0,15129,2023-04-21T21:35,0,36000
553,2028240,14,39000,0,98.0,3390,2023-04-21T21:35,-5850,33150
554,2560668,15,48300,69000,97.0,1277,2023-04-21T21:35,0,48300
555,2123132,16,36900,39000,97.0,6473,2023-04-21T21:35,-3690,33210
556,2287131,17,31450,37000,95.0,1752,2023-04-21T21:35,-4718,26732
557,2356693,18,39000,0,97.0,1569,2023-04-21T21:35,-5850,33150
558,2879425,19,48900,55000,97.0,355,2023-04-21T21:35,-7335,41565
559,1771132,20,29000,0,96.0,5360,2023-04-21T21:35,0,29000
560,1855444,21,39900,42000,97.0,3083,2023-04-21T21:35,-5985,33915
561,2576197,22,35100,39000,98.0,23,2023-04-21T21:35,0,35100
562,1214317,23,36000,0,97.0,11557,2023-04-21T21:35,0,36000
563,2381807,24,48300,69000,98.0,1167,2023-04-21T21:35,0,48300
564,1524720,25,36000,0,96.0,3439,2023-04-21T21:35,0,36000
565,1214169,26,36000,0,96.0,5393,2023-04-21T21:35,0,36000
566,2864918,27,49000,0,99.0,153,2023-04-21T21:35,0,49000
567,3119084,28,69000,0,86.0,3,2023-04-21T21:35,-12420,56580
568,2859190,29,33300,37000,96.0,490,2023-04-21T21:35,-4995,28305
569,1022013,30,79000,0,96.0,6309,2023-04-21T21:35,0,79000
570,1214173,31,36000,0,96.0,5639,2023-04-21T21:35,0,36000
571,2221221,32,35100,39000,96.0,1911,2023-04-21T21:35,0,35100
572,1214109,33,36000,0,97.0,8216,2023-04-21T21:35,0,36000
573,2286829,34,31450,37000,95.0,5092,2023-04-21T21:35,-4718,26732
574,1907733,35,29900,39000,96.0,3918,2023-04-21T21:35,0,29900
575,2672186,36,20900,30000,96.0,629,2023-04-21T21:35,-2299,18601
576,1214106,37,36000,0,96.0,9788,2023-04-21T21:35,0,36000
577,3012243,38,29900,39900,99.0,88,2023-04-21T21:35,-4485,25415
578,1939301,39,39000,0,97.0,828,2023-04-21T21:35,-5850,33150
579,1452917,40,69000,0,96.0,2434,2023-04-21T21:35,0,69000
580,2280146,41,35100,39000,97.0,960,2023-04-21T21:35,0,35100
581,2707659,42,37800,42000,97.0,546,2023-04-21T21:35,-3780,34020
582,1771133,43,26100,29000,97.0,5766,2023-04-21T21:35,0,26100
583,2922090,44,52000,0,96.0,76,2023-04-21T21:35,0,52000
584,2107999,45,36000,0,97.0,2719,2023-04-21T21:35,0,36000
585,1906772,46,39900,42000,97.0,3125,2023-04-21T21:35,-5985,33915
586,2053753,47,42000,0,98.0,4170,2023-04-21T21:35,-6300,35700
587,2134295,48,39000,0,97.0,424,2023-04-21T21:35,0,39000
588,2650964,49,48900,53000,98.0,211,2023-04-21T21:35,-7335,41565
589,2507080,50,39000,0,98.0,440,2023-04-21T21:35,-5850,33150
590,2591291,51,39200,49000,97.0,1051,2023-04-21T21:35,0,39200
591,1755276,52,46550,49000,97.0,2432,2023-04-21T21:35,-9310,37240
592,2329375,53,34710,39000,96.0,2138,2023-04-21T21:35,-3471,31239
593,2573131,54,39900,42000,98.0,727,2023-04-21T21:35,-5985,33915
594,3039061,55,33150,39000,96.0,47,2023-04-21T21:35,-4973,28177
595,3099126,56,54000,0,98.0,14,2023-04-21T21:35,0,54000
596,1497550,57,29600,37000,95.0,5737,2023-04-21T21:35,0,29600
597,1022015,58,79000,0,96.0,1956,2023-04-21T21:35,0,79000
598,410572,59,33150,39000,94.0,9385,2023-04-21T21:35,-4973,28177
599,1920840,60,39000,0,98.0,1398,2023-04-21T21:35,-5850,33150
600,3099783,61,54150,57000,98.0,15,2023-04-21T21:35,0,54150
601,1214171,62,36000,0,97.0,1737,2023-04-21T21:35,0,36000
602,1086824,63,29600,37000,95.0,18664,2023-04-21T21:35,0,29600
603,2289281,64,28500,38000,96.0,919,2023-04-21T21:35,0,28500
604,2683883,65,69000,0,97.0,149,2023-04-21T21:35,0,69000
605,2198830,66,14700,21000,95.0,1508,2023-04-21T21:35,0,14700
606,2980928,67,308000,490000,91.0,19,2023-04-21T21:35,-30000,278000
607,3039055,68,36550,43000,96.0,63,2023-04-21T21:35,-5483,31067
608,2169131,69,35100,39000,97.0,469,2023-04-21T21:35,0,35100
609,2531210,70,26300,35000,97.0,685,2023-04-21T21:35,-3945,22355
610,3225733,71,49000,0,100.0,12,2023-04-21T21:35,0,49000
611,2879417,72,48900,55000,98.0,230,2023-04-21T21:35,-7335,41565
612,3170707,73,39000,0,90.0,22,2023-04-21T21:35,0,39000
613,2384630,74,42000,0,98.0,789,2023-04-21T21:35,0,42000
614,2962388,75,31200,39000,96.0,145,2023-04-21T21:35,0,31200
615,2921965,76,52000,0,98.0,194,2023-04-21T21:35,0,52000
616,2875051,77,138000,207000,97.0,29,2023-04-21T21:35,-27600,110400
617,2286824,78,33300,37000,96.0,1025,2023-04-21T21:35,-4995,28305
618,3099784,79,54150,57000,95.0,17,2023-04-21T21:35,0,54150
619,2715553,80,68000,0,95.0,281,2023-04-21T21:35,0,68000
620,1335132,81,29000,0,95.0,1136,2023-04-21T21:35,0,29000
621,2287158,82,33300,37000,95.0,1261,2023-04-21T21:35,-4995,28305
622,2996001,83,48900,55000,95.0,28,2023-04-21T21:35,-7335,41565
623,2658143,84,35100,39000,96.0,285,2023-04-21T21:35,0,35100
624,2435766,85,37900,39900,98.0,221,2023-04-21T21:35,-5685,32215
625,2288644,86,35700,42000,96.0,1233,2023-04-21T21:35,-7140,28560
626,2864774,87,49000,0,98.0,103,2023-04-21T21:35,0,49000
627,3051146,88,34000,0,92.0,48,2023-04-21T21:35,-3400,30600
628,3119341,89,129000,0,100.0,3,2023-04-21T21:35,0,129000
629,1632175,90,36900,39000,97.0,2731,2023-04-21T21:35,-3690,33210
630,2489894,1,142200,158000,98.0,109,2023-04-21T21:35,0,142200
631,2605850,2,94000,0,97.0,174,2023-04-21T21:35,-4700,89300
632,2457512,3,237300,339000,98.0,37,2023-04-21T21:35,0,237300
633,3106487,4,133200,148000,99.0,30,2023-04-21T21:35,0,133200
634,3102177,5,230000,0,100.0,1,2023-04-21T21:35,0,230000
635,1875664,6,33190,36900,96.0,572,2023-04-21T21:35,0,33190
636,2568529,7,220000,0,100.0,14,2023-04-21T21:35,0,220000
637,3031171,8,68000,0,98.0,65,2023-04-21T21:35,0,68000
638,3138205,9,147250,155000,0.0,0,2023-04-21T21:35,0,147250
639,2392489,10,28690,31900,97.0,738,2023-04-21T21:35,0,28690
640,3148942,11,399000,0,0.0,0,2023-04-21T21:35,0,399000
641,3206508,12,150100,158000,0.0,0,2023-04-21T21:35,-7505,142595
642,3148943,13,399000,0,0.0,0,2023-04-21T21:35,0,399000
643,3130633,14,149000,0,100.0,6,2023-04-21T21:35,-7450,141550
644,3109653,15,194600,278000,0.0,0,2023-04-21T21:35,0,194600
645,2424645,16,125300,179000,96.0,15,2023-04-21T21:35,-22554,102746
646,3206504,17,159600,168000,0.0,0,2023-04-21T21:35,0,159600
647,3092174,18,365000,0,0.0,0,2023-04-21T21:35,0,365000
648,2388209,19,94000,0,96.0,158,2023-04-21T21:35,-4700,89300
649,1875663,20,33190,36900,95.0,834,2023-04-21T21:35,0,33190
650,1779568,21,54400,64000,95.0,294,2023-04-21T21:35,-8160,46240
651,2512635,22,35400,59000,96.0,227,2023-04-21T21:35,0,35400
652,3198182,23,289000,0,0.0,0,2023-04-21T21:35,-14450,274550
653,2392491,24,28690,31900,96.0,407,2023-04-21T21:35,0,28690
654,3230056,25,252000,0,0.0,0,2023-04-21T21:35,0,252000
655,3081772,26,189000,0,96.0,5,2023-04-21T21:35,0,189000
656,3190290,27,249000,0,0.0,0,2023-04-21T21:35,0,249000
657,3145607,28,249000,0,100.0,3,2023-04-21T21:35,-12450,236550
658,3074707,29,119000,0,100.0,4,2023-04-21T21:35,0,119000
659,3137386,30,238000,298000,0.0,0,2023-04-21T21:35,-42840,195160
660,1103286,31,94000,0,95.0,784,2023-04-21T21:35,0,94000
661,3102188,32,230000,0,0.0,0,2023-04-21T21:35,0,230000
662,3205817,33,229900,242000,0.0,0,2023-04-21T21:35,-34485,195415
663,3187364,34,59900,0,0.0,0,2023-04-21T21:35,-8985,50915
664,3230036,35,212000,0,0.0,0,2023-04-21T21:35,0,212000
665,2415480,36,148000,0,98.0,12,2023-04-21T21:35,0,148000
666,2412916,37,223000,0,100.0,2,2023-04-21T21:35,0,223000
667,2478652,38,61200,68000,94.0,341,2023-04-21T21:35,-9180,52020
668,2610808,39,280000,573000,0.0,0,2023-04-21T21:35,0,280000
669,3146756,40,209000,0,0.0,0,2023-04-21T21:35,-37620,171380
670,3203077,41,168000,0,0.0,0,2023-04-21T21:35,-25200,142800
671,3050856,42,170100,189000,92.0,14,2023-04-21T21:35,-8505,161595
672,2448897,43,39890,49900,97.0,29,2023-04-21T21:35,0,39890
673,3081770,44,189000,0,96.0,5,2023-04-21T21:35,0,189000
674,3242725,45,198000,0,0.0,0,2023-04-21T21:35,0,198000
675,3201469,46,159000,0,0.0,0,2023-04-21T21:35,0,159000
676,3105579,47,189000,0,0.0,0,2023-04-21T21:35,0,189000
677,3050173,48,166600,238000,100.0,6,2023-04-21T21:35,0,166600
678,3053218,49,159000,0,90.0,4,2023-04-21T21:35,0,159000
679,3135234,50,62300,89000,94.0,7,2023-04-21T21:35,-9345,52955
680,3124527,51,197100,219000,0.0,0,2023-04-21T21:35,0,197100
681,3105576,52,189000,0,100.0,2,2023-04-21T21:35,0,189000
682,2970900,53,189000,0,100.0,6,2023-04-21T21:35,0,189000
683,3158872,54,94900,105000,0.0,0,2023-04-21T21:35,-9490,85410
684,2568590,55,185000,0,100.0,5,2023-04-21T21:35,0,185000
685,3130640,56,169000,0,100.0,2,2023-04-21T21:35,-8450,160550
686,1537416,57,57800,68000,90.0,134,2023-04-21T21:35,0,57800
687,3186964,58,189000,0,0.0,0,2023-04-21T21:35,0,189000
688,2698154,59,189000,0,0.0,0,2023-04-21T21:35,0,189000
689,3230044,60,178000,0,0.0,0,2023-04-21T21:35,0,178000
690,3200457,61,159000,0,0.0,0,2023-04-21T21:35,-15900,143100
691,3041837,62,168000,0,0.0,0,2023-04-21T21:35,0,168000
692,3102263,63,165000,0,0.0,0,2023-04-21T21:35,0,165000
693,2306207,64,19880,28000,93.0,524,2023-04-21T21:35,0,19880
694,3146668,65,159600,168000,100.0,3,2023-04-21T21:35,0,159600
695,3078199,66,178000,0,0.0,0,2023-04-21T21:35,-26700,151300
696,3130620,67,141550,149000,0.0,0,2023-04-21T21:35,-7078,134472
697,3147475,68,159000,0,0.0,0,2023-04-21T21:35,0,159000
698,3126193,69,63200,79000,95.0,8,2023-04-21T21:35,-9480,53720
699,3193295,70,168000,0,0.0,0,2023-04-21T21:35,0,168000
700,3227586,71,159000,0,0.0,0,2023-04-21T21:35,-15900,143100
701,3201739,72,62100,69000,0.0,0,2023-04-21T21:35,-4347,57753
702,3210314,73,62100,69000,0.0,0,2023-04-21T21:35,-3105,58995
703,3107083,74,89000,0,100.0,6,2023-04-21T21:35,0,89000
704,2245439,75,33190,36900,97.0,59,2023-04-21T21:35,0,33190
705,3152244,76,159000,0,0.0,0,2023-04-21T21:35,0,159000
706,1968720,77,154000,0,90.0,4,2023-04-21T21:35,0,154000
707,2455865,78,166400,208000,0.0,0,2023-04-21T21:35,0,166400
708,3071464,79,159000,0,100.0,4,2023-04-21T21:35,0,159000
709,3132939,80,158000,0,0.0,0,2023-04-21T21:35,-23700,134300
710,3152241,81,159000,0,100.0,2,2023-04-21T21:35,0,159000
711,3195127,82,159000,0,0.0,0,2023-04-21T21:35,0,159000
712,3120382,83,159000,0,0.0,0,2023-04-21T21:35,-23850,135150
713,2620217,84,159600,228000,97.0,7,2023-04-21T21:35,0,159600
714,3170245,85,159000,0,0.0,0,2023-04-21T21:35,0,159000
715,2359795,86,160650,189000,100.0,18,2023-04-21T21:35,0,160650
716,2106476,87,59900,0,96.0,18,2023-04-21T21:35,0,59900
717,2457508,88,153300,219000,96.0,33,2023-04-21T21:35,0,153300
718,3119265,89,111200,139000,0.0,0,2023-04-21T21:35,0,111200
719,2435044,90,77900,82000,93.0,36,2023-04-21T21:35,0,77900
720,2631866,1,174000,290000,0.0,0,2023-04-21T21:35,-31320,142680
721,3031104,2,48300,69000,98.0,76,2023-04-21T21:35,-7245,41055
722,3058718,3,86400,96000,92.0,19,2023-04-21T21:35,-15552,70848
723,2377804,4,198000,0,93.0,38,2023-04-21T21:35,-35640,162360
724,1944554,5,36900,0,96.0,566,2023-04-21T21:35,-3690,33210
725,2607711,6,399000,0,0.0,0,2023-04-21T21:35,-70000,329000
726,2716675,7,39900,59000,96.0,187,2023-04-21T21:35,-5985,33915
727,3185771,8,368000,0,0.0,0,2023-04-21T21:35,-66240,301760
728,3047863,9,368000,0,0.0,0,2023-04-21T21:35,-66240,301760
729,2864414,10,69300,99000,95.0,102,2023-04-21T21:35,-10395,58905
730,2413549,11,116100,129000,99.0,45,2023-04-21T21:35,-20898,95202
731,1645760,12,43900,0,96.0,351,2023-04-21T21:35,0,43900
732,1931894,13,37900,0,95.0,539,2023-04-21T21:35,0,37900
733,2551400,14,39900,0,93.0,151,2023-04-21T21:35,0,39900
734,3127627,15,319000,0,0.0,0,2023-04-21T21:35,-57420,261580
735,3000422,16,59000,0,96.0,45,2023-04-21T21:35,0,59000
736,3133296,17,143100,159000,0.0,0,2023-04-21T21:35,-21465,121635
737,3113979,18,298000,0,0.0,0,2023-04-21T21:35,-53640,244360
738,3089308,19,143650,169000,0.0,0,2023-04-21T21:35,0,143650
739,3144417,20,71100,79000,100.0,3,2023-04-21T21:35,0,71100
740,2978106,21,49900,0,100.0,6,2023-04-21T21:35,-4990,44910
741,3190572,22,264000,378000,100.0,1,2023-04-21T21:35,-47520,216480
742,3190568,23,278000,398000,0.0,0,2023-04-21T21:35,-50040,227960
743,2413507,24,116100,129000,95.0,45,2023-04-21T21:35,-20898,95202
744,3144257,25,66000,82000,93.0,3,2023-04-21T21:35,-9900,56100
745,3058721,26,86400,96000,93.0,9,2023-04-21T21:35,-15552,70848
746,2978103,27,47900,0,98.0,14,2023-04-21T21:35,0,47900
747,2925522,28,65000,0,96.0,131,2023-04-21T21:35,0,65000
748,3233403,29,239000,0,0.0,0,2023-04-21T21:35,-43020,195980
749,2850491,30,250600,358000,100.0,5,2023-04-21T21:35,-45108,205492
750,2942784,31,189000,0,100.0,3,2023-04-21T21:35,-28350,160650
751,1324169,32,29900,0,95.0,1359,2023-04-21T21:35,0,29900
752,3062947,33,110400,138000,100.0,5,2023-04-21T21:35,0,110400
753,3105866,34,89000,0,97.0,7,2023-04-21T21:35,-13350,75650
754,3091416,35,115600,0,91.0,9,2023-04-21T21:35,0,115600
755,3132900,36,170100,189000,0.0,0,2023-04-21T21:35,-25515,144585
756,2798672,37,208600,298000,100.0,1,2023-04-21T21:35,-37548,171052
757,1819994,38,36500,43000,92.0,669,2023-04-21T21:35,-3650,32850
758,3070528,39,168000,0,95.0,4,2023-04-21T21:35,0,168000
759,2541603,40,203000,290000,0.0,0,2023-04-21T21:35,-36540,166460
760,2551401,41,37900,0,94.0,334,2023-04-21T21:35,0,37900
761,2316503,42,38400,64000,94.0,336,2023-04-21T21:35,0,38400
762,3144344,43,66000,82000,100.0,1,2023-04-21T21:35,-9900,56100
763,2117249,44,29590,32900,94.0,464,2023-04-21T21:35,-2959,26631
764,3190834,45,198000,0,0.0,0,2023-04-21T21:35,0,198000
765,2664567,46,173000,0,100.0,6,2023-04-21T21:35,-31140,141860
766,3073252,47,160200,178000,100.0,6,2023-04-21T21:35,-28836,131364
767,3119570,48,198000,0,100.0,1,2023-04-21T21:35,0,198000
768,3135305,49,38500,55000,100.0,5,2023-04-21T21:35,-5775,32725
769,3134491,50,188340,219000,0.0,0,2023-04-21T21:35,-33902,154438
770,3137062,51,185000,0,0.0,0,2023-04-21T21:35,-18500,166500
771,3126113,52,55300,79000,88.0,16,2023-04-21T21:35,-8295,47005
772,3193975,53,178200,198000,0.0,0,2023-04-21T21:35,-8910,169290
773,3179304,54,174400,218000,0.0,0,2023-04-21T21:35,-31392,143008
774,2590578,55,178200,198000,0.0,0,2023-04-21T21:35,-32076,146124
775,2378594,56,88200,98000,95.0,132,2023-04-21T21:35,0,88200
776,3170471,57,139000,0,100.0,1,2023-04-21T21:35,0,139000
777,3081768,58,169000,0,100.0,3,2023-04-21T21:35,0,169000
778,2448900,59,43900,0,96.0,108,2023-04-21T21:35,0,43900
779,2756335,60,125400,132000,97.0,69,2023-04-21T21:35,0,125400
780,3081766,61,169000,0,100.0,2,2023-04-21T21:35,0,169000
781,3221635,62,84000,0,0.0,0,2023-04-21T21:35,0,84000
782,2771725,63,166600,238000,94.0,15,2023-04-21T21:35,-29988,136612
783,1944553,64,36900,0,96.0,221,2023-04-21T21:35,-3690,33210
784,3040758,65,94400,111000,92.0,23,2023-04-21T21:35,-14160,80240
785,2533449,66,39840,48000,96.0,25,2023-04-21T21:35,-3984,35856
786,3133082,67,171000,0,90.0,6,2023-04-21T21:35,0,171000
787,3133264,68,143100,159000,0.0,0,2023-04-21T21:35,-21465,121635
788,2551407,69,37900,0,97.0,193,2023-04-21T21:35,0,37900
789,3047742,70,71100,79000,85.0,11,2023-04-21T21:35,0,71100
790,3133119,71,171000,0,0.0,0,2023-04-21T21:35,0,171000
791,3092928,72,139000,0,100.0,1,2023-04-21T21:35,0,139000
792,2830762,73,139000,0,99.0,48,2023-04-21T21:35,0,139000
793,2806614,74,119000,0,97.0,117,2023-04-21T21:35,0,119000
794,3122265,75,124200,138000,88.0,5,2023-04-21T21:35,-22356,101844
795,3124534,76,152150,179000,0.0,0,2023-04-21T21:35,0,152150
796,2914815,77,151200,189000,96.0,5,2023-04-21T21:35,0,151200
797,3216015,78,149000,0,0.0,0,2023-04-21T21:35,-26820,122180
798,2860567,79,143400,239000,96.0,5,2023-04-21T21:35,-25812,117588
799,3051192,80,98100,109000,95.0,26,2023-04-21T21:35,-4905,93195
800,2533425,81,32300,38000,96.0,219,2023-04-21T21:35,-3230,29070
801,3093391,82,149000,0,100.0,2,2023-04-21T21:35,0,149000
802,3200164,83,125100,139000,100.0,1,2023-04-21T21:35,-22518,102582
803,3125453,84,49900,89900,92.0,5,2023-04-21T21:35,0,49900
804,3147218,85,148000,0,0.0,0,2023-04-21T21:35,0,148000
805,2883202,86,148000,0,0.0,0,2023-04-21T21:35,0,148000
806,3039835,87,142200,158000,100.0,4,2023-04-21T21:35,0,142200
807,2739218,88,75600,108000,92.0,8,2023-04-21T21:35,0,75600
808,3115376,89,140400,156000,0.0,0,2023-04-21T21:35,0,140400
809,2660961,90,53100,59000,98.0,153,2023-04-21T21:35,0,53100
810,991339,1,17890,19900,97.0,53460,2023-04-21T21:35,0,17890
811,1986031,2,27900,0,97.0,10875,2023-04-21T21:35,0,27900
812,998051,3,15900,24000,97.0,164480,2023-04-21T21:35,0,15900
813,991340,4,19900,0,97.0,31085,2023-04-21T21:35,0,19900
814,763821,5,16900,22000,96.0,31547,2023-04-21T21:35,0,16900
815,1094835,6,15900,0,97.0,6296,2023-04-21T21:35,0,15900
816,792919,7,15190,16900,96.0,17999,2023-04-21T21:35,0,15190
817,1477845,8,15400,22000,96.0,9845,2023-04-21T21:35,0,15400
818,1996705,9,23690,27900,98.0,2743,2023-04-21T21:35,0,23690
819,1094748,10,19900,0,97.0,19312,2023-04-21T21:35,0,19900
820,1996702,11,25090,27900,97.0,1967,2023-04-21T21:35,0,25090
821,746158,12,19390,22900,96.0,20574,2023-04-21T21:35,0,19390
822,1342874,13,16900,33000,97.0,13094,2023-04-21T21:35,0,16900
823,991341,14,16890,19900,96.0,10285,2023-04-21T21:35,0,16890
824,792920,15,15190,16900,96.0,9705,2023-04-21T21:35,0,15190
825,1062063,16,9490,15900,96.0,2179,2023-04-21T21:35,0,9490
826,2845854,17,13000,18900,97.0,293,2023-04-21T21:35,-2600,10400
827,746154,18,17900,0,96.0,5219,2023-04-21T21:35,0,17900
828,1092994,19,19390,22900,96.0,2670,2023-04-21T21:35,0,19390
829,734085,20,13900,19800,96.0,65211,2023-04-21T21:35,0,13900
830,1986029,21,25090,27900,97.0,4009,2023-04-21T21:35,0,25090
831,479245,22,15400,22000,93.0,5448,2023-04-21T21:35,0,15400
832,3009680,23,12590,14900,98.0,150,2023-04-21T21:35,0,12590
833,1974077,24,37490,46900,97.0,908,2023-04-21T21:35,0,37490
834,1729576,25,9900,13900,97.0,16351,2023-04-21T21:35,-1485,8415
835,1094750,26,16890,19900,97.0,3575,2023-04-21T21:35,0,16890
836,1986030,27,25090,27900,97.0,1711,2023-04-21T21:35,0,25090
837,1443937,28,12900,24000,97.0,8209,2023-04-21T21:35,0,12900
838,991570,29,12900,20000,97.0,19179,2023-04-21T21:35,0,12900
839,792921,30,15190,16900,95.0,7822,2023-04-21T21:35,0,15190
840,2960555,31,19000,0,93.0,128,2023-04-21T21:35,0,19000
841,2477854,32,16890,19900,98.0,1480,2023-04-21T21:35,0,16890
842,2821598,33,19390,22900,97.0,163,2023-04-21T21:35,0,19390
843,746159,34,19390,22900,95.0,28755,2023-04-21T21:35,0,19390
844,1094749,35,19900,0,96.0,4982,2023-04-21T21:35,0,19900
845,3033249,36,15000,0,95.0,283,2023-04-21T21:35,0,15000
846,1094837,37,13490,15900,96.0,1776,2023-04-21T21:35,0,13490
847,2832613,38,11900,33000,97.0,796,2023-04-21T21:35,0,11900
848,2821588,39,19690,21900,97.0,56,2023-04-21T21:35,0,19690
849,2297277,40,19900,22000,96.0,322,2023-04-21T21:35,0,19900
850,2821589,41,19690,21900,96.0,43,2023-04-21T21:35,0,19690
851,1094834,42,20290,23900,96.0,2473,2023-04-21T21:35,0,20290
852,1094836,43,15900,0,97.0,1334,2023-04-21T21:35,0,15900
853,1392775,44,8290,11900,96.0,267,2023-04-21T21:35,0,8290
854,2973894,45,22000,27500,98.0,32,2023-04-21T21:35,-1100,20900
855,2295818,46,19900,22000,95.0,190,2023-04-21T21:35,0,19900
856,2738094,47,17890,19900,96.0,178,2023-04-21T21:35,0,17890
857,1346009,48,9900,12000,97.0,6762,2023-04-21T21:35,-1485,8415
858,2011852,49,21490,23900,97.0,1327,2023-04-21T21:35,0,21490
859,2959925,50,22000,27500,98.0,133,2023-04-21T21:35,-1100,20900
860,1392772,51,16890,19900,96.0,1150,2023-04-21T21:35,0,16890
861,1996704,52,22290,27900,97.0,724,2023-04-21T21:35,0,22290
862,2870865,53,15900,19900,95.0,73,2023-04-21T21:35,-3180,12720
863,958997,54,15190,17900,95.0,1422,2023-04-21T21:35,0,15190
864,1358721,55,14900,22000,96.0,1159,2023-04-21T21:35,-2235,12665
865,1392777,56,11890,19900,96.0,389,2023-04-21T21:35,0,11890
866,2011850,57,21490,23900,98.0,875,2023-04-21T21:35,0,21490
867,472686,58,9900,14800,94.0,765,2023-04-21T21:35,0,9900
868,1062062,59,16890,19900,96.0,1460,2023-04-21T21:35,0,16890
869,1346070,60,9900,12000,97.0,1906,2023-04-21T21:35,-1485,8415
870,2467197,61,30000,0,95.0,149,2023-04-21T21:35,0,30000
871,1348077,62,10900,16500,97.0,1887,2023-04-21T21:35,0,10900
872,1475055,63,16900,22000,96.0,1187,2023-04-21T21:35,-2535,14365
873,1477846,64,15400,22000,96.0,2695,2023-04-21T21:35,0,15400
874,746155,65,17900,0,95.0,1274,2023-04-21T21:35,0,17900
875,2973952,66,28800,48000,95.0,18,2023-04-21T21:35,-5184,23616
876,746157,67,16090,17900,95.0,990,2023-04-21T21:35,0,16090
877,3195569,68,19000,0,100.0,3,2023-04-21T21:35,0,19000
878,1547562,69,15400,22000,95.0,1379,2023-04-21T21:35,0,15400
879,2011851,70,21490,23900,98.0,683,2023-04-21T21:35,0,21490
880,2738095,71,17890,19900,95.0,112,2023-04-21T21:35,0,17890
881,1821485,72,30000,0,96.0,1298,2023-04-21T21:35,0,30000
882,2821591,73,15590,20900,96.0,118,2023-04-21T21:35,0,15590
883,2347097,74,14900,24000,98.0,1623,2023-04-21T21:35,-2235,12665
884,2346958,75,18900,24000,97.0,532,2023-04-21T21:35,-2835,16065
885,1045103,76,9490,15900,95.0,2423,2023-04-21T21:35,0,9490
886,2821597,77,22900,0,98.0,111,2023-04-21T21:35,0,22900
887,1286366,78,11900,24000,97.0,9855,2023-04-21T21:35,0,11900
888,1092995,79,19390,22900,96.0,1598,2023-04-21T21:35,0,19390
889,2982659,80,19900,0,98.0,13,2023-04-21T21:35,0,19900
890,2225906,81,12590,14900,96.0,355,2023-04-21T21:35,0,12590
891,1392773,82,16890,19900,95.0,1479,2023-04-21T21:35,0,16890
892,1260388,83,20900,0,95.0,692,2023-04-21T21:35,0,20900
893,2477852,84,16890,19900,98.0,692,2023-04-21T21:35,0,16890
894,3164916,85,80800,115000,0.0,0,2023-04-21T21:35,0,80800
895,3164917,86,80800,115000,0.0,0,2023-04-21T21:35,0,80800
896,2433154,87,30000,0,95.0,88,2023-04-21T21:35,0,30000
897,1387502,88,12690,15900,95.0,519,2023-04-21T21:35,0,12690
898,2821592,89,15590,20900,98.0,151,2023-04-21T21:35,0,15590
899,2821590,90,19690,21900,98.0,55,2023-04-21T21:35,0,19690
