,item_id,rank,price,del_price,rating,rating_count,time,coupon,real_price
0,2272830,1,35910,39900,97.0,19755,2023-04-13T19:32,-5387,30523
1,3149803,2,89100,99000,91.0,7,2023-04-13T19:32,0,89100
2,1848166,3,44100,49000,97.0,41227,2023-04-13T19:32,0,44100
3,2313388,4,68000,85000,96.0,2173,2023-04-13T19:32,-13600,54400
4,1763157,5,44200,52000,95.0,2696,2023-04-13T19:32,0,44200
5,2086653,6,16900,0,97.0,39990,2023-04-13T19:32,0,16900
6,345889,7,29900,47900,95.0,9990,2023-04-13T19:32,0,29900
7,2442409,8,39000,78000,96.0,9040,2023-04-13T19:32,-5850,33150
8,2149254,9,37800,0,97.0,33778,2023-04-13T19:32,-5670,32130
9,3064420,10,55200,69000,97.0,66,2023-04-13T19:32,0,55200
10,2034137,11,31800,0,97.0,17563,2023-04-13T19:32,-4770,27030
11,2479911,12,49400,76000,97.0,4375,2023-04-13T19:32,0,49400
12,2454238,13,97200,108000,97.0,1595,2023-04-13T19:32,-14580,82620
13,3043051,14,68000,85000,96.0,95,2023-04-13T19:32,-13600,54400
14,2646350,15,59800,94000,95.0,4463,2023-04-13T19:32,-8970,50830
15,1882578,16,35910,39900,97.0,10094,2023-04-13T19:32,0,35910
16,2285512,17,44200,52000,96.0,1743,2023-04-13T19:32,0,44200
17,1706633,18,199000,0,97.0,2421,2023-04-13T19:32,0,199000
18,3105468,19,67150,79000,98.0,77,2023-04-13T19:32,0,67150
19,3143791,20,45900,68000,98.0,308,2023-04-13T19:32,-6885,39015
20,1939099,21,34300,49000,97.0,11889,2023-04-13T19:32,0,34300
21,2314616,22,39000,43000,97.0,8380,2023-04-13T19:32,-5850,33150
22,2462040,23,38000,45000,95.0,3891,2023-04-13T19:32,-7600,30400
23,1817394,24,59900,150000,93.0,7279,2023-04-13T19:32,0,59900
24,1921901,25,36900,70500,96.0,7657,2023-04-13T19:32,0,36900
25,1763123,26,84550,89000,96.0,1675,2023-04-13T19:32,0,84550
26,1821755,27,43400,54000,96.0,2042,2023-04-13T19:32,-8680,34720
27,3175768,28,49500,66000,95.0,29,2023-04-13T19:32,-4950,44550
28,3176119,29,69000,0,96.0,17,2023-04-13T19:32,-10350,58650
29,1554514,30,47200,59000,96.0,6375,2023-04-13T19:32,-9440,37760
30,2364807,31,219000,0,96.0,720,2023-04-13T19:32,0,219000
31,2396645,32,39900,59000,96.0,23641,2023-04-13T19:32,0,39900
32,2704375,33,55300,79000,98.0,10,2023-04-13T19:32,-11060,44240
33,1842348,34,79200,99000,96.0,3031,2023-04-13T19:32,-15840,63360
34,2996536,35,39900,59000,96.0,613,2023-04-13T19:32,-3990,35910
35,2375962,36,59000,62000,98.0,5589,2023-04-13T19:32,-5900,53100
36,1498105,37,189000,0,97.0,2019,2023-04-13T19:32,0,189000
37,3129723,38,27300,39000,98.0,33,2023-04-13T19:32,-4095,23205
38,2326935,39,55300,79000,96.0,13018,2023-04-13T19:32,-11060,44240
39,2978699,40,234000,495000,87.0,14,2023-04-13T19:32,-20000,214000
40,3187851,41,49900,110000,97.0,213,2023-04-13T19:32,0,49900
41,1884943,42,29900,39000,96.0,18959,2023-04-13T19:32,-4485,25415
42,1498103,43,199000,0,96.0,880,2023-04-13T19:32,0,199000
43,3202529,44,29900,94000,100.0,5,2023-04-13T19:32,0,29900
44,2038497,45,36000,45000,95.0,16409,2023-04-13T19:32,-3600,32400
45,1582356,46,49200,82000,96.0,16280,2023-04-13T19:32,0,49200
46,3034895,47,101150,119000,98.0,395,2023-04-13T19:32,0,101150
47,2065708,48,59000,62000,98.0,6748,2023-04-13T19:32,-5900,53100
48,2913656,49,47900,64000,96.0,366,2023-04-13T19:32,-4790,43110
49,1005680,50,17500,35000,95.0,9260,2023-04-13T19:32,0,17500
50,2122566,51,33800,0,97.0,16479,2023-04-13T19:32,-5070,28730
51,1608272,52,39800,65590,96.0,4150,2023-04-13T19:32,0,39800
52,2453556,53,39900,42000,97.0,6311,2023-04-13T19:32,0,39900
53,1944612,54,35800,59700,97.0,2942,2023-04-13T19:32,0,35800
54,2377269,55,45000,0,97.0,4061,2023-04-13T19:32,0,45000
55,3206068,56,52900,74000,98.0,379,2023-04-13T19:32,0,52900
56,2995691,57,2200000,3220000,0.0,0,2023-04-13T19:32,-20000,2180000
57,2392759,58,39900,49600,95.0,4094,2023-04-13T19:32,-5985,33915
58,1779737,59,27200,32000,96.0,7297,2023-04-13T19:32,-5440,21760
59,3220819,60,45000,0,0.0,0,2023-04-13T19:32,0,45000
60,2877493,61,59800,92000,95.0,1495,2023-04-13T19:32,0,59800
61,3082587,62,57600,64000,0.0,0,2023-04-13T19:32,-11520,46080
62,854337,63,33900,0,95.0,17433,2023-04-13T19:32,0,33900
63,1336398,64,40200,67000,96.0,19119,2023-04-13T19:32,0,40200
64,2970543,65,62100,69000,97.0,308,2023-04-13T19:32,0,62100
65,996177,66,15900,0,95.0,77753,2023-04-13T19:32,0,15900
66,2368712,67,38700,43000,97.0,5619,2023-04-13T19:32,0,38700
67,3042516,68,42000,65000,97.0,116,2023-04-13T19:32,-4200,37800
68,2445758,69,59700,0,97.0,1283,2023-04-13T19:32,0,59700
69,1503352,70,39900,42000,97.0,8478,2023-04-13T19:32,0,39900
70,3176118,71,69000,0,98.0,21,2023-04-13T19:32,-10350,58650
71,994588,72,39900,53000,93.0,6097,2023-04-13T19:32,-3990,35910
72,1899755,73,29900,39000,96.0,5006,2023-04-13T19:32,-4485,25415
73,3067178,74,29750,35000,95.0,134,2023-04-13T19:32,-5950,23800
74,2015684,75,39000,0,95.0,6457,2023-04-13T19:32,0,39000
75,2305840,76,59700,0,97.0,4011,2023-04-13T19:32,0,59700
76,2409894,77,39000,78000,97.0,5202,2023-04-13T19:32,-5850,33150
77,3051787,78,57600,64000,0.0,0,2023-04-13T19:32,-5760,51840
78,3017711,79,63200,79000,96.0,89,2023-04-13T19:32,-9480,53720
79,1382658,80,16900,0,94.0,47517,2023-04-13T19:32,0,16900
80,2401885,81,23900,59000,96.0,3503,2023-04-13T19:32,0,23900
81,3043045,82,68000,85000,98.0,54,2023-04-13T19:32,-13600,54400
82,2660716,83,50400,72000,96.0,2412,2023-04-13T19:32,-10080,40320
83,1943792,84,34400,43000,96.0,5448,2023-04-13T19:32,0,34400
84,2171559,85,39900,54000,96.0,4237,2023-04-13T19:32,-3990,35910
85,2109937,86,49600,68000,96.0,1081,2023-04-13T19:32,0,49600
86,2376229,87,36000,0,97.0,3867,2023-04-13T19:32,0,36000
87,1005683,88,17500,35000,95.0,10912,2023-04-13T19:32,0,17500
88,2575342,89,39900,59000,96.0,872,2023-04-13T19:32,0,39900
89,3129246,90,72000,0,96.0,45,2023-04-13T19:32,0,72000
90,1558197,1,73690,81900,97.0,32576,2023-04-13T19:32,0,73690
91,1778404,2,42000,45000,96.0,67626,2023-04-13T19:32,-6300,35700
92,2723218,3,69900,109000,97.0,2523,2023-04-13T19:32,-10485,59415
93,1283757,4,75490,83900,96.0,26755,2023-04-13T19:32,0,75490
94,2343198,5,119000,129000,97.0,5099,2023-04-13T19:32,0,119000
95,1790383,6,59000,86000,95.0,5653,2023-04-13T19:32,-8850,50150
96,3012082,7,59900,79000,97.0,1070,2023-04-13T19:32,0,59900
97,2184463,8,389000,0,98.0,404,2023-04-13T19:32,0,389000
98,1856181,9,35910,39900,97.0,7720,2023-04-13T19:32,-5387,30523
99,2810079,10,2394000,4980000,100.0,3,2023-04-13T19:32,-20000,2374000
100,1576700,11,89000,129000,97.0,16937,2023-04-13T19:32,-13350,75650
101,1776552,12,59000,69000,94.0,6173,2023-04-13T19:32,-8850,50150
102,2020732,13,70900,89000,95.0,864,2023-04-13T19:32,0,70900
103,2061715,14,83900,105000,97.0,2761,2023-04-13T19:32,0,83900
104,2064545,15,59800,94000,97.0,11243,2023-04-13T19:32,-2990,56810
105,2471405,16,89000,138000,97.0,2123,2023-04-13T19:32,-8900,80100
106,2329532,17,119200,149000,97.0,3997,2023-04-13T19:32,-11920,107280
107,1530516,18,69900,79000,96.0,2384,2023-04-13T19:32,0,69900
108,3058265,19,162000,169000,96.0,197,2023-04-13T19:32,0,162000
109,737793,20,173400,218000,95.0,1155,2023-04-13T19:32,-34680,138720
110,1108007,21,79900,0,95.0,47934,2023-04-13T19:32,0,79900
111,1530517,22,69900,79000,96.0,2139,2023-04-13T19:32,0,69900
112,3055246,23,159000,0,97.0,69,2023-04-13T19:32,0,159000
113,3033224,24,59900,74000,97.0,717,2023-04-13T19:32,0,59900
114,1778408,25,42000,45000,95.0,11777,2023-04-13T19:32,-6300,35700
115,2732486,26,109000,179000,98.0,735,2023-04-13T19:32,-10900,98100
116,1760177,27,139200,174000,97.0,333,2023-04-13T19:32,-20880,118320
117,1291017,28,67900,96000,95.0,13063,2023-04-13T19:32,0,67900
118,1776365,29,53400,89000,96.0,4628,2023-04-13T19:32,0,53400
119,3124653,30,201600,288000,100.0,12,2023-04-13T19:32,-40320,161280
120,1195307,31,92700,103000,96.0,12695,2023-04-13T19:32,-13905,78795
121,3025211,32,44900,69000,97.0,228,2023-04-13T19:32,-2245,42655
122,2285025,33,89900,137900,96.0,111,2023-04-13T19:32,0,89900
123,3010527,34,237150,279000,97.0,241,2023-04-13T19:32,0,237150
124,1139192,35,71100,94900,97.0,14441,2023-04-13T19:32,-10665,60435
125,1576682,36,245000,339000,97.0,8621,2023-04-13T19:32,-36750,208250
126,1618312,37,83900,0,97.0,7199,2023-04-13T19:32,-8390,75510
127,3047846,38,197100,219000,100.0,23,2023-04-13T19:32,-39420,157680
128,2723216,39,69900,109000,97.0,1149,2023-04-13T19:32,-10485,59415
129,2375909,40,80890,89900,98.0,1582,2023-04-13T19:32,0,80890
130,1558683,41,81900,0,97.0,6262,2023-04-13T19:32,0,81900
131,2718413,42,126650,149000,97.0,1451,2023-04-13T19:32,0,126650
132,2110493,43,389000,0,96.0,644,2023-04-13T19:32,0,389000
133,3096451,44,124200,138000,98.0,51,2023-04-13T19:32,-18630,105570
134,3029811,45,63200,79000,97.0,271,2023-04-13T19:32,0,63200
135,2752332,46,94700,105300,95.0,2637,2023-04-13T19:32,0,94700
136,3125671,47,148000,0,98.0,21,2023-04-13T19:32,0,148000
137,1737051,48,62300,89000,96.0,5130,2023-04-13T19:32,0,62300
138,2159724,49,29900,32000,95.0,2345,2023-04-13T19:32,0,29900
139,2407203,50,148500,165000,97.0,324,2023-04-13T19:32,0,148500
140,3116512,51,2436000,0,0.0,0,2023-04-13T19:32,-20000,2416000
141,3039655,52,69700,83000,96.0,596,2023-04-13T19:32,-10455,59245
142,3061233,53,39500,79000,97.0,76,2023-04-13T19:32,0,39500
143,2699160,54,179000,0,96.0,95,2023-04-13T19:32,0,179000
144,1337094,55,69900,0,95.0,5448,2023-04-13T19:32,0,69900
145,3043085,56,55080,91800,93.0,3,2023-04-13T19:32,-8262,46818
146,1833230,57,108800,136000,97.0,5463,2023-04-13T19:32,-16320,92480
147,3079071,58,64900,87000,94.0,186,2023-04-13T19:32,-6490,58410
148,2723772,59,109900,169000,94.0,1014,2023-04-13T19:32,0,109900
149,2670700,60,268200,298000,98.0,1206,2023-04-13T19:32,-40230,227970
150,1337096,61,69900,0,97.0,2994,2023-04-13T19:32,0,69900
151,2039434,62,174400,218000,98.0,601,2023-04-13T19:32,-34880,139520
152,2788216,63,146000,159000,98.0,139,2023-04-13T19:32,0,146000
153,2343199,64,119000,129000,98.0,1852,2023-04-13T19:32,0,119000
154,727847,65,68500,159000,93.0,10923,2023-04-13T19:32,0,68500
155,2288426,66,69000,109000,94.0,839,2023-04-13T19:32,-10350,58650
156,2143672,67,96900,149000,96.0,117,2023-04-13T19:32,-19380,77520
157,3209862,68,89000,111500,100.0,1,2023-04-13T19:32,-4450,84550
158,1776550,69,59000,69000,94.0,4169,2023-04-13T19:32,-8850,50150
159,3061903,70,179000,0,98.0,12,2023-04-13T19:32,0,179000
160,2572705,71,168300,198000,96.0,65,2023-04-13T19:32,-25245,143055
161,2712632,72,107000,0,97.0,1369,2023-04-13T19:32,0,107000
162,3037473,73,69900,85900,96.0,252,2023-04-13T19:32,-10485,59415
163,3046664,74,89900,99000,97.0,145,2023-04-13T19:32,-13485,76415
164,3051261,75,62300,89000,97.0,95,2023-04-13T19:32,-12460,49840
165,1593755,76,89360,111700,97.0,14488,2023-04-13T19:32,-13404,75956
166,2715055,77,159000,189000,97.0,2030,2023-04-13T19:32,0,159000
167,2322837,78,139200,174000,97.0,1608,2023-04-13T19:32,-20880,118320
168,2668986,79,35910,39900,96.0,3586,2023-04-13T19:32,-5387,30523
169,2322836,80,139200,174000,97.0,1037,2023-04-13T19:32,-20880,118320
170,3048143,81,163800,182000,96.0,457,2023-04-13T19:32,0,163800
171,1620285,82,299000,0,97.0,172,2023-04-13T19:32,0,299000
172,1280576,83,37200,62000,96.0,25278,2023-04-13T19:32,-5580,31620
173,3209864,84,89000,111500,100.0,2,2023-04-13T19:32,-4450,84550
174,965917,85,71890,79900,95.0,13094,2023-04-13T19:32,0,71890
175,2995694,86,1679000,2610000,100.0,1,2023-04-13T19:32,-20000,1659000
176,3220798,87,148000,0,0.0,0,2023-04-13T19:32,0,148000
177,3046112,88,188100,209000,100.0,7,2023-04-13T19:32,-37620,150480
178,2315115,89,127200,159000,97.0,808,2023-04-13T19:32,-19080,108120
179,3039484,90,85500,114000,97.0,359,2023-04-13T19:32,-12825,72675
180,2112059,1,36400,0,97.0,43376,2023-04-13T19:32,-5460,30940
181,1149329,2,39900,0,96.0,86385,2023-04-13T19:32,0,39900
182,1568057,3,49600,62000,96.0,22487,2023-04-13T19:32,0,49600
183,1551840,4,35100,39000,97.0,84119,2023-04-13T19:32,0,35100
184,750908,5,35900,54000,96.0,84361,2023-04-13T19:32,0,35900
185,1168906,6,41900,0,97.0,71348,2023-04-13T19:32,0,41900
186,2060719,7,55200,69000,96.0,5302,2023-04-13T19:32,0,55200
187,2976721,8,168000,0,98.0,399,2023-04-13T19:32,0,168000
188,2092852,9,42000,52800,96.0,11308,2023-04-13T19:32,0,42000
189,3047822,10,116100,129000,99.0,93,2023-04-13T19:32,-23220,92880
190,1803221,11,81800,109000,97.0,1560,2023-04-13T19:32,-16360,65440
191,1149328,12,39900,0,96.0,94672,2023-04-13T19:32,0,39900
192,3101581,13,156000,0,96.0,29,2023-04-13T19:32,0,156000
193,1370101,14,39000,89000,96.0,23166,2023-04-13T19:32,-1950,37050
194,1924274,15,49900,66000,95.0,22618,2023-04-13T19:32,0,49900
195,2112061,16,36400,0,97.0,14870,2023-04-13T19:32,-5460,30940
196,2124896,17,98000,0,98.0,730,2023-04-13T19:32,-14700,83300
197,858911,18,39000,49000,95.0,67124,2023-04-13T19:32,-5850,33150
198,3085508,19,108000,0,100.0,27,2023-04-13T19:32,-16200,91800
199,2060717,20,55200,69000,95.0,3923,2023-04-13T19:32,0,55200
200,2060720,21,55200,69000,95.0,2633,2023-04-13T19:32,0,55200
201,2789091,22,79200,99000,96.0,856,2023-04-13T19:32,-11880,67320
202,2706287,23,29000,54000,95.0,3910,2023-04-13T19:32,0,29000
203,1573215,24,133200,148000,98.0,9371,2023-04-13T19:32,-19980,113220
204,2039334,25,79200,99000,97.0,887,2023-04-13T19:32,-15840,63360
205,1551839,26,39000,0,97.0,23742,2023-04-13T19:32,0,39000
206,1368664,27,81800,109000,97.0,5162,2023-04-13T19:32,-16360,65440
207,1323090,28,64400,92000,96.0,6022,2023-04-13T19:32,-12880,51520
208,3037629,29,134100,149000,97.0,108,2023-04-13T19:32,-26820,107280
209,2028327,30,49900,0,97.0,9244,2023-04-13T19:32,0,49900
210,2850706,31,168000,0,98.0,484,2023-04-13T19:32,0,168000
211,1555407,32,74100,78000,97.0,11670,2023-04-13T19:32,-11115,62985
212,2150457,33,119250,159000,97.0,3927,2023-04-13T19:32,-17888,101362
213,2184087,34,49000,89000,96.0,4144,2023-04-13T19:32,-2450,46550
214,3062147,35,99000,149000,99.0,43,2023-04-13T19:32,0,99000
215,3098372,36,82000,139000,97.0,958,2023-04-13T19:32,0,82000
216,1552753,37,74100,78000,97.0,28255,2023-04-13T19:32,-11115,62985
217,2789111,38,79200,99000,97.0,912,2023-04-13T19:32,-11880,67320
218,1926048,39,32000,0,97.0,14830,2023-04-13T19:32,0,32000
219,2224196,40,81800,109000,96.0,457,2023-04-13T19:32,-16360,65440
220,3047828,41,125100,139000,99.0,99,2023-04-13T19:32,-18765,106335
221,2032901,42,39900,0,97.0,6935,2023-04-13T19:32,0,39900
222,2028326,43,49900,0,97.0,6292,2023-04-13T19:32,0,49900
223,2060759,44,59800,74800,97.0,7305,2023-04-13T19:32,0,59800
224,3043508,45,71200,89000,97.0,162,2023-04-13T19:32,0,71200
225,1736085,46,39900,59800,96.0,37005,2023-04-13T19:32,0,39900
226,2351467,47,39800,54000,96.0,6398,2023-04-13T19:32,-5970,33830
227,1568032,48,49600,62000,96.0,6217,2023-04-13T19:32,0,49600
228,1222184,49,41900,0,97.0,48530,2023-04-13T19:32,0,41900
229,890521,50,39800,63000,94.0,11225,2023-04-13T19:32,0,39800
230,2039333,51,79200,99000,98.0,352,2023-04-13T19:32,-15840,63360
231,2723714,52,52000,58000,96.0,1635,2023-04-13T19:32,0,52000
232,2358429,53,159000,0,98.0,2661,2023-04-13T19:32,0,159000
233,2562527,54,29400,42000,97.0,4104,2023-04-13T19:32,-4410,24990
234,2749153,55,66600,74000,97.0,603,2023-04-13T19:32,0,66600
235,1627892,56,43900,0,97.0,11144,2023-04-13T19:32,0,43900
236,1477272,57,44200,68000,96.0,17943,2023-04-13T19:32,-2210,41990
237,3101578,58,156000,0,98.0,41,2023-04-13T19:32,0,156000
238,3141395,59,49900,73900,97.0,205,2023-04-13T19:32,-4990,44910
239,1764739,60,64400,92000,97.0,2765,2023-04-13T19:32,-12880,51520
240,1595607,61,57900,89000,97.0,5764,2023-04-13T19:32,-11580,46320
241,3082544,62,98100,109000,0.0,0,2023-04-13T19:32,-19620,78480
242,2060743,63,33000,55000,95.0,3623,2023-04-13T19:32,0,33000
243,3049798,64,96800,121000,97.0,86,2023-04-13T19:32,-19360,77440
244,1168922,65,43900,0,96.0,18292,2023-04-13T19:32,0,43900
245,2503133,66,42000,52800,96.0,3135,2023-04-13T19:32,0,42000
246,1666442,67,49900,0,97.0,10986,2023-04-13T19:32,0,49900
247,1324127,68,28790,33900,96.0,13822,2023-04-13T19:32,0,28790
248,1436218,69,25900,68000,95.0,19293,2023-04-13T19:32,0,25900
249,1638610,70,97850,103000,98.0,4046,2023-04-13T19:32,-14678,83172
250,3039451,71,41300,70100,96.0,591,2023-04-13T19:32,0,41300
251,2039335,72,79200,99000,97.0,394,2023-04-13T19:32,-15840,63360
252,2028329,73,49900,0,96.0,6599,2023-04-13T19:32,0,49900
253,1885631,74,39000,49000,96.0,23802,2023-04-13T19:32,-5850,33150
254,1212776,75,28690,31900,96.0,23497,2023-04-13T19:32,0,28690
255,2837340,76,53000,59000,96.0,868,2023-04-13T19:32,-10600,42400
256,2877984,77,59000,0,97.0,446,2023-04-13T19:32,0,59000
257,890338,78,39000,49000,95.0,47813,2023-04-13T19:32,-5850,33150
258,1246215,79,49000,65000,96.0,6346,2023-04-13T19:32,-9800,39200
259,2711142,80,39800,54000,96.0,1043,2023-04-13T19:32,-5970,33830
260,1224095,81,35890,39900,97.0,24531,2023-04-13T19:32,0,35890
261,2131950,82,39000,49000,96.0,3998,2023-04-13T19:32,-5850,33150
262,2107115,83,121500,135000,98.0,11733,2023-04-13T19:32,-18225,103275
263,3070909,84,139000,0,100.0,5,2023-04-13T19:32,0,139000
264,3037465,85,45500,56900,95.0,294,2023-04-13T19:32,-6825,38675
265,1440874,86,39900,0,95.0,15172,2023-04-13T19:32,0,39900
266,2578996,87,39900,59000,95.0,4725,2023-04-13T19:32,-5985,33915
267,1100326,88,57900,89000,95.0,37029,2023-04-13T19:32,-11580,46320
268,3031102,89,63200,79000,98.0,13,2023-04-13T19:32,0,63200
269,3082547,90,116100,129000,0.0,0,2023-04-13T19:32,-23220,92880
270,2702033,1,127200,159000,97.0,420,2023-04-13T19:32,0,127200
271,3161264,2,98100,109000,100.0,11,2023-04-13T19:32,-19620,78480
272,1789507,3,79000,0,98.0,26014,2023-04-13T19:32,0,79000
273,1842449,4,84000,99000,97.0,5424,2023-04-13T19:32,-16800,67200
274,2789785,5,116920,148000,97.0,633,2023-04-13T19:32,-11692,105228
275,3192309,6,93220,118000,98.0,68,2023-04-13T19:32,-9322,83898
276,913402,7,83300,98000,95.0,8064,2023-04-13T19:32,-16660,66640
277,3161263,8,98100,109000,100.0,6,2023-04-13T19:32,-19620,78480
278,1969507,9,88000,0,98.0,5477,2023-04-13T19:32,0,88000
279,1034480,10,135000,150000,97.0,18162,2023-04-13T19:32,0,135000
280,2789787,11,116920,148000,96.0,346,2023-04-13T19:32,-11692,105228
281,2235274,12,145000,0,98.0,722,2023-04-13T19:32,0,145000
282,3216143,13,39900,49600,0.0,0,2023-04-13T19:32,-5985,33915
283,2458214,14,1879000,3395000,100.0,13,2023-04-13T19:32,-20000,1859000
284,2979849,15,1852000,2370000,100.0,4,2023-04-13T19:32,-20000,1832000
285,3101111,16,152150,179000,96.0,46,2023-04-13T19:32,0,152150
286,2789786,17,124820,158000,98.0,242,2023-04-13T19:32,-12482,112338
287,1835080,18,98000,0,97.0,2853,2023-04-13T19:32,0,98000
288,2789784,19,124820,158000,97.0,188,2023-04-13T19:32,-12482,112338
289,2555081,20,1557000,2600000,0.0,0,2023-04-13T19:32,-20000,1537000
290,1910358,21,89100,99000,98.0,2503,2023-04-13T19:32,-13365,75735
291,3000157,22,142200,158000,96.0,149,2023-04-13T19:32,-7110,135090
292,3038000,23,74700,83000,97.0,425,2023-04-13T19:32,-11205,63495
293,2980956,24,2660000,3500000,100.0,1,2023-04-13T19:32,-20000,2640000
294,2577899,25,138000,0,98.0,341,2023-04-13T19:32,0,138000
295,1264107,26,65000,90000,97.0,6417,2023-04-13T19:32,-9750,55250
296,2320927,27,39000,51000,97.0,2235,2023-04-13T19:32,0,39000
297,2066837,28,79000,119000,97.0,6544,2023-04-13T19:32,-11850,67150
298,2621696,29,234000,0,97.0,172,2023-04-13T19:32,0,234000
299,3216131,30,39900,49600,0.0,0,2023-04-13T19:32,-5985,33915
300,2401550,31,2201000,3280000,96.0,6,2023-04-13T19:32,-20000,2181000
301,2344540,32,96000,0,98.0,9300,2023-04-13T19:32,0,96000
302,2690212,33,1075000,1950000,95.0,9,2023-04-13T19:32,-20000,1055000
303,3034751,34,64800,72000,97.0,528,2023-04-13T19:32,0,64800
304,2418244,35,715000,1090000,100.0,1,2023-04-13T19:32,-20000,695000
305,2558648,36,119000,0,98.0,1299,2023-04-13T19:32,0,119000
306,3050558,37,2089000,3290000,100.0,1,2023-04-13T19:32,-20000,2069000
307,3029905,38,395000,0,100.0,37,2023-04-13T19:32,0,395000
308,1323612,39,238000,0,97.0,3844,2023-04-13T19:32,0,238000
309,2664933,40,90000,0,96.0,357,2023-04-13T19:32,-4500,85500
310,1581689,41,75600,89000,97.0,4029,2023-04-13T19:32,0,75600
311,1736022,42,150400,188000,95.0,446,2023-04-13T19:32,0,150400
312,2271789,43,71100,79000,97.0,2560,2023-04-13T19:32,0,71100
313,342189,44,39500,52000,95.0,15796,2023-04-13T19:32,0,39500
314,2770508,45,138000,0,97.0,348,2023-04-13T19:32,0,138000
315,1744101,46,103500,109000,98.0,2974,2023-04-13T19:32,0,103500
316,1528287,47,46500,49000,96.0,4655,2023-04-13T19:32,0,46500
317,2902045,48,298000,485000,98.0,36,2023-04-13T19:32,-20000,278000
318,2688604,49,159000,0,97.0,890,2023-04-13T19:32,0,159000
319,1969488,50,88000,0,98.0,1777,2023-04-13T19:32,0,88000
320,2273014,51,1791000,2390000,100.0,1,2023-04-13T19:32,-20000,1771000
321,2408317,52,145800,162000,96.0,396,2023-04-13T19:32,0,145800
322,2344538,53,119000,0,98.0,6446,2023-04-13T19:32,0,119000
323,1263004,54,159000,0,97.0,5269,2023-04-13T19:32,0,159000
324,2930265,55,91000,0,97.0,601,2023-04-13T19:32,0,91000
325,3047568,56,109650,129000,96.0,78,2023-04-13T19:32,-10965,98685
326,3024801,57,138000,0,100.0,19,2023-04-13T19:32,0,138000
327,1564343,58,92800,119000,98.0,8123,2023-04-13T19:32,0,92800
328,1247560,59,79000,0,96.0,4287,2023-04-13T19:32,0,79000
329,2343665,60,89000,0,97.0,4675,2023-04-13T19:32,0,89000
330,1964770,61,59400,66000,97.0,2525,2023-04-13T19:32,-8910,50490
331,3034743,62,75600,84000,96.0,226,2023-04-13T19:32,0,75600
332,2954961,63,95000,0,96.0,385,2023-04-13T19:32,0,95000
333,2856863,64,1416000,2167000,0.0,0,2023-04-13T19:32,-20000,1396000
334,2514819,65,59000,66000,97.0,864,2023-04-13T19:32,0,59000
335,3149665,66,98000,0,100.0,8,2023-04-13T19:32,-14700,83300
336,3011494,67,69900,79000,96.0,267,2023-04-13T19:32,-6990,62910
337,2422175,68,145800,162000,99.0,216,2023-04-13T19:32,-21870,123930
338,3142123,69,290000,0,100.0,23,2023-04-13T19:32,-14500,275500
339,3070516,70,138000,0,96.0,27,2023-04-13T19:32,0,138000
340,3140729,71,114600,128000,0.0,0,2023-04-13T19:32,-11460,103140
341,3072371,72,125100,139000,96.0,122,2023-04-13T19:32,-6255,118845
342,3034745,73,75600,84000,97.0,190,2023-04-13T19:32,0,75600
343,2305287,74,69800,0,98.0,1054,2023-04-13T19:32,0,69800
344,2633431,75,1244800,1556000,0.0,0,2023-04-13T19:32,-20000,1224800
345,2245910,76,46000,69000,95.0,760,2023-04-13T19:32,0,46000
346,940853,77,92700,109000,96.0,7486,2023-04-13T19:32,-18540,74160
347,2630526,78,100000,0,96.0,658,2023-04-13T19:32,-5000,95000
348,2474566,79,587000,750000,90.0,2,2023-04-13T19:32,0,587000
349,3045584,80,130500,145000,97.0,3792,2023-04-13T19:32,0,130500
350,1534526,81,52200,55000,97.0,2479,2023-04-13T19:32,0,52200
351,693318,82,79000,110000,96.0,13203,2023-04-13T19:32,-11850,67150
352,2615405,83,219000,0,96.0,236,2023-04-13T19:32,0,219000
353,938746,84,80100,89000,95.0,12555,2023-04-13T19:32,0,80100
354,2888946,85,79000,0,98.0,178,2023-04-13T19:32,-7900,71100
355,1745100,86,103500,109000,97.0,1019,2023-04-13T19:32,0,103500
356,1758217,87,43900,56000,97.0,13184,2023-04-13T19:32,-2195,41705
357,2567009,88,1500000,1713000,80.0,1,2023-04-13T19:32,-20000,1480000
358,2371563,89,1131000,1436000,100.0,4,2023-04-13T19:32,-20000,1111000
359,3142253,90,39900,49600,96.0,47,2023-04-13T19:32,-5985,33915
360,1955217,1,69000,109000,96.0,5219,2023-04-13T19:32,-13800,55200
361,1762407,2,260000,0,97.0,3363,2023-04-13T19:32,0,260000
362,969541,3,69000,0,97.0,29848,2023-04-13T19:32,0,69000
363,3026310,4,99000,0,99.0,725,2023-04-13T19:32,0,99000
364,1762406,5,260000,0,98.0,3418,2023-04-13T19:32,0,260000
365,490136,6,56900,95000,98.0,2452,2023-04-13T19:32,0,56900
366,2545799,7,149000,0,98.0,2201,2023-04-13T19:32,0,149000
367,2293400,8,129000,0,96.0,1032,2023-04-13T19:32,0,129000
368,2855992,9,159000,0,97.0,579,2023-04-13T19:32,0,159000
369,810034,10,85500,95000,97.0,45328,2023-04-13T19:32,0,85500
370,2638067,11,99000,139000,97.0,3180,2023-04-13T19:32,0,99000
371,1622068,12,119000,0,97.0,6722,2023-04-13T19:32,0,119000
372,1622069,13,119000,0,98.0,5879,2023-04-13T19:32,0,119000
373,2731878,14,44900,79000,97.0,1768,2023-04-13T19:32,0,44900
374,3172978,15,185000,0,100.0,1,2023-04-13T19:32,0,185000
375,311052,16,53100,59000,97.0,41301,2023-04-13T19:32,0,53100
376,2670201,17,39900,109000,97.0,860,2023-04-13T19:32,0,39900
377,3172975,18,260000,0,100.0,8,2023-04-13T19:32,0,260000
378,490135,19,59900,95000,97.0,3349,2023-04-13T19:32,0,59900
379,810033,20,89100,99000,97.0,34303,2023-04-13T19:32,0,89100
380,695334,21,63900,99000,96.0,9478,2023-04-13T19:32,0,63900
381,1354129,22,69000,99000,95.0,8727,2023-04-13T19:32,-13800,55200
382,2801304,23,414000,700000,98.0,194,2023-04-13T19:32,-20000,394000
383,1900410,24,129000,0,97.0,4925,2023-04-13T19:32,0,129000
384,2777033,25,477000,815000,93.0,19,2023-04-13T19:32,-20000,457000
385,2375550,26,69000,99000,94.0,2601,2023-04-13T19:32,-13800,55200
386,186610,27,75900,85000,97.0,16639,2023-04-13T19:32,0,75900
387,2233180,28,75900,109000,97.0,14284,2023-04-13T19:32,0,75900
388,1296778,29,99000,0,98.0,2154,2023-04-13T19:32,0,99000
389,1478592,30,59900,95000,97.0,3065,2023-04-13T19:32,0,59900
390,2785168,31,179000,0,98.0,37,2023-04-13T19:32,0,179000
391,3200836,32,179000,0,98.0,30,2023-04-13T19:32,0,179000
392,2737457,33,230000,0,98.0,481,2023-04-13T19:32,0,230000
393,3030422,34,139000,0,96.0,880,2023-04-13T19:32,0,139000
394,3091287,35,119000,0,97.0,350,2023-04-13T19:32,0,119000
395,2320478,36,129000,0,97.0,539,2023-04-13T19:32,0,129000
396,2530875,37,39900,109000,96.0,1582,2023-04-13T19:32,0,39900
397,3033248,38,109000,0,97.0,675,2023-04-13T19:32,0,109000
398,816033,39,57900,89000,96.0,13359,2023-04-13T19:32,0,57900
399,2622254,40,109000,0,98.0,939,2023-04-13T19:32,0,109000
400,2670200,41,39900,109000,97.0,1120,2023-04-13T19:32,0,39900
401,3079037,42,195000,0,97.0,277,2023-04-13T19:32,0,195000
402,1231944,43,119000,0,97.0,1355,2023-04-13T19:32,0,119000
403,2161992,44,55900,95000,97.0,3396,2023-04-13T19:32,0,55900
404,577636,45,99900,139000,95.0,31258,2023-04-13T19:32,0,99900
405,2784035,46,334350,743000,84.0,5,2023-04-13T19:32,-20000,314350
406,3096431,47,139000,0,99.0,61,2023-04-13T19:32,0,139000
407,1492897,48,55900,75000,96.0,3175,2023-04-13T19:32,0,55900
408,2129859,49,39900,109000,97.0,222,2023-04-13T19:32,0,39900
409,2809006,50,847000,1130000,99.0,34,2023-04-13T19:32,-20000,827000
410,1494180,51,71100,79000,95.0,5280,2023-04-13T19:32,0,71100
411,716244,52,54900,95000,98.0,1278,2023-04-13T19:32,0,54900
412,181907,53,89900,119000,97.0,7177,2023-04-13T19:32,0,89900
413,2233178,54,75900,109000,97.0,4991,2023-04-13T19:32,0,75900
414,1868015,55,129000,0,97.0,1954,2023-04-13T19:32,0,129000
415,311050,56,53100,59000,97.0,9084,2023-04-13T19:32,0,53100
416,3115168,57,169000,0,95.0,24,2023-04-13T19:32,0,169000
417,1473136,58,119900,149000,97.0,10799,2023-04-13T19:32,0,119900
418,3172970,59,148000,0,99.0,32,2023-04-13T19:32,0,148000
419,1729744,60,76500,85000,97.0,3382,2023-04-13T19:32,0,76500
420,2673444,61,49900,149000,96.0,370,2023-04-13T19:32,0,49900
421,2851558,62,320000,1060000,100.0,2,2023-04-13T19:32,-20000,300000
422,2554105,63,39900,109000,96.0,721,2023-04-13T19:32,0,39900
423,2737458,64,230000,0,98.0,698,2023-04-13T19:32,0,230000
424,2691016,65,306000,0,98.0,200,2023-04-13T19:32,-45900,260100
425,1990244,66,129000,0,98.0,1124,2023-04-13T19:32,0,129000
426,3172974,67,260000,0,100.0,7,2023-04-13T19:32,0,260000
427,2312772,68,69900,139800,96.0,1406,2023-04-13T19:32,-13980,55920
428,2777004,69,370000,815000,100.0,1,2023-04-13T19:32,-20000,350000
429,1130307,70,109000,0,97.0,6070,2023-04-13T19:32,0,109000
430,490134,71,55900,95000,97.0,2044,2023-04-13T19:32,0,55900
431,3023097,72,230000,0,98.0,116,2023-04-13T19:32,0,230000
432,810032,73,85500,95000,97.0,13777,2023-04-13T19:32,0,85500
433,311051,74,58500,65000,97.0,19610,2023-04-13T19:32,0,58500
434,2737456,75,260000,0,98.0,227,2023-04-13T19:32,0,260000
435,2524840,76,139000,0,97.0,879,2023-04-13T19:32,0,139000
436,1812247,77,89000,0,97.0,3068,2023-04-13T19:32,-17800,71200
437,2229208,78,109000,0,97.0,1621,2023-04-13T19:32,0,109000
438,2741233,79,109000,0,97.0,2772,2023-04-13T19:32,0,109000
439,1853613,80,130000,0,96.0,107,2023-04-13T19:32,0,130000
440,1608838,81,85000,0,97.0,12654,2023-04-13T19:32,0,85000
441,2777005,82,477000,815000,94.0,34,2023-04-13T19:32,-20000,457000
442,2068678,83,129000,0,96.0,934,2023-04-13T19:32,0,129000
443,810036,84,85500,95000,97.0,5139,2023-04-13T19:32,0,85500
444,2839680,85,44900,89000,97.0,395,2023-04-13T19:32,0,44900
445,102620,86,69000,0,97.0,17961,2023-04-13T19:32,0,69000
446,1296776,87,99000,0,98.0,2953,2023-04-13T19:32,0,99000
447,3100522,88,129000,0,97.0,185,2023-04-13T19:32,0,129000
448,2778805,89,99000,0,97.0,1041,2023-04-13T19:32,0,99000
449,1353454,90,69000,99000,95.0,4464,2023-04-13T19:32,-13800,55200
450,1562990,1,230000,0,96.0,1286,2023-04-13T19:32,0,230000
451,1092992,2,69000,0,97.0,38060,2023-04-13T19:32,0,69000
452,3124961,3,62100,69000,98.0,149,2023-04-13T19:32,-3105,58995
453,3062046,4,78300,87000,97.0,177,2023-04-13T19:32,-3915,74385
454,3134606,5,125100,139000,100.0,6,2023-04-13T19:32,-6255,118845
455,1568047,6,159000,0,95.0,12029,2023-04-13T19:32,-31800,127200
456,3061996,7,88200,98000,98.0,119,2023-04-13T19:32,-4410,83790
457,3143034,8,31700,79000,100.0,7,2023-04-13T19:32,-6340,25360
458,3134621,9,136800,152000,98.0,12,2023-04-13T19:32,-6840,129960
459,2091749,10,80100,89000,95.0,6289,2023-04-13T19:32,0,80100
460,3161736,11,55300,158000,98.0,208,2023-04-13T19:32,-11060,44240
461,2383245,12,99000,0,98.0,840,2023-04-13T19:32,-19800,79200
462,2378989,13,159000,0,95.0,28,2023-04-13T19:32,-31800,127200
463,1334438,14,170000,0,96.0,4416,2023-04-13T19:32,0,170000
464,2430426,15,169000,0,98.0,749,2023-04-13T19:32,0,169000
465,595040,16,210000,0,95.0,8747,2023-04-13T19:32,0,210000
466,3143035,17,31700,79000,97.0,16,2023-04-13T19:32,-6340,25360
467,3192443,18,77420,98000,97.0,63,2023-04-13T19:32,-7742,69678
468,1339622,19,42900,59000,97.0,16390,2023-04-13T19:32,0,42900
469,2664372,20,65000,0,97.0,1080,2023-04-13T19:32,0,65000
470,1129750,21,69000,0,97.0,3946,2023-04-13T19:32,0,69000
471,3075621,22,339000,0,98.0,84,2023-04-13T19:32,0,339000
472,2735953,23,207000,230000,98.0,439,2023-04-13T19:32,0,207000
473,2433538,24,84660,102000,96.0,2428,2023-04-13T19:32,0,84660
474,1720813,25,149000,0,97.0,480,2023-04-13T19:32,0,149000
475,2435822,26,99000,0,97.0,269,2023-04-13T19:32,-19800,79200
476,3143030,27,31700,79000,97.0,8,2023-04-13T19:32,-6340,25360
477,2432733,28,44900,59000,97.0,2875,2023-04-13T19:32,0,44900
478,1720822,29,209000,0,97.0,305,2023-04-13T19:32,0,209000
479,2910082,30,265500,295000,98.0,496,2023-04-13T19:32,0,265500
480,2101924,31,99900,0,96.0,1386,2023-04-13T19:32,0,99900
481,2816812,32,119900,0,93.0,1554,2023-04-13T19:32,0,119900
482,595039,33,210000,0,97.0,3537,2023-04-13T19:32,0,210000
483,2732741,34,229000,760000,100.0,1,2023-04-13T19:32,-20000,209000
484,1926895,35,44000,108000,93.0,4227,2023-04-13T19:32,-8800,35200
485,3049313,36,57100,64900,97.0,658,2023-04-13T19:32,0,57100
486,2816816,37,143890,159900,97.0,1884,2023-04-13T19:32,0,143890
487,2032683,38,210000,0,96.0,176,2023-04-13T19:32,0,210000
488,2143833,39,89640,108000,96.0,2435,2023-04-13T19:32,0,89640
489,1730341,40,180600,258000,96.0,437,2023-04-13T19:32,0,180600
490,1439535,41,49000,0,96.0,16353,2023-04-13T19:32,0,49000
491,1890398,42,138000,168000,96.0,2750,2023-04-13T19:32,-13800,124200
492,2414019,43,398000,980000,100.0,8,2023-04-13T19:32,-20000,378000
493,1810762,44,140000,0,96.0,84,2023-04-13T19:32,0,140000
494,2910086,45,265500,295000,98.0,208,2023-04-13T19:32,0,265500
495,3062069,46,71100,79000,96.0,65,2023-04-13T19:32,-3555,67545
496,2379000,47,159000,0,97.0,116,2023-04-13T19:32,-31800,127200
497,3024585,48,59000,0,97.0,144,2023-04-13T19:32,-8850,50150
498,2809007,49,688000,1440000,90.0,2,2023-04-13T19:32,-20000,668000
499,1699941,50,67150,79000,97.0,4896,2023-04-13T19:32,-3358,63792
500,3223186,51,119000,0,0.0,0,2023-04-13T19:32,0,119000
501,2071613,52,89100,99000,92.0,1509,2023-04-13T19:32,-17820,71280
502,3223241,53,119000,0,0.0,0,2023-04-13T19:32,0,119000
503,2664373,54,65000,0,97.0,1042,2023-04-13T19:32,0,65000
504,2363570,55,39900,55000,97.0,1065,2023-04-13T19:32,0,39900
505,3132471,56,79000,0,97.0,28,2023-04-13T19:32,0,79000
506,3143028,57,31700,79000,100.0,2,2023-04-13T19:32,-6340,25360
507,3104657,58,160000,0,91.0,7,2023-04-13T19:32,0,160000
508,2621831,59,59800,85000,95.0,731,2023-04-13T19:32,-8970,50830
509,1724193,60,251900,280000,98.0,1484,2023-04-13T19:32,0,251900
510,2741208,61,98890,109900,96.0,182,2023-04-13T19:32,0,98890
511,1952910,62,265500,295000,98.0,1740,2023-04-13T19:32,0,265500
512,1419869,63,70300,74000,95.0,10578,2023-04-13T19:32,0,70300
513,2919223,64,826000,1470000,0.0,0,2023-04-13T19:32,-20000,806000
514,2039312,65,181300,259000,99.0,43,2023-04-13T19:32,-36260,145040
515,2684750,66,270000,0,98.0,15,2023-04-13T19:32,0,270000
516,2650879,67,169000,0,100.0,23,2023-04-13T19:32,0,169000
517,3097625,68,95000,0,94.0,10,2023-04-13T19:32,0,95000
518,2690519,69,73800,82000,96.0,198,2023-04-13T19:32,-3690,70110
519,1815709,70,138000,168000,96.0,7141,2023-04-13T19:32,-13800,124200
520,3134563,71,88200,98000,90.0,6,2023-04-13T19:32,-4410,83790
521,1762562,72,98100,109000,95.0,308,2023-04-13T19:32,0,98100
522,2624538,73,40900,59000,97.0,1515,2023-04-13T19:32,0,40900
523,2518112,74,87150,105000,96.0,987,2023-04-13T19:32,0,87150
524,2440524,75,69000,0,97.0,1574,2023-04-13T19:32,0,69000
525,3126912,76,159000,0,100.0,2,2023-04-13T19:32,-31800,127200
526,685185,77,148000,198000,95.0,12509,2023-04-13T19:32,-22200,125800
527,1215246,78,54300,110000,95.0,378,2023-04-13T19:32,0,54300
528,2736221,79,104500,110000,96.0,281,2023-04-13T19:32,0,104500
529,1891201,80,155000,0,98.0,211,2023-04-13T19:32,0,155000
530,2098793,81,89100,99000,96.0,1612,2023-04-13T19:32,0,89100
531,2243103,82,121500,135000,97.0,55,2023-04-13T19:32,0,121500
532,2381942,83,442000,1030000,93.0,3,2023-04-13T19:32,0,442000
533,1128656,84,86800,99000,95.0,21652,2023-04-13T19:32,0,86800
534,3126914,85,159000,0,95.0,4,2023-04-13T19:32,-31800,127200
535,3172972,86,138000,0,100.0,8,2023-04-13T19:32,0,138000
536,2355319,87,107890,119900,96.0,501,2023-04-13T19:32,0,107890
537,2032681,88,210000,0,96.0,120,2023-04-13T19:32,0,210000
538,3124959,89,52200,58000,97.0,48,2023-04-13T19:32,-2610,49590
539,127121,90,141000,152000,95.0,1875,2023-04-13T19:32,0,141000
540,2134140,1,39000,0,97.0,3583,2023-04-13T19:32,0,39000
541,2356713,2,39000,0,97.0,1493,2023-04-13T19:32,0,39000
542,1214164,3,36000,0,96.0,24995,2023-04-13T19:32,0,36000
543,2280117,4,35100,39000,97.0,6360,2023-04-13T19:32,0,35100
544,1822717,5,56050,59000,97.0,4331,2023-04-13T19:32,0,56050
545,1920929,6,39000,0,97.0,4004,2023-04-13T19:32,-3900,35100
546,2356711,7,39000,0,98.0,1510,2023-04-13T19:32,0,39000
547,1771137,8,26100,29000,97.0,12566,2023-04-13T19:32,0,26100
548,2879419,9,48900,55000,98.0,762,2023-04-13T19:32,-7335,41565
549,2134158,10,39000,0,97.0,2523,2023-04-13T19:32,0,39000
550,1272626,11,36000,0,96.0,14178,2023-04-13T19:32,0,36000
551,1214174,12,36000,0,97.0,15066,2023-04-13T19:32,0,36000
552,1214109,13,36000,0,97.0,8154,2023-04-13T19:32,0,36000
553,1771132,14,26100,29000,96.0,5284,2023-04-13T19:32,0,26100
554,2864918,15,49000,0,99.0,145,2023-04-13T19:32,0,49000
555,2356693,16,39000,0,97.0,1540,2023-04-13T19:32,0,39000
556,1855444,17,39900,42000,97.0,3039,2023-04-13T19:32,-5985,33915
557,1214317,18,36000,0,97.0,11510,2023-04-13T19:32,0,36000
558,1214173,19,36000,0,96.0,5584,2023-04-13T19:32,0,36000
559,2028240,20,39000,0,98.0,3358,2023-04-13T19:32,0,39000
560,1214169,21,36000,0,96.0,5345,2023-04-13T19:32,0,36000
561,2286829,22,37000,0,95.0,4990,2023-04-13T19:32,-5550,31450
562,2221221,23,35100,39000,96.0,1879,2023-04-13T19:32,0,35100
563,2879425,24,48900,55000,98.0,318,2023-04-13T19:32,-7335,41565
564,1524720,25,36000,0,96.0,3396,2023-04-13T19:32,0,36000
565,1907733,26,29900,39000,96.0,3864,2023-04-13T19:32,0,29900
566,2107999,27,36000,0,97.0,2696,2023-04-13T19:32,0,36000
567,1022013,28,79000,0,96.0,6280,2023-04-13T19:32,0,79000
568,2123132,29,39000,0,97.0,6426,2023-04-13T19:32,-3900,35100
569,1497550,30,29600,37000,95.0,5705,2023-04-13T19:32,0,29600
570,1214171,31,36000,0,97.0,1720,2023-04-13T19:32,0,36000
571,2687157,32,45000,0,97.0,1058,2023-04-13T19:32,0,45000
572,1925814,33,35100,39000,96.0,1678,2023-04-13T19:32,0,35100
573,2280146,34,35100,39000,97.0,937,2023-04-13T19:32,0,35100
574,2134287,35,39000,0,98.0,715,2023-04-13T19:32,0,39000
575,1771133,36,26100,29000,97.0,5723,2023-04-13T19:32,0,26100
576,3012243,37,29900,39900,98.0,69,2023-04-13T19:32,-4485,25415
577,2329375,38,34710,39000,96.0,2108,2023-04-13T19:32,-3471,31239
578,2287131,39,37000,0,95.0,1688,2023-04-13T19:32,-5550,31450
579,2560668,40,58650,69000,97.0,1260,2023-04-13T19:32,0,58650
580,1920840,41,39000,0,98.0,1381,2023-04-13T19:32,0,39000
581,2591291,42,39200,49000,97.0,1031,2023-04-13T19:32,0,39200
582,1214106,43,36000,0,96.0,9752,2023-04-13T19:32,0,36000
583,1086824,44,29600,37000,95.0,18643,2023-04-13T19:32,0,29600
584,1452917,45,69000,0,96.0,2422,2023-04-13T19:32,0,69000
585,2879417,46,48900,55000,98.0,217,2023-04-13T19:32,-7335,41565
586,2650965,47,48900,53000,98.0,380,2023-04-13T19:32,-7335,41565
587,2573131,48,39900,42000,98.0,708,2023-04-13T19:32,-5985,33915
588,2672186,49,20900,30000,96.0,593,2023-04-13T19:32,-2299,18601
589,1760824,50,49700,59000,97.0,313,2023-04-13T19:32,0,49700
590,2650964,51,48900,53000,98.0,195,2023-04-13T19:32,-7335,41565
591,2715553,52,68000,0,95.0,268,2023-04-13T19:32,0,68000
592,1906772,53,39900,42000,97.0,3090,2023-04-13T19:32,-5985,33915
593,3039055,54,43000,0,94.0,42,2023-04-13T19:32,-4300,38700
594,2879422,55,48900,55000,98.0,26,2023-04-13T19:32,-7335,41565
595,1335132,56,29000,0,95.0,1120,2023-04-13T19:32,0,29000
596,2930563,57,160000,238000,92.0,5,2023-04-13T19:32,-16000,144000
597,3142351,58,49000,0,100.0,25,2023-04-13T19:32,0,49000
598,2280751,59,29000,0,97.0,1354,2023-04-13T19:32,0,29000
599,2926042,60,68000,0,96.0,17,2023-04-13T19:32,0,68000
600,2507080,61,39000,0,98.0,416,2023-04-13T19:32,0,39000
601,2157077,62,37800,42000,95.0,740,2023-04-13T19:32,-5670,32130
602,2715570,63,68000,0,97.0,109,2023-04-13T19:32,0,68000
603,2289281,64,28500,38000,96.0,889,2023-04-13T19:32,0,28500
604,2879431,65,48900,55000,98.0,69,2023-04-13T19:32,-7335,41565
605,2650966,66,48900,53000,97.0,186,2023-04-13T19:32,-7335,41565
606,1214193,67,39000,0,97.0,15370,2023-04-13T19:32,0,39000
607,1214316,68,36000,0,97.0,1995,2023-04-13T19:32,0,36000
608,2089719,69,36000,0,97.0,2421,2023-04-13T19:32,0,36000
609,2464070,70,44000,55000,96.0,378,2023-04-13T19:32,-2200,41800
610,1906773,71,39900,42000,97.0,667,2023-04-13T19:32,-5985,33915
611,2053753,72,42000,0,98.0,4145,2023-04-13T19:32,0,42000
612,2340313,73,296000,510000,100.0,8,2023-04-13T19:32,-20000,276000
613,2707659,74,42000,0,97.0,530,2023-04-13T19:32,0,42000
614,2864774,75,49000,0,98.0,92,2023-04-13T19:32,0,49000
615,2765415,76,99000,0,100.0,20,2023-04-13T19:32,0,99000
616,1755276,77,49000,0,97.0,2417,2023-04-13T19:32,0,49000
617,2356714,78,39000,0,97.0,483,2023-04-13T19:32,0,39000
618,1022014,79,79000,0,96.0,11466,2023-04-13T19:32,0,79000
619,1836699,80,79000,0,96.0,265,2023-04-13T19:32,0,79000
620,2921965,81,52000,0,98.0,185,2023-04-13T19:32,0,52000
621,2922336,82,52000,0,97.0,151,2023-04-13T19:32,0,52000
622,3099126,83,54000,0,0.0,0,2023-04-13T19:32,0,54000
623,1535402,84,39000,0,97.0,1205,2023-04-13T19:32,0,39000
624,2962388,85,31200,39000,96.0,128,2023-04-13T19:32,0,31200
625,1939301,86,39000,0,97.0,812,2023-04-13T19:32,0,39000
626,2995999,87,48900,55000,99.0,29,2023-04-13T19:32,-7335,41565
627,1014906,88,52000,0,96.0,490,2023-04-13T19:32,-7800,44200
628,2169131,89,35100,39000,97.0,447,2023-04-13T19:32,0,35100
629,3142350,90,49000,0,100.0,19,2023-04-13T19:32,0,49000
630,3106487,1,133200,148000,99.0,26,2023-04-13T19:32,0,133200
631,3059119,2,161100,179000,92.0,24,2023-04-13T19:32,-28998,132102
632,2827957,3,568100,1579000,100.0,2,2023-04-13T19:32,-20000,548100
633,2457512,4,237300,339000,98.0,37,2023-04-13T19:32,0,237300
634,2415801,5,455000,0,0.0,0,2023-04-13T19:32,0,455000
635,3224998,6,390000,0,0.0,0,2023-04-13T19:32,-50000,340000
636,2830893,7,189000,0,100.0,5,2023-04-13T19:32,0,189000
637,2605850,8,94000,0,97.0,168,2023-04-13T19:32,0,94000
638,3008189,9,334000,478000,100.0,6,2023-04-13T19:32,-43420,290580
639,3130633,10,149000,0,100.0,6,2023-04-13T19:32,0,149000
640,3008191,11,348000,498000,100.0,1,2023-04-13T19:32,-45240,302760
641,3030948,12,68000,0,99.0,35,2023-04-13T19:32,-3400,64600
642,3201469,13,159000,0,0.0,0,2023-04-13T19:32,0,159000
643,1840913,14,143200,179000,92.0,16,2023-04-13T19:32,0,143200
644,3040732,15,55300,79000,100.0,2,2023-04-13T19:32,-11060,44240
645,3224202,16,298000,0,0.0,0,2023-04-13T19:32,-50000,248000
646,3196948,17,129000,0,100.0,3,2023-04-13T19:32,0,129000
647,3031171,18,68000,0,98.0,55,2023-04-13T19:32,-3400,64600
648,2512635,19,35400,59000,96.0,217,2023-04-13T19:32,0,35400
649,3196981,20,129000,0,0.0,0,2023-04-13T19:32,0,129000
650,2489894,21,150100,158000,98.0,109,2023-04-13T19:32,0,150100
651,2377832,22,195000,0,95.0,175,2023-04-13T19:32,0,195000
652,3084762,23,119000,0,100.0,2,2023-04-13T19:32,0,119000
653,3098634,24,222740,259000,0.0,0,2023-04-13T19:32,-40094,182646
654,2610670,25,234000,0,100.0,3,2023-04-13T19:32,0,234000
655,2153636,26,173600,248000,98.0,31,2023-04-13T19:32,0,173600
656,3037449,27,199000,0,80.0,3,2023-04-13T19:32,0,199000
657,3040733,28,55300,79000,0.0,0,2023-04-13T19:32,-11060,44240
658,3053225,29,159000,0,100.0,2,2023-04-13T19:32,0,159000
659,3050173,30,166600,238000,100.0,2,2023-04-13T19:32,0,166600
660,3130645,31,119000,0,100.0,1,2023-04-13T19:32,0,119000
661,3099416,32,44910,49900,100.0,3,2023-04-13T19:32,0,44910
662,3171882,33,149000,0,100.0,2,2023-04-13T19:32,0,149000
663,3171883,34,149000,0,100.0,3,2023-04-13T19:32,0,149000
664,1537416,35,57800,68000,90.0,133,2023-04-13T19:32,0,57800
665,3073259,36,196200,218000,100.0,5,2023-04-13T19:32,-35316,160884
666,3066926,37,94400,118000,100.0,1,2023-04-13T19:32,-18880,75520
667,2393504,38,94000,0,99.0,52,2023-04-13T19:32,0,94000
668,1779568,39,54400,64000,95.0,294,2023-04-13T19:32,-10880,43520
669,3138201,40,139500,155000,0.0,0,2023-04-13T19:32,-6975,132525
670,2452062,41,98100,109000,97.0,43,2023-04-13T19:32,0,98100
671,3055337,42,159000,0,100.0,1,2023-04-13T19:32,0,159000
672,1871030,43,133600,167000,95.0,102,2023-04-13T19:32,0,133600
673,2411380,44,182400,228000,100.0,2,2023-04-13T19:32,0,182400
674,3196932,45,159000,0,0.0,0,2023-04-13T19:32,0,159000
675,2721825,46,185400,309000,100.0,1,2023-04-13T19:32,-27810,157590
676,3200457,47,159000,0,0.0,0,2023-04-13T19:32,0,159000
677,3041837,48,168000,0,0.0,0,2023-04-13T19:32,0,168000
678,3040734,49,55300,79000,100.0,1,2023-04-13T19:32,-11060,44240
679,3119222,50,179000,0,0.0,0,2023-04-13T19:32,0,179000
680,2714524,51,48300,69000,95.0,401,2023-04-13T19:32,-7245,41055
681,3160102,52,170500,0,0.0,0,2023-04-13T19:32,0,170500
682,3174225,53,161100,179000,0.0,0,2023-04-13T19:32,-28998,132102
683,1609017,54,178000,0,0.0,0,2023-04-13T19:32,0,178000
684,3149931,55,109000,0,100.0,5,2023-04-13T19:32,0,109000
685,3155272,56,87200,109000,0.0,0,2023-04-13T19:32,0,87200
686,3128138,57,175000,0,0.0,0,2023-04-13T19:32,0,175000
687,3138205,58,139500,155000,0.0,0,2023-04-13T19:32,-6975,132525
688,3153593,59,151200,168000,100.0,1,2023-04-13T19:32,-27216,123984
689,2457508,60,153300,219000,97.0,31,2023-04-13T19:32,0,153300
690,3134492,61,79000,0,100.0,4,2023-04-13T19:32,0,79000
691,3055334,62,159000,0,0.0,0,2023-04-13T19:32,0,159000
692,1455772,63,94000,0,96.0,211,2023-04-13T19:32,0,94000
693,1911292,64,168000,0,0.0,0,2023-04-13T19:32,0,168000
694,2849021,65,152000,0,93.0,3,2023-04-13T19:32,0,152000
695,3119265,66,125100,139000,0.0,0,2023-04-13T19:32,0,125100
696,3152277,67,119000,178000,0.0,0,2023-04-13T19:32,0,119000
697,3132939,68,158000,0,0.0,0,2023-04-13T19:32,0,158000
698,3221008,69,146000,0,0.0,0,2023-04-13T19:32,0,146000
699,3206552,70,106400,112000,0.0,0,2023-04-13T19:32,0,106400
700,3203937,71,159000,0,0.0,0,2023-04-13T19:32,0,159000
701,2044442,72,70000,0,96.0,171,2023-04-13T19:32,0,70000
702,1695518,73,125800,148000,95.0,48,2023-04-13T19:32,0,125800
703,2478652,74,56500,68000,94.0,332,2023-04-13T19:32,-11300,45200
704,2585216,75,148000,0,86.0,12,2023-04-13T19:32,0,148000
705,3170245,76,143000,159000,0.0,0,2023-04-13T19:32,0,143000
706,2712722,77,46900,79000,95.0,29,2023-04-13T19:32,0,46900
707,1955908,78,55800,93000,91.0,69,2023-04-13T19:32,-8370,47430
708,2558144,79,143200,179000,100.0,4,2023-04-13T19:32,0,143200
709,2784064,80,126400,158000,60.0,2,2023-04-13T19:32,0,126400
710,2775942,81,198000,660000,0.0,0,2023-04-13T19:32,-19800,178200
711,2590365,82,143100,159000,0.0,0,2023-04-13T19:32,0,143100
712,3203383,83,129000,0,0.0,0,2023-04-13T19:32,0,129000
713,3134129,84,128000,0,0.0,0,2023-04-13T19:32,-19200,108800
714,3142518,85,139000,0,0.0,0,2023-04-13T19:32,-6950,132050
715,3137344,86,139000,0,0.0,0,2023-04-13T19:32,0,139000
716,2957670,87,131600,188000,100.0,2,2023-04-13T19:32,0,131600
717,3224160,88,129000,0,0.0,0,2023-04-13T19:32,0,129000
718,3074709,89,119000,0,0.0,0,2023-04-13T19:32,0,119000
719,3135234,90,80100,89000,95.0,4,2023-04-13T19:32,-12015,68085
720,2713339,1,188000,470000,90.0,2,2023-04-13T19:32,-18800,169200
721,2978105,2,49900,0,95.0,8,2023-04-13T19:32,-4990,44910
722,2978106,3,49900,0,100.0,3,2023-04-13T19:32,-4990,44910
723,3070528,4,168000,0,95.0,4,2023-04-13T19:32,0,168000
724,2819904,5,255200,319000,80.0,1,2023-04-13T19:32,0,255200
725,2819908,6,255200,319000,0.0,0,2023-04-13T19:32,0,255200
726,1788995,7,55500,65000,94.0,564,2023-04-13T19:32,-11100,44400
727,3040758,8,82000,111000,98.0,11,2023-04-13T19:32,-16400,65600
728,3040745,9,88000,110000,94.0,17,2023-04-13T19:32,-17600,70400
729,3038425,10,111200,139000,96.0,6,2023-04-13T19:32,-16680,94520
730,3031104,11,55200,69000,98.0,60,2023-04-13T19:32,-8280,46920
731,3049792,12,67000,79000,100.0,9,2023-04-13T19:32,-13400,53600
732,2713273,13,359000,0,100.0,1,2023-04-13T19:32,0,359000
733,2925522,14,58500,65000,95.0,119,2023-04-13T19:32,0,58500
734,3070530,15,168000,0,0.0,0,2023-04-13T19:32,0,168000
735,2499645,16,348000,0,100.0,1,2023-04-13T19:32,-52200,295800
736,3159166,17,162000,0,0.0,0,2023-04-13T19:32,0,162000
737,3026955,18,86700,102000,87.0,8,2023-04-13T19:32,-13005,73695
738,3118978,19,318000,0,80.0,1,2023-04-13T19:32,-50000,268000
739,3118975,20,318000,0,80.0,1,2023-04-13T19:32,-50000,268000
740,3147249,21,318000,0,0.0,0,2023-04-13T19:32,-50000,268000
741,3190566,22,306000,438000,0.0,0,2023-04-13T19:32,-50000,256000
742,3051039,23,95200,119000,100.0,33,2023-04-13T19:32,0,95200
743,1944554,24,31290,36900,96.0,546,2023-04-13T19:32,0,31290
744,1931894,25,37900,0,95.0,523,2023-04-13T19:32,0,37900
745,2891916,26,265300,379000,80.0,4,2023-04-13T19:32,0,265300
746,3206524,27,131100,138000,0.0,0,2023-04-13T19:32,0,131100
747,2836351,28,49680,72000,96.0,471,2023-04-13T19:32,-7452,42228
748,2816861,29,255200,319000,0.0,0,2023-04-13T19:32,0,255200
749,2377814,30,178200,198000,96.0,78,2023-04-13T19:32,-26730,151470
750,1819994,31,36500,43000,92.0,663,2023-04-13T19:32,-3650,32850
751,2850491,32,250600,358000,100.0,5,2023-04-13T19:32,-32578,218022
752,2551401,33,37900,0,94.0,325,2023-04-13T19:32,0,37900
753,3174961,34,241200,268000,0.0,0,2023-04-13T19:32,-43416,197784
754,3194479,35,119000,0,0.0,0,2023-04-13T19:32,0,119000
755,2643339,36,124000,138000,96.0,21,2023-04-13T19:32,-18600,105400
756,2864414,37,69300,99000,95.0,94,2023-04-13T19:32,-10395,58905
757,2849028,38,77500,0,0.0,0,2023-04-13T19:32,0,77500
758,2551400,39,39900,0,93.0,138,2023-04-13T19:32,0,39900
759,3210874,40,89100,99000,0.0,0,2023-04-13T19:32,0,89100
760,2394390,41,231000,0,0.0,0,2023-04-13T19:32,-34650,196350
761,3174796,42,223200,248000,0.0,0,2023-04-13T19:32,-40176,183024
762,2378594,43,88200,98000,95.0,130,2023-04-13T19:32,0,88200
763,2942784,44,189000,0,100.0,3,2023-04-13T19:32,0,189000
764,3000422,45,59000,0,97.0,34,2023-04-13T19:32,0,59000
765,3066309,46,109000,0,100.0,1,2023-04-13T19:32,-16350,92650
766,2686263,47,205000,0,0.0,0,2023-04-13T19:32,0,205000
767,2744470,48,169000,338000,0.0,0,2023-04-13T19:32,-21970,147030
768,2377812,49,188100,198000,96.0,58,2023-04-13T19:32,-28215,159885
769,2377804,50,178200,198000,93.0,38,2023-04-13T19:32,-26730,151470
770,3100234,51,174400,218000,0.0,0,2023-04-13T19:32,-31392,143008
771,3049781,52,76000,95000,100.0,2,2023-04-13T19:32,-15200,60800
772,2942764,53,189000,0,98.0,14,2023-04-13T19:32,0,189000
773,3098355,54,161100,179000,0.0,0,2023-04-13T19:32,-28998,132102
774,2416957,55,54000,67900,95.0,42,2023-04-13T19:32,-8100,45900
775,3134491,56,188340,219000,0.0,0,2023-04-13T19:32,-33902,154438
776,3081767,57,169000,0,91.0,7,2023-04-13T19:32,0,169000
777,3134481,58,188340,219000,0.0,0,2023-04-13T19:32,-33902,154438
778,3172166,59,99000,0,0.0,0,2023-04-13T19:32,0,99000
779,2867750,60,135000,0,97.0,44,2023-04-13T19:32,0,135000
780,2864423,61,69300,99000,94.0,18,2023-04-13T19:32,-10395,58905
781,3098640,62,179550,189000,0.0,0,2023-04-13T19:32,-32319,147231
782,3073254,63,160200,178000,92.0,8,2023-04-13T19:32,-28836,131364
783,3052037,64,174000,249000,0.0,0,2023-04-13T19:32,0,174000
784,2378593,65,88200,98000,94.0,70,2023-04-13T19:32,0,88200
785,3118729,66,176400,196000,0.0,0,2023-04-13T19:32,-31752,144648
786,3085784,67,128000,0,100.0,2,2023-04-13T19:32,0,128000
787,1944553,68,36900,0,96.0,217,2023-04-13T19:32,-3690,33210
788,3040569,69,169100,178000,0.0,0,2023-04-13T19:32,0,169100
789,3105350,70,48800,65000,97.0,9,2023-04-13T19:32,-7320,41480
790,2716675,71,39900,59000,96.0,177,2023-04-13T19:32,-5985,33915
791,2117256,72,37900,0,96.0,254,2023-04-13T19:32,0,37900
792,3102083,73,167400,279000,0.0,0,2023-04-13T19:32,-30132,137268
793,3118732,74,167200,176000,0.0,0,2023-04-13T19:32,-30096,137104
794,2571671,75,149000,0,100.0,7,2023-04-13T19:32,0,149000
795,2571681,76,149000,0,86.0,9,2023-04-13T19:32,0,149000
796,3098351,77,161100,179000,100.0,1,2023-04-13T19:32,-28998,132102
797,3125453,78,49900,89900,93.0,3,2023-04-13T19:32,0,49900
798,3193246,79,149000,0,0.0,0,2023-04-13T19:32,0,149000
799,1645760,80,43900,0,96.0,344,2023-04-13T19:32,0,43900
800,3073229,81,151200,168000,100.0,1,2023-04-13T19:32,-27216,123984
801,2390967,82,39530,59000,93.0,216,2023-04-13T19:32,0,39530
802,2448902,83,37290,43900,95.0,106,2023-04-13T19:32,0,37290
803,3119630,84,158000,0,90.0,2,2023-04-13T19:32,0,158000
804,3120598,85,152100,169000,100.0,1,2023-04-13T19:32,-27378,124722
805,2830808,86,139000,0,97.0,15,2023-04-13T19:32,0,139000
806,3071045,87,148000,0,100.0,1,2023-04-13T19:32,-20720,127280
807,3058718,88,86400,96000,95.0,14,2023-04-13T19:32,-15552,70848
808,2117253,89,43900,0,94.0,269,2023-04-13T19:32,0,43900
809,3120201,90,124200,138000,100.0,2,2023-04-13T19:32,-22356,101844
810,991339,1,17890,19900,97.0,53018,2023-04-13T19:32,0,17890
811,1986031,2,24990,27900,97.0,10675,2023-04-13T19:32,0,24990
812,998051,3,15900,24000,97.0,163461,2023-04-13T19:32,0,15900
813,1094748,4,19900,0,97.0,19199,2023-04-13T19:32,0,19900
814,991340,5,17890,19900,97.0,30935,2023-04-13T19:32,0,17890
815,763821,6,16900,22000,96.0,31430,2023-04-13T19:32,0,16900
816,1477845,7,15400,22000,96.0,9737,2023-04-13T19:32,0,15400
817,1094835,8,14290,15900,97.0,6242,2023-04-13T19:32,0,14290
818,792919,9,15190,16900,96.0,17947,2023-04-13T19:32,0,15190
819,1342874,10,16900,33000,97.0,12894,2023-04-13T19:32,0,16900
820,746158,11,22900,0,96.0,20541,2023-04-13T19:32,0,22900
821,3033249,12,15000,0,96.0,211,2023-04-13T19:32,-750,14250
822,734085,13,13900,19800,96.0,64935,2023-04-13T19:32,0,13900
823,1443937,14,12900,24000,97.0,8040,2023-04-13T19:32,0,12900
824,1821485,15,30000,0,96.0,1280,2023-04-13T19:32,0,30000
825,1729576,16,9900,13900,97.0,16164,2023-04-13T19:32,0,9900
826,1996702,17,23690,27900,97.0,1950,2023-04-13T19:32,0,23690
827,991570,18,12900,20000,97.0,19102,2023-04-13T19:32,0,12900
828,2845854,19,13200,18900,97.0,248,2023-04-13T19:32,-2640,10560
829,479245,20,15400,22000,93.0,5419,2023-04-13T19:32,0,15400
830,792920,21,15190,16900,96.0,9674,2023-04-13T19:32,0,15190
831,1986030,22,23690,27900,97.0,1679,2023-04-13T19:32,0,23690
832,1996705,23,23690,27900,98.0,2701,2023-04-13T19:32,0,23690
833,2297277,24,19900,22000,95.0,304,2023-04-13T19:32,0,19900
834,1986029,25,27900,0,97.0,3967,2023-04-13T19:32,0,27900
835,1996704,26,22290,27900,97.0,716,2023-04-13T19:32,0,22290
836,2821598,27,19390,22900,97.0,151,2023-04-13T19:32,0,19390
837,991341,28,16890,19900,96.0,10243,2023-04-13T19:32,0,16890
838,1094750,29,16890,19900,97.0,3562,2023-04-13T19:32,0,16890
839,2960555,30,19000,0,94.0,111,2023-04-13T19:32,0,19000
840,2011852,31,21490,23900,97.0,1312,2023-04-13T19:32,0,21490
841,746154,32,17900,0,96.0,5192,2023-04-13T19:32,0,17900
842,2832613,33,11900,33000,97.0,726,2023-04-13T19:32,0,11900
843,1094749,34,19900,0,96.0,4967,2023-04-13T19:32,0,19900
844,1346009,35,9900,12000,97.0,6719,2023-04-13T19:32,0,9900
845,2295818,36,19900,22000,95.0,187,2023-04-13T19:32,0,19900
846,3220486,37,18000,0,0.0,0,2023-04-13T19:32,0,18000
847,3220488,38,18000,0,0.0,0,2023-04-13T19:32,0,18000
848,1821487,39,30000,0,97.0,685,2023-04-13T19:32,0,30000
849,2477854,40,17890,19900,98.0,1469,2023-04-13T19:32,0,17890
850,1094837,41,13490,15900,96.0,1760,2023-04-13T19:32,0,13490
851,2973952,42,28800,48000,94.0,15,2023-04-13T19:32,-4320,24480
852,2835702,43,13900,15800,97.0,70,2023-04-13T19:32,0,13900
853,2293399,44,19900,22000,95.0,631,2023-04-13T19:32,0,19900
854,1348077,45,10900,16500,97.0,1864,2023-04-13T19:32,0,10900
855,2011850,46,21490,23900,98.0,867,2023-04-13T19:32,0,21490
856,2959925,47,22000,27500,98.0,115,2023-04-13T19:32,0,22000
857,1358721,48,14900,22000,96.0,1141,2023-04-13T19:32,0,14900
858,2342849,49,15120,18900,91.0,125,2023-04-13T19:32,0,15120
859,2467197,50,30000,0,95.0,137,2023-04-13T19:32,0,30000
860,3118094,51,28800,32000,97.0,9,2023-04-13T19:32,0,28800
861,2929635,52,16800,27000,97.0,534,2023-04-13T19:32,0,16800
862,2821597,53,22900,0,98.0,108,2023-04-13T19:32,0,22900
863,958997,54,16090,17900,95.0,1415,2023-04-13T19:32,0,16090
864,3113489,55,32000,0,100.0,2,2023-04-13T19:32,0,32000
865,1392773,56,16890,19900,95.0,1476,2023-04-13T19:32,0,16890
866,3009680,57,12590,14900,98.0,126,2023-04-13T19:32,0,12590
867,1260383,58,19900,0,95.0,1455,2023-04-13T19:32,0,19900
868,2798430,59,29000,0,97.0,46,2023-04-13T19:32,0,29000
869,1094836,60,14290,15900,97.0,1322,2023-04-13T19:32,0,14290
870,2346958,61,18900,24000,98.0,522,2023-04-13T19:32,0,18900
871,752821,62,9900,0,94.0,23815,2023-04-13T19:32,0,9900
872,1475055,63,16900,22000,96.0,1179,2023-04-13T19:32,0,16900
873,2347097,64,14900,24000,98.0,1582,2023-04-13T19:32,0,14900
874,746159,65,22900,0,95.0,28740,2023-04-13T19:32,0,22900
875,1821480,66,30000,0,97.0,236,2023-04-13T19:32,0,30000
876,2973894,67,22000,27500,98.0,30,2023-04-13T19:32,0,22000
877,2870865,68,15900,19900,96.0,69,2023-04-13T19:32,-3180,12720
878,2738094,69,19900,0,96.0,176,2023-04-13T19:32,0,19900
879,472686,70,9900,14800,94.0,740,2023-04-13T19:32,0,9900
880,2821589,71,19690,21900,96.0,39,2023-04-13T19:32,0,19690
881,2122868,72,9900,13900,97.0,3897,2023-04-13T19:32,0,9900
882,1094834,73,21490,23900,96.0,2462,2023-04-13T19:32,0,21490
883,1777081,74,8000,12800,96.0,1217,2023-04-13T19:32,0,8000
884,3113487,75,32000,0,100.0,4,2023-04-13T19:32,0,32000
885,2551214,76,5900,9900,97.0,218,2023-04-13T19:32,0,5900
886,1260388,77,20900,0,95.0,679,2023-04-13T19:32,0,20900
887,1647682,78,14900,23600,97.0,955,2023-04-13T19:32,0,14900
888,3113486,79,32000,0,80.0,1,2023-04-13T19:32,0,32000
889,2509300,80,19900,0,96.0,395,2023-04-13T19:32,0,19900
890,1974077,81,42090,46900,97.0,900,2023-04-13T19:32,0,42090
891,1260384,82,19900,0,95.0,1803,2023-04-13T19:32,0,19900
892,1547562,83,15400,22000,95.0,1367,2023-04-13T19:32,0,15400
893,783120,84,13900,0,96.0,1414,2023-04-13T19:32,0,13900
894,3181894,85,22000,0,100.0,4,2023-04-13T19:32,0,22000
895,1882611,86,12900,21900,96.0,256,2023-04-13T19:32,0,12900
896,1360044,87,19900,0,97.0,1763,2023-04-13T19:32,0,19900
897,1092994,88,22900,0,96.0,2661,2023-04-13T19:32,0,22900
898,1717607,89,13900,20800,96.0,2164,2023-04-13T19:32,0,13900
899,2959926,90,14850,16500,98.0,147,2023-04-13T19:32,0,14850
