,item_id,rank,price,del_price,rating,rating_count,time,coupon,real_price
0,1848166,1,34300,49000,97.0,41813,2023-04-30T19:45,-3430,30870
1,1763157,2,49300,52000,96.0,3095,2023-04-30T19:45,0,49300
2,2442409,3,27300,78000,96.0,9563,2023-04-30T19:45,0,27300
3,2272830,4,35910,39900,97.0,21297,2023-04-30T19:45,-7182,28728
4,3187851,5,49900,110000,96.0,495,2023-04-30T19:45,-4990,44910
5,1921901,6,36900,70500,96.0,7886,2023-04-30T19:45,0,36900
6,3143791,7,45900,68000,97.0,1045,2023-04-30T19:45,-9180,36720
7,3204179,8,49900,0,98.0,115,2023-04-30T19:45,0,49900
8,2646350,9,59800,94000,95.0,5281,2023-04-30T19:45,-5980,53820
9,2285512,10,49300,52000,96.0,1952,2023-04-30T19:45,-2465,46835
10,1944612,11,35800,59700,97.0,3274,2023-04-30T19:45,0,35800
11,345889,12,29900,47900,96.0,10684,2023-04-30T19:45,0,29900
12,2820620,13,1092000,0,100.0,5,2023-04-30T19:45,0,1092000
13,3259338,14,88200,98000,100.0,1,2023-04-30T19:45,0,88200
14,1884943,15,27900,39000,96.0,19250,2023-04-30T19:45,-4185,23715
15,3219911,16,69900,118000,97.0,93,2023-04-30T19:45,-6990,62910
16,2086653,17,16900,0,97.0,41316,2023-04-30T19:45,0,16900
17,2575342,18,39900,59000,96.0,1062,2023-04-30T19:45,-3990,35910
18,3214271,19,49200,82000,98.0,352,2023-04-30T19:45,0,49200
19,1882578,20,35910,39900,97.0,11075,2023-04-30T19:45,-7182,28728
20,3043740,21,49700,59000,98.0,109,2023-04-30T19:45,-2485,47215
21,1899755,22,27900,39000,96.0,5211,2023-04-30T19:45,-4185,23715
22,2479911,23,49400,76000,97.0,4783,2023-04-30T19:45,-2470,46930
23,2453556,24,39900,42000,97.0,6563,2023-04-30T19:45,0,39900
24,3257423,25,69300,99000,0.0,0,2023-04-30T19:45,0,69300
25,3046771,26,39560,46000,98.0,230,2023-04-30T19:45,0,39560
26,2462040,27,38000,45000,95.0,4132,2023-04-30T19:45,-5700,32300
27,2376229,28,32400,36000,97.0,4037,2023-04-30T19:45,0,32400
28,3214275,29,49200,82000,98.0,543,2023-04-30T19:45,0,49200
29,3214280,30,49200,82000,98.0,490,2023-04-30T19:45,0,49200
30,3105468,31,63200,79000,98.0,160,2023-04-30T19:45,0,63200
31,2376233,32,32400,36000,97.0,2385,2023-04-30T19:45,0,32400
32,2398380,33,27000,45000,96.0,1943,2023-04-30T19:45,-2700,24300
33,3265079,34,42000,0,97.0,128,2023-04-30T19:45,0,42000
34,1763218,35,80100,89000,96.0,1573,2023-04-30T19:45,0,80100
35,1763123,36,80100,89000,96.0,1737,2023-04-30T19:45,0,80100
36,2645415,37,55300,79000,98.0,390,2023-04-30T19:45,0,55300
37,1848797,38,169000,0,97.0,140,2023-04-30T19:45,0,169000
38,1939099,39,31850,49000,97.0,12303,2023-04-30T19:45,-6370,25480
39,2034137,40,31800,0,97.0,18683,2023-04-30T19:45,-4770,27030
40,3042516,41,42000,65000,96.0,289,2023-04-30T19:45,-4200,37800
41,2409894,42,27300,78000,97.0,5402,2023-04-30T19:45,0,27300
42,2461377,43,169000,0,96.0,356,2023-04-30T19:45,0,169000
43,3214283,44,49200,82000,98.0,370,2023-04-30T19:45,0,49200
44,1503352,45,39900,42000,97.0,8634,2023-04-30T19:45,0,39900
45,1706633,46,199000,0,97.0,2523,2023-04-30T19:45,0,199000
46,1779737,47,20800,32000,96.0,7611,2023-04-30T19:45,-3120,17680
47,2996536,48,39900,59000,96.0,900,2023-04-30T19:45,-3990,35910
48,2913659,49,47900,64000,96.0,425,2023-04-30T19:45,-9580,38320
49,3141118,50,109000,0,80.0,2,2023-04-30T19:45,-16350,92650
50,1955452,51,39800,69990,95.0,2834,2023-04-30T19:45,0,39800
51,3046818,52,39560,46000,98.0,162,2023-04-30T19:45,0,39560
52,2377269,53,45000,0,97.0,4392,2023-04-30T19:45,0,45000
53,3174960,54,69900,87900,96.0,10,2023-04-30T19:45,0,69900
54,2015684,55,39000,0,94.0,6570,2023-04-30T19:45,0,39000
55,1836749,56,119000,0,95.0,32,2023-04-30T19:45,0,119000
56,2426596,57,34400,43000,96.0,3086,2023-04-30T19:45,-5160,29240
57,3211815,58,24500,35000,97.0,109,2023-04-30T19:45,-4900,19600
58,3071299,59,39800,45000,96.0,126,2023-04-30T19:45,-5970,33830
59,3227259,60,39900,45000,100.0,6,2023-04-30T19:45,-11970,27930
60,2471760,61,27300,39000,97.0,6703,2023-04-30T19:45,0,27300
61,1005683,62,14000,35000,95.0,11309,2023-04-30T19:45,0,14000
62,2453552,63,39900,42000,97.0,3169,2023-04-30T19:45,0,39900
63,3256915,64,70000,150000,100.0,2,2023-04-30T19:45,0,70000
64,994588,65,39900,53000,94.0,6237,2023-04-30T19:45,-11970,27930
65,1008043,66,48000,60000,95.0,14848,2023-04-30T19:45,-7200,40800
66,3134406,67,53910,59900,99.0,337,2023-04-30T19:45,-10782,43128
67,3064420,68,61500,69000,98.0,185,2023-04-30T19:45,-3075,58425
68,2326935,69,47400,79000,96.0,13219,2023-04-30T19:45,-9480,37920
69,3129723,70,31200,39000,97.0,168,2023-04-30T19:45,-4680,26520
70,1336398,71,33500,67000,96.0,19305,2023-04-30T19:45,-6700,26800
71,1846930,72,17500,39000,96.0,8535,2023-04-30T19:45,0,17500
72,2368712,73,38700,43000,97.0,5737,2023-04-30T19:45,-7740,30960
73,1820701,74,31500,35000,97.0,5671,2023-04-30T19:45,0,31500
74,2313388,75,68000,85000,96.0,2336,2023-04-30T19:45,0,68000
75,2630449,76,29400,42000,96.0,697,2023-04-30T19:45,0,29400
76,3070584,77,58000,0,97.0,89,2023-04-30T19:45,0,58000
77,2612829,78,34500,67900,97.0,2106,2023-04-30T19:45,0,34500
78,2456003,79,54900,82900,94.0,2348,2023-04-30T19:45,0,54900
79,2375962,80,59000,62000,98.0,6053,2023-04-30T19:45,0,59000
80,2403601,81,32500,50000,96.0,2431,2023-04-30T19:45,-4875,27625
81,3165424,82,61000,65000,98.0,75,2023-04-30T19:45,0,61000
82,1848804,83,169000,0,95.0,13,2023-04-30T19:45,0,169000
83,2392759,84,39900,49600,95.0,4383,2023-04-30T19:45,-5985,33915
84,3201923,85,87200,109000,100.0,9,2023-04-30T19:45,-13080,74120
85,3163734,86,63200,79000,98.0,204,2023-04-30T19:45,0,63200
86,996177,87,15900,0,95.0,78331,2023-04-30T19:45,0,15900
87,3214276,88,41400,69000,98.0,204,2023-04-30T19:45,0,41400
88,3129117,89,45000,0,98.0,113,2023-04-30T19:45,-4500,40500
89,3157193,90,39000,0,94.0,87,2023-04-30T19:45,0,39000
90,1778404,1,39000,45000,96.0,68821,2023-04-30T19:45,-5850,33150
91,2061715,2,79900,105000,97.0,2905,2023-04-30T19:45,0,79900
92,3033083,3,69760,109000,97.0,86,2023-04-30T19:45,-20928,48832
93,1558197,4,69590,81900,97.0,33324,2023-04-30T19:45,0,69590
94,2723218,5,69900,85900,97.0,3305,2023-04-30T19:45,-10485,59415
95,2184466,6,359000,0,98.0,37,2023-04-30T19:45,0,359000
96,2329532,7,119200,149000,97.0,4196,2023-04-30T19:45,0,119200
97,2991502,8,299000,435000,0.0,0,2023-04-30T19:45,-30000,269000
98,1776552,9,59000,69000,94.0,6336,2023-04-30T19:45,-8850,50150
99,2991501,10,299000,435000,90.0,2,2023-04-30T19:45,-30000,269000
100,1571879,11,79900,112900,96.0,7334,2023-04-30T19:45,0,79900
101,1856181,12,35910,39900,97.0,8875,2023-04-30T19:45,-7182,28728
102,1790383,13,54700,86000,95.0,6044,2023-04-30T19:45,-8205,46495
103,3042939,14,75900,95000,93.0,47,2023-04-30T19:45,-22770,53130
104,3012082,15,59900,79000,96.0,1376,2023-04-30T19:45,0,59900
105,3046899,16,79900,105000,96.0,181,2023-04-30T19:45,-23970,55930
106,3100493,17,139000,0,97.0,106,2023-04-30T19:45,0,139000
107,2732486,18,99000,179000,98.0,893,2023-04-30T19:45,0,99000
108,1778408,19,39000,45000,95.0,12067,2023-04-30T19:45,-5850,33150
109,1283757,20,71290,83900,96.0,27025,2023-04-30T19:45,0,71290
110,1530516,21,69900,79000,96.0,2567,2023-04-30T19:45,0,69900
111,1737051,22,62300,89000,96.0,5235,2023-04-30T19:45,-12460,49840
112,1969617,23,162000,0,96.0,2728,2023-04-30T19:45,0,162000
113,1530517,24,69900,79000,96.0,2289,2023-04-30T19:45,0,69900
114,2329533,25,119200,149000,97.0,1451,2023-04-30T19:45,0,119200
115,1139192,26,66400,94900,97.0,14596,2023-04-30T19:45,-9960,56440
116,1618312,27,83900,0,97.0,7361,2023-04-30T19:45,-8390,75510
117,1108007,28,67890,79900,95.0,48081,2023-04-30T19:45,0,67890
118,3186581,29,126650,149000,100.0,2,2023-04-30T19:45,-12665,113985
119,1576700,30,89000,129000,97.0,17245,2023-04-30T19:45,-13350,75650
120,3054935,31,89900,0,96.0,132,2023-04-30T19:45,0,89900
121,3029811,32,63200,79000,96.0,365,2023-04-30T19:45,-12640,50560
122,946995,33,106250,125000,94.0,2920,2023-04-30T19:45,-15938,90312
123,2471405,34,89000,138000,97.0,2285,2023-04-30T19:45,-8900,80100
124,3247941,35,134100,149000,0.0,0,2023-04-30T19:45,-20115,113985
125,2980968,36,2016000,3390000,0.0,0,2023-04-30T19:45,0,2016000
126,2991491,37,299000,425000,93.0,6,2023-04-30T19:45,-30000,269000
127,3033224,38,59900,74000,97.0,960,2023-04-30T19:45,0,59900
128,3157691,39,209000,0,98.0,17,2023-04-30T19:45,-41800,167200
129,1776549,40,59000,69000,94.0,4679,2023-04-30T19:45,-8850,50150
130,2444808,41,75490,83900,97.0,758,2023-04-30T19:45,0,75490
131,3125136,42,119000,0,60.0,2,2023-04-30T19:45,-11900,107100
132,1776365,43,53400,89000,96.0,4734,2023-04-30T19:45,-8010,45390
133,3092775,44,139900,0,100.0,10,2023-04-30T19:45,-20985,118915
134,2064545,45,59800,94000,97.0,11534,2023-04-30T19:45,-2990,56810
135,1291017,46,67900,96000,95.0,13250,2023-04-30T19:45,0,67900
136,2343198,47,119000,129000,97.0,5419,2023-04-30T19:45,-17850,101150
137,3091295,48,169000,0,95.0,42,2023-04-30T19:45,-50700,118300
138,2795301,49,1580000,2300000,100.0,2,2023-04-30T19:45,-30000,1550000
139,2752332,50,84200,105300,95.0,2770,2023-04-30T19:45,-12630,71570
140,2159724,51,29900,32000,95.0,2531,2023-04-30T19:45,0,29900
141,3125671,52,148000,0,98.0,39,2023-04-30T19:45,0,148000
142,3037473,53,69900,85900,95.0,434,2023-04-30T19:45,-10485,59415
143,2839961,54,1510000,0,0.0,0,2023-04-30T19:45,0,1510000
144,3092774,55,139900,0,97.0,27,2023-04-30T19:45,-20985,118915
145,1571878,56,79900,112900,96.0,4918,2023-04-30T19:45,0,79900
146,3075584,57,159900,249000,90.0,2,2023-04-30T19:45,-47970,111930
147,1558683,58,69590,81900,97.0,6406,2023-04-30T19:45,0,69590
148,1195307,59,87550,103000,96.0,12852,2023-04-30T19:45,-13133,74417
149,2991494,60,309000,435000,100.0,1,2023-04-30T19:45,-30000,279000
150,3055246,61,159000,0,97.0,104,2023-04-30T19:45,0,159000
151,3047188,62,109650,129000,99.0,73,2023-04-30T19:45,0,109650
152,1751722,63,53910,59900,97.0,3604,2023-04-30T19:45,-10782,43128
153,2788216,64,146000,159000,98.0,225,2023-04-30T19:45,-21900,124100
154,2683549,65,111750,149000,97.0,2675,2023-04-30T19:45,0,111750
155,2837409,66,162000,0,96.0,55,2023-04-30T19:45,0,162000
156,2375909,67,76390,89900,98.0,1709,2023-04-30T19:45,0,76390
157,2343199,68,119000,129000,98.0,1984,2023-04-30T19:45,-17850,101150
158,2999864,69,64500,129000,99.0,81,2023-04-30T19:45,-9675,54825
159,3196693,70,179000,0,96.0,10,2023-04-30T19:45,0,179000
160,1593755,71,89300,111700,97.0,14584,2023-04-30T19:45,-13395,75905
161,3051559,72,39000,93000,96.0,54,2023-04-30T19:45,-5850,33150
162,2723216,73,52000,85900,97.0,1307,2023-04-30T19:45,0,52000
163,3037477,74,69900,85900,97.0,381,2023-04-30T19:45,-10485,59415
164,3048143,75,109200,182000,96.0,627,2023-04-30T19:45,-16380,92820
165,2712632,76,107000,0,97.0,1434,2023-04-30T19:45,0,107000
166,2381781,77,186750,249000,98.0,883,2023-04-30T19:45,0,186750
167,1882525,78,139000,0,98.0,1925,2023-04-30T19:45,0,139000
168,1776550,79,59000,69000,94.0,4234,2023-04-30T19:45,-8850,50150
169,1280576,80,39900,62000,96.0,25487,2023-04-30T19:45,-5985,33915
170,3100547,81,129000,0,99.0,33,2023-04-30T19:45,0,129000
171,3042934,82,109900,139000,99.0,30,2023-04-30T19:45,-32970,76930
172,3048144,83,109200,182000,96.0,288,2023-04-30T19:45,-16380,92820
173,965917,84,63890,79900,95.0,13159,2023-04-30T19:45,0,63890
174,3051261,85,53400,89000,97.0,186,2023-04-30T19:45,-10680,42720
175,1567183,86,71175,94900,97.0,7582,2023-04-30T19:45,-10677,60498
176,3234833,87,89900,105000,0.0,0,2023-04-30T19:45,-26970,62930
177,1620285,88,299000,0,97.0,196,2023-04-30T19:45,0,299000
178,1737049,89,62300,89000,96.0,2108,2023-04-30T19:45,-12460,49840
179,3029809,90,63200,79000,98.0,180,2023-04-30T19:45,-12640,50560
180,2112059,1,36400,52000,97.0,44759,2023-04-30T19:45,-5460,30940
181,1924274,2,49900,66000,95.0,23005,2023-04-30T19:45,-4990,44910
182,750908,3,34900,54000,96.0,85391,2023-04-30T19:45,-3490,31410
183,3141395,4,49900,73900,96.0,354,2023-04-30T19:45,0,49900
184,2092852,5,31300,52800,96.0,11853,2023-04-30T19:45,0,31300
185,2060719,6,55200,69000,96.0,5795,2023-04-30T19:45,-5520,49680
186,2060717,7,55200,69000,95.0,4227,2023-04-30T19:45,-5520,49680
187,1926048,8,32000,0,97.0,15394,2023-04-30T19:45,-1600,30400
188,1149329,9,39900,0,96.0,87361,2023-04-30T19:45,0,39900
189,1551840,10,39000,0,97.0,85552,2023-04-30T19:45,0,39000
190,2060720,11,55200,69000,96.0,2819,2023-04-30T19:45,-5520,49680
191,2028327,12,42390,49900,96.0,9651,2023-04-30T19:45,0,42390
192,1168906,13,35590,41900,97.0,72355,2023-04-30T19:45,0,35590
193,2112061,14,36400,52000,97.0,15578,2023-04-30T19:45,-5460,30940
194,1370101,15,39000,89000,96.0,23972,2023-04-30T19:45,-1950,37050
195,2569078,16,59250,79000,96.0,2619,2023-04-30T19:45,-8888,50362
196,1149328,17,35890,39900,96.0,95125,2023-04-30T19:45,0,35890
197,858911,18,39000,49000,95.0,67621,2023-04-30T19:45,-5850,33150
198,2358429,19,119250,159000,98.0,2813,2023-04-30T19:45,-11925,107325
199,3154699,20,49800,63000,97.0,259,2023-04-30T19:45,0,49800
200,2129180,21,76300,109000,96.0,454,2023-04-30T19:45,-7630,68670
201,2789111,22,79200,99000,97.0,1123,2023-04-30T19:45,-11880,67320
202,1885631,23,39000,49000,96.0,24034,2023-04-30T19:45,-5850,33150
203,1568057,24,49600,62000,96.0,23033,2023-04-30T19:45,-7440,42160
204,1627892,25,43900,0,97.0,11745,2023-04-30T19:45,0,43900
205,2495075,26,49800,72000,95.0,12443,2023-04-30T19:45,-4980,44820
206,2060759,27,59800,74800,97.0,7579,2023-04-30T19:45,-5980,53820
207,2789091,28,79200,99000,97.0,1112,2023-04-30T19:45,-11880,67320
208,2150457,29,119250,159000,97.0,4226,2023-04-30T19:45,-17888,101362
209,1440874,30,39900,0,95.0,15360,2023-04-30T19:45,0,39900
210,2351467,31,29000,54000,96.0,6936,2023-04-30T19:45,0,29000
211,2723714,32,46400,58000,96.0,1943,2023-04-30T19:45,0,46400
212,1436504,33,41900,0,96.0,9424,2023-04-30T19:45,0,41900
213,3043508,34,71200,89000,97.0,386,2023-04-30T19:45,0,71200
214,3046898,35,59630,89000,96.0,89,2023-04-30T19:45,-17889,41741
215,2704218,36,107000,126000,97.0,194,2023-04-30T19:45,-16050,90950
216,2503133,37,31300,52800,96.0,3261,2023-04-30T19:45,0,31300
217,1539028,38,56070,89000,95.0,4816,2023-04-30T19:45,-16821,39249
218,1551839,39,39000,0,97.0,24417,2023-04-30T19:45,0,39000
219,2060743,40,33000,55000,95.0,3831,2023-04-30T19:45,-3300,29700
220,1222184,41,37690,41900,97.0,49009,2023-04-30T19:45,0,37690
221,3252638,42,59800,86000,96.0,22,2023-04-30T19:45,-5980,53820
222,1552753,43,70200,78000,97.0,28523,2023-04-30T19:45,-10530,59670
223,2725611,44,89600,128000,98.0,2371,2023-04-30T19:45,-13440,76160
224,2028326,45,49900,0,97.0,6649,2023-04-30T19:45,0,49900
225,883004,46,69900,89000,94.0,9578,2023-04-30T19:45,0,69900
226,1323090,47,73600,92000,96.0,6222,2023-04-30T19:45,-11040,62560
227,1555407,48,70200,78000,97.0,11905,2023-04-30T19:45,-10530,59670
228,1985223,49,39000,89000,96.0,1842,2023-04-30T19:45,-1950,37050
229,3091296,50,129000,0,96.0,124,2023-04-30T19:45,-38700,90300
230,2749153,51,66600,74000,97.0,721,2023-04-30T19:45,0,66600
231,1854665,52,139000,0,97.0,1167,2023-04-30T19:45,0,139000
232,1736085,53,43900,59800,96.0,37799,2023-04-30T19:45,0,43900
233,3220911,54,89000,129000,97.0,312,2023-04-30T19:45,0,89000
234,2092849,55,42000,52800,96.0,10053,2023-04-30T19:45,-4200,37800
235,3086712,56,41900,85000,96.0,189,2023-04-30T19:45,-4190,37710
236,3154697,57,49800,63000,96.0,202,2023-04-30T19:45,0,49800
237,2578996,58,27900,59000,95.0,4913,2023-04-30T19:45,0,27900
238,1926034,59,32000,0,97.0,3301,2023-04-30T19:45,-1600,30400
239,2562527,60,29400,42000,97.0,4409,2023-04-30T19:45,-5880,23520
240,1753533,61,59900,105000,95.0,3306,2023-04-30T19:45,-17970,41930
241,1826978,62,79000,0,96.0,7108,2023-04-30T19:45,-11850,67150
242,2706287,63,39800,54000,95.0,4446,2023-04-30T19:45,-5970,33830
243,2107115,64,98500,135000,98.0,11890,2023-04-30T19:45,-14775,83725
244,1436218,65,39900,68000,95.0,20013,2023-04-30T19:45,0,39900
245,2678399,66,33900,69000,96.0,1035,2023-04-30T19:45,-10170,23730
246,2184087,67,47200,89000,96.0,4361,2023-04-30T19:45,-2360,44840
247,1885345,68,29700,45000,97.0,2031,2023-04-30T19:45,-8910,20790
248,3240542,69,71200,89000,100.0,17,2023-04-30T19:45,0,71200
249,2032901,70,35890,39900,97.0,7173,2023-04-30T19:45,0,35890
250,2261213,71,98550,135000,98.0,4222,2023-04-30T19:45,-14783,83767
251,3124490,72,26550,53000,93.0,140,2023-04-30T19:45,0,26550
252,1477272,73,44200,68000,96.0,18205,2023-04-30T19:45,-2210,41990
253,3129953,74,29800,49800,98.0,50,2023-04-30T19:45,0,29800
254,1778523,75,39000,49000,96.0,3580,2023-04-30T19:45,-5850,33150
255,2574822,76,22900,27800,96.0,1930,2023-04-30T19:45,0,22900
256,1350363,77,53600,68000,97.0,1340,2023-04-30T19:45,0,53600
257,1885563,78,39000,49000,95.0,4649,2023-04-30T19:45,-5850,33150
258,890338,79,39000,49000,95.0,48107,2023-04-30T19:45,-5850,33150
259,3044076,80,80100,89000,97.0,73,2023-04-30T19:45,-12015,68085
260,3062147,81,119200,149000,98.0,127,2023-04-30T19:45,0,119200
261,2569079,82,59250,79000,96.0,1242,2023-04-30T19:45,-8888,50362
262,2592084,83,39900,59000,96.0,671,2023-04-30T19:45,-3990,35910
263,1317598,84,39000,0,97.0,5582,2023-04-30T19:45,-3900,35100
264,2708877,85,39800,49800,95.0,1129,2023-04-30T19:45,-3980,35820
265,1322221,86,42390,49900,96.0,10504,2023-04-30T19:45,0,42390
266,2965641,87,89100,99000,97.0,152,2023-04-30T19:45,0,89100
267,1666442,88,49900,0,97.0,11179,2023-04-30T19:45,0,49900
268,2817384,89,69300,99000,98.0,246,2023-04-30T19:45,-6930,62370
269,3034871,90,88200,126000,97.0,246,2023-04-30T19:45,0,88200
270,1789507,1,71100,79000,98.0,26480,2023-04-30T19:45,0,71100
271,2657250,2,125400,149000,98.0,174,2023-04-30T19:45,0,125400
272,1034480,3,135000,150000,97.0,18385,2023-04-30T19:45,0,135000
273,1969507,4,88000,0,98.0,5648,2023-04-30T19:45,0,88000
274,2633416,5,3159000,0,0.0,0,2023-04-30T19:45,-20000,3139000
275,2800608,6,1324350,2671000,100.0,4,2023-04-30T19:45,0,1324350
276,1835080,7,98000,0,97.0,2981,2023-04-30T19:45,0,98000
277,2911057,8,1839000,3820000,0.0,0,2023-04-30T19:45,0,1839000
278,2980956,9,2799000,3500000,100.0,1,2023-04-30T19:45,-30000,2769000
279,3034751,10,64800,72000,96.0,770,2023-04-30T19:45,0,64800
280,3101111,11,161100,179000,95.0,69,2023-04-30T19:45,0,161100
281,2934103,12,2360000,3645000,0.0,0,2023-04-30T19:45,-30000,2330000
282,3047568,13,99330,129000,96.0,136,2023-04-30T19:45,0,99330
283,2271789,14,71100,79000,97.0,2655,2023-04-30T19:45,0,71100
284,3174246,15,298000,485000,0.0,0,2023-04-30T19:45,-30000,268000
285,1323612,16,238000,0,97.0,3887,2023-04-30T19:45,-35700,202300
286,1264107,17,62000,90000,97.0,6603,2023-04-30T19:45,-9300,52700
287,3048786,18,1458000,3050000,93.0,3,2023-04-30T19:45,-30000,1428000
288,2393864,19,1950000,3130000,100.0,1,2023-04-30T19:45,-30000,1920000
289,3034745,20,75600,84000,98.0,260,2023-04-30T19:45,0,75600
290,3024801,21,138000,0,98.0,39,2023-04-30T19:45,0,138000
291,2979849,22,1872000,2370000,88.0,10,2023-04-30T19:45,-30000,1842000
292,1969488,23,88000,0,98.0,1858,2023-04-30T19:45,0,88000
293,2066837,24,69000,119000,97.0,6730,2023-04-30T19:45,-10350,58650
294,2770508,25,138000,0,97.0,386,2023-04-30T19:45,0,138000
295,2344538,26,119000,0,98.0,6650,2023-04-30T19:45,0,119000
296,2530385,27,1759000,3090000,0.0,0,2023-04-30T19:45,-30000,1729000
297,2320927,28,39000,51000,97.0,2459,2023-04-30T19:45,0,39000
298,2514819,29,54000,66000,97.0,955,2023-04-30T19:45,0,54000
299,2849890,30,1599000,2550000,100.0,3,2023-04-30T19:45,-30000,1569000
300,2654166,31,82000,108000,95.0,191,2023-04-30T19:45,-12300,69700
301,2995683,32,1599000,2450000,0.0,0,2023-04-30T19:45,-30000,1569000
302,1581689,33,75600,89000,97.0,4159,2023-04-30T19:45,0,75600
303,2408213,34,89000,0,96.0,162,2023-04-30T19:45,0,89000
304,2702033,35,127200,159000,97.0,468,2023-04-30T19:45,0,127200
305,2633431,36,1556000,0,0.0,0,2023-04-30T19:45,-20000,1536000
306,2584181,37,57600,72000,99.0,1292,2023-04-30T19:45,0,57600
307,2630526,38,100000,0,96.0,743,2023-04-30T19:45,0,100000
308,2673886,39,1399000,2360000,96.0,5,2023-04-30T19:45,-30000,1369000
309,1744101,40,103500,109000,98.0,2983,2023-04-30T19:45,0,103500
310,2343664,41,89000,0,97.0,1357,2023-04-30T19:45,0,89000
311,2954961,42,95000,0,96.0,403,2023-04-30T19:45,0,95000
312,1528287,43,46500,49000,96.0,4807,2023-04-30T19:45,0,46500
313,3029920,44,275000,0,98.0,54,2023-04-30T19:45,0,275000
314,342189,45,39500,52000,95.0,15969,2023-04-30T19:45,0,39500
315,2992113,46,699000,955000,0.0,0,2023-04-30T19:45,-30000,669000
316,2344540,47,96000,0,98.0,9568,2023-04-30T19:45,0,96000
317,1564343,48,92800,119000,98.0,8218,2023-04-30T19:45,-13920,78880
318,1842449,49,84000,99000,97.0,5577,2023-04-30T19:45,-12600,71400
319,2567009,50,1299000,1713000,80.0,1,2023-04-30T19:45,-30000,1269000
320,3045584,51,130500,145000,97.0,3816,2023-04-30T19:45,0,130500
321,2754080,52,88000,0,97.0,552,2023-04-30T19:45,0,88000
322,3070516,53,138000,0,98.0,60,2023-04-30T19:45,0,138000
323,3144722,54,1250000,2200000,0.0,0,2023-04-30T19:45,0,1250000
324,2537628,55,388000,0,98.0,40,2023-04-30T19:45,-77600,310400
325,2980951,56,599000,870000,0.0,0,2023-04-30T19:45,-30000,569000
326,3034749,57,64800,72000,97.0,591,2023-04-30T19:45,0,64800
327,2930265,58,91000,0,98.0,710,2023-04-30T19:45,0,91000
328,2112607,59,178000,0,97.0,386,2023-04-30T19:45,0,178000
329,2795064,60,178000,0,96.0,50,2023-04-30T19:45,0,178000
330,2888946,61,79000,0,98.0,221,2023-04-30T19:45,0,79000
331,2757112,62,359000,0,93.0,113,2023-04-30T19:45,-71800,287200
332,2979839,63,1115000,1490000,0.0,0,2023-04-30T19:45,0,1115000
333,2451428,64,1471000,2995000,100.0,5,2023-04-30T19:45,-20000,1451000
334,2979846,65,1458000,2820000,0.0,0,2023-04-30T19:45,0,1458000
335,2110431,66,129000,0,95.0,36,2023-04-30T19:45,0,129000
336,1564368,67,69000,129000,96.0,66,2023-04-30T19:45,-10350,58650
337,2940844,68,1422000,2750000,80.0,2,2023-04-30T19:45,-30000,1392000
338,2425732,69,1447000,2950000,0.0,0,2023-04-30T19:45,-20000,1427000
339,2914916,70,369000,439000,97.0,15,2023-04-30T19:45,0,369000
340,1447194,71,59900,230000,96.0,3005,2023-04-30T19:45,-2995,56905
341,1964770,72,59400,66000,97.0,2582,2023-04-30T19:45,-8910,50490
342,2777025,73,335000,485000,100.0,64,2023-04-30T19:45,-30000,305000
343,3038000,74,74700,83000,96.0,578,2023-04-30T19:45,0,74700
344,1263004,75,159000,0,97.0,5306,2023-04-30T19:45,0,159000
345,3082387,76,139000,0,97.0,173,2023-04-30T19:45,-13900,125100
346,2422175,77,145800,162000,98.0,246,2023-04-30T19:45,-21870,123930
347,3011494,78,69900,79000,95.0,303,2023-04-30T19:45,0,69900
348,2105328,79,55300,79000,97.0,593,2023-04-30T19:45,-8295,47005
349,1745100,80,103500,109000,97.0,1063,2023-04-30T19:45,0,103500
350,3029922,81,295000,0,97.0,125,2023-04-30T19:45,0,295000
351,3042852,82,139000,0,95.0,31,2023-04-30T19:45,0,139000
352,2929152,83,719000,1671000,100.0,4,2023-04-30T19:45,-30000,689000
353,3029926,84,285000,0,99.0,80,2023-04-30T19:45,0,285000
354,2614124,85,98000,0,97.0,289,2023-04-30T19:45,0,98000
355,1534526,86,52200,55000,97.0,2579,2023-04-30T19:45,0,52200
356,2279619,87,80100,89000,97.0,505,2023-04-30T19:45,0,80100
357,2343665,88,89000,0,97.0,4793,2023-04-30T19:45,0,89000
358,3030006,89,475000,0,100.0,25,2023-04-30T19:45,0,475000
359,2975285,90,55250,65000,98.0,429,2023-04-30T19:45,0,55250
360,1622069,1,119000,0,98.0,6062,2023-04-30T19:45,0,119000
361,2638067,2,99000,139000,97.0,3426,2023-04-30T19:45,-29700,69300
362,3030422,3,117900,139000,97.0,1007,2023-04-30T19:45,-35370,82530
363,577636,4,97300,139000,95.0,31417,2023-04-30T19:45,-29190,68110
364,1762407,5,260000,0,97.0,3592,2023-04-30T19:45,0,260000
365,2545799,6,149000,0,98.0,2467,2023-04-30T19:45,0,149000
366,2861393,7,96900,139000,93.0,331,2023-04-30T19:45,-29070,67830
367,1762406,8,260000,0,98.0,3574,2023-04-30T19:45,0,260000
368,2609128,9,69900,139000,94.0,243,2023-04-30T19:45,-20970,48930
369,3091287,10,119000,0,98.0,450,2023-04-30T19:45,0,119000
370,810034,11,85500,95000,97.0,45573,2023-04-30T19:45,0,85500
371,2861392,12,96900,139000,97.0,668,2023-04-30T19:45,-29070,67830
372,969541,13,69000,0,97.0,30651,2023-04-30T19:45,0,69000
373,3072688,14,115900,129000,100.0,16,2023-04-30T19:45,-34770,81130
374,1622068,15,119000,0,97.0,6993,2023-04-30T19:45,0,119000
375,2293400,16,129000,0,96.0,1153,2023-04-30T19:45,0,129000
376,490136,17,56900,95000,98.0,2878,2023-04-30T19:45,0,56900
377,2822681,18,79900,129000,96.0,180,2023-04-30T19:45,-23970,55930
378,2996167,19,96900,139000,97.0,213,2023-04-30T19:45,-29070,67830
379,3026310,20,99000,0,99.0,1081,2023-04-30T19:45,0,99000
380,2565212,21,119000,0,99.0,486,2023-04-30T19:45,0,119000
381,2785168,22,179000,0,99.0,102,2023-04-30T19:45,0,179000
382,181907,23,79900,119000,97.0,7342,2023-04-30T19:45,0,79900
383,3109771,24,133900,149000,98.0,62,2023-04-30T19:45,-40170,93730
384,311052,25,53100,59000,97.0,41646,2023-04-30T19:45,0,53100
385,3033084,26,129000,0,99.0,91,2023-04-30T19:45,0,129000
386,490135,27,59900,95000,98.0,3594,2023-04-30T19:45,0,59900
387,2383963,28,139000,0,96.0,194,2023-04-30T19:45,0,139000
388,695334,29,63900,99000,96.0,9696,2023-04-30T19:45,0,63900
389,165988,30,33900,69000,96.0,4876,2023-04-30T19:45,0,33900
390,186610,31,75900,85000,97.0,16860,2023-04-30T19:45,0,75900
391,2577087,32,89900,139000,97.0,465,2023-04-30T19:45,-26970,62930
392,2161992,33,55900,95000,97.0,3634,2023-04-30T19:45,0,55900
393,816033,34,57900,89000,96.0,13548,2023-04-30T19:45,0,57900
394,2849854,35,349000,1100000,88.0,5,2023-04-30T19:45,-30000,319000
395,3033248,36,109000,0,97.0,801,2023-04-30T19:45,-10900,98100
396,2233180,37,75900,109000,97.0,14635,2023-04-30T19:45,0,75900
397,2703013,38,75900,129000,96.0,44,2023-04-30T19:45,-22770,53130
398,810032,39,85500,95000,97.0,13864,2023-04-30T19:45,0,85500
399,2320478,40,129000,0,97.0,611,2023-04-30T19:45,0,129000
400,2992068,41,99900,129000,98.0,125,2023-04-30T19:45,-29970,69930
401,2899663,42,69900,159000,95.0,75,2023-04-30T19:45,-20970,48930
402,1473136,43,79900,149000,97.0,10847,2023-04-30T19:45,0,79900
403,1493265,44,85500,95000,98.0,5057,2023-04-30T19:45,0,85500
404,2686987,45,129000,0,97.0,249,2023-04-30T19:45,0,129000
405,1955217,46,69000,109000,96.0,5395,2023-04-30T19:45,-10350,58650
406,716244,47,59900,95000,98.0,1433,2023-04-30T19:45,0,59900
407,2992069,48,96900,139000,96.0,231,2023-04-30T19:45,-29070,67830
408,2861395,49,96900,139000,96.0,600,2023-04-30T19:45,-29070,67830
409,1492897,50,55900,75000,96.0,3294,2023-04-30T19:45,0,55900
410,2815897,51,59950,109000,94.0,122,2023-04-30T19:45,-17985,41965
411,3024528,52,132050,139000,96.0,128,2023-04-30T19:45,0,132050
412,2861396,53,89900,139000,94.0,94,2023-04-30T19:45,-26970,62930
413,2731878,54,44900,79000,97.0,2057,2023-04-30T19:45,0,44900
414,2855992,55,159000,0,97.0,692,2023-04-30T19:45,0,159000
415,2622254,56,109000,0,98.0,1016,2023-04-30T19:45,0,109000
416,3091288,57,119000,0,99.0,85,2023-04-30T19:45,0,119000
417,2737457,58,230000,0,98.0,525,2023-04-30T19:45,0,230000
418,1296778,59,99000,0,98.0,2246,2023-04-30T19:45,0,99000
419,2670201,60,39900,109000,97.0,1148,2023-04-30T19:45,0,39900
420,2741233,61,109000,0,97.0,2910,2023-04-30T19:45,-10900,98100
421,2861394,62,89900,139000,97.0,82,2023-04-30T19:45,-26970,62930
422,810033,63,89100,99000,97.0,34443,2023-04-30T19:45,0,89100
423,1231944,64,119000,0,97.0,1459,2023-04-30T19:45,0,119000
424,3072685,65,106900,119000,97.0,54,2023-04-30T19:45,-32070,74830
425,1478592,66,75900,95000,97.0,3234,2023-04-30T19:45,0,75900
426,3167965,67,119000,0,96.0,13,2023-04-30T19:45,0,119000
427,2524840,68,139000,0,97.0,941,2023-04-30T19:45,0,139000
428,102618,69,69000,0,97.0,6232,2023-04-30T19:45,0,69000
429,1900410,70,129000,0,97.0,5015,2023-04-30T19:45,0,129000
430,1608838,71,85000,0,97.0,12735,2023-04-30T19:45,0,85000
431,2957146,72,39900,89000,95.0,55,2023-04-30T19:45,-11970,27930
432,3138474,73,106900,119000,98.0,38,2023-04-30T19:45,-32070,74830
433,2996166,74,55900,129000,98.0,49,2023-04-30T19:45,-16770,39130
434,1469860,75,51900,75000,97.0,6871,2023-04-30T19:45,0,51900
435,2886127,76,257000,595000,98.0,13,2023-04-30T19:45,-30000,227000
436,104240,77,33900,69000,96.0,3954,2023-04-30T19:45,0,33900
437,3091289,78,119000,0,98.0,97,2023-04-30T19:45,0,119000
438,2261769,79,42900,119000,95.0,1409,2023-04-30T19:45,0,42900
439,311050,80,53100,59000,97.0,9178,2023-04-30T19:45,0,53100
440,3200836,81,179000,0,98.0,84,2023-04-30T19:45,0,179000
441,3188621,82,119000,0,100.0,8,2023-04-30T19:45,0,119000
442,1107127,83,69900,149000,97.0,4626,2023-04-30T19:45,0,69900
443,2493214,84,169000,0,97.0,241,2023-04-30T19:45,0,169000
444,1853613,85,130000,0,96.0,125,2023-04-30T19:45,0,130000
445,2801307,86,399000,700000,98.0,72,2023-04-30T19:45,-30000,369000
446,1470186,87,49900,75000,97.0,3023,2023-04-30T19:45,0,49900
447,1493263,88,89100,99000,98.0,4324,2023-04-30T19:45,0,89100
448,3096431,89,139000,0,98.0,86,2023-04-30T19:45,0,139000
449,1494180,90,71100,79000,95.0,5357,2023-04-30T19:45,0,71100
450,2624538,1,34810,59000,97.0,1731,2023-04-30T19:45,-10443,24367
451,1720813,2,149000,0,97.0,549,2023-04-30T19:45,0,149000
452,1092992,3,69000,0,97.0,38726,2023-04-30T19:45,0,69000
453,3062046,4,78300,87000,97.0,387,2023-04-30T19:45,-11745,66555
454,1339622,5,42900,59000,97.0,16584,2023-04-30T19:45,-12870,30030
455,1720822,6,209000,0,97.0,340,2023-04-30T19:45,-12540,196460
456,2432733,7,40120,59000,97.0,3065,2023-04-30T19:45,-12036,28084
457,2237841,8,195000,0,98.0,75,2023-04-30T19:45,-11700,183300
458,3061996,9,88200,98000,97.0,271,2023-04-30T19:45,-13230,74970
459,3124961,10,65550,69000,97.0,486,2023-04-30T19:45,-9833,55717
460,3134621,11,136800,152000,97.0,96,2023-04-30T19:45,-20520,116280
461,3134606,12,125100,139000,97.0,110,2023-04-30T19:45,-18765,106335
462,2957149,13,44900,59000,99.0,85,2023-04-30T19:45,-13470,31430
463,3062069,14,71100,79000,96.0,129,2023-04-30T19:45,-10665,60435
464,1334438,15,170000,0,96.0,4475,2023-04-30T19:45,0,170000
465,2419871,16,40120,59000,97.0,1017,2023-04-30T19:45,-12036,28084
466,2383245,17,99000,0,98.0,952,2023-04-30T19:45,0,99000
467,3008041,18,44900,59000,98.0,262,2023-04-30T19:45,-13470,31430
468,2668514,19,500000,842000,100.0,49,2023-04-30T19:45,-30000,470000
469,595039,20,210000,0,97.0,3575,2023-04-30T19:45,0,210000
470,1828166,21,126000,210000,94.0,867,2023-04-30T19:45,0,126000
471,1834405,22,39900,55000,96.0,2736,2023-04-30T19:45,-11970,27930
472,2633381,23,992000,0,100.0,1,2023-04-30T19:45,0,992000
473,2816812,24,119900,0,93.0,1606,2023-04-30T19:45,0,119900
474,1568047,25,127200,159000,95.0,12102,2023-04-30T19:45,-19080,108120
475,595040,26,210000,0,95.0,8780,2023-04-30T19:45,0,210000
476,2621831,27,64400,92000,95.0,817,2023-04-30T19:45,-9660,54740
477,3133873,28,143650,169000,0.0,0,2023-04-30T19:45,0,143650
478,3161736,29,67900,158000,98.0,383,2023-04-30T19:45,-10185,57715
479,2093156,30,259000,0,92.0,29,2023-04-30T19:45,0,259000
480,3134563,31,88200,98000,95.0,54,2023-04-30T19:45,-13230,74970
481,2091749,32,75650,89000,95.0,6436,2023-04-30T19:45,0,75650
482,3049313,33,57100,64900,97.0,904,2023-04-30T19:45,0,57100
483,3224811,34,138000,0,96.0,11,2023-04-30T19:45,0,138000
484,2686298,35,645000,980000,0.0,0,2023-04-30T19:45,-20000,625000
485,2736221,36,99000,110000,96.0,328,2023-04-30T19:45,0,99000
486,2664372,37,65000,0,97.0,1188,2023-04-30T19:45,0,65000
487,2101924,38,99900,0,96.0,1444,2023-04-30T19:45,0,99900
488,1439535,39,49000,0,96.0,16431,2023-04-30T19:45,0,49000
489,3188391,40,107100,170000,96.0,5,2023-04-30T19:45,0,107100
490,1891201,41,155000,0,98.0,247,2023-04-30T19:45,-9300,145700
491,1010925,42,170000,0,96.0,2094,2023-04-30T19:45,0,170000
492,2820616,43,1160000,0,100.0,3,2023-04-30T19:45,0,1160000
493,1724193,44,251900,280000,98.0,1506,2023-04-30T19:45,0,251900
494,2818508,45,196000,280000,97.0,78,2023-04-30T19:45,0,196000
495,2379000,46,151500,159000,97.0,149,2023-04-30T19:45,0,151500
496,1810758,47,144000,160000,96.0,378,2023-04-30T19:45,0,144000
497,3167199,48,174250,205000,100.0,3,2023-04-30T19:45,0,174250
498,1334440,49,102000,170000,96.0,2079,2023-04-30T19:45,0,102000
499,2684750,50,243000,270000,96.0,17,2023-04-30T19:45,0,243000
500,3218310,51,141550,149000,100.0,4,2023-04-30T19:45,-8493,133057
501,1262089,52,300000,0,97.0,1601,2023-04-30T19:45,0,300000
502,2698593,53,1010000,0,0.0,0,2023-04-30T19:45,0,1010000
503,2633477,54,992000,0,0.0,0,2023-04-30T19:45,0,992000
504,2910082,55,265500,295000,98.0,536,2023-04-30T19:45,0,265500
505,3104658,56,153000,170000,97.0,17,2023-04-30T19:45,0,153000
506,2750309,57,40120,59000,98.0,475,2023-04-30T19:45,0,40120
507,685185,58,139000,198000,95.0,12534,2023-04-30T19:45,-20850,118150
508,2664373,59,65000,0,97.0,1154,2023-04-30T19:45,0,65000
509,1010923,60,171000,190000,95.0,379,2023-04-30T19:45,0,171000
510,1129750,61,69000,0,97.0,4022,2023-04-30T19:45,0,69000
511,1021359,62,61000,100000,94.0,5425,2023-04-30T19:45,-9150,51850
512,1419869,63,70300,74000,95.0,10614,2023-04-30T19:45,-10545,59755
513,1813898,64,219000,0,97.0,41,2023-04-30T19:45,0,219000
514,1810760,65,135000,150000,96.0,212,2023-04-30T19:45,0,135000
515,785345,66,210000,0,97.0,185,2023-04-30T19:45,0,210000
516,1562990,67,230000,0,96.0,1298,2023-04-30T19:45,0,230000
517,2716424,68,198000,0,97.0,308,2023-04-30T19:45,0,198000
518,1439527,69,49000,0,95.0,13477,2023-04-30T19:45,0,49000
519,1897197,70,53100,59000,96.0,1034,2023-04-30T19:45,-7965,45135
520,2818506,71,168000,280000,95.0,141,2023-04-30T19:45,0,168000
521,3142573,72,189000,0,88.0,7,2023-04-30T19:45,0,189000
522,2143833,73,89640,108000,96.0,2479,2023-04-30T19:45,0,89640
523,3024585,74,59000,0,97.0,195,2023-04-30T19:45,-8850,50150
524,3218308,75,185250,195000,0.0,0,2023-04-30T19:45,-11115,174135
525,127121,76,141000,152000,95.0,1889,2023-04-30T19:45,-21150,119850
526,3223186,77,119000,0,100.0,7,2023-04-30T19:45,0,119000
527,1890398,78,132000,168000,96.0,2811,2023-04-30T19:45,-13200,118800
528,1438359,79,99000,0,97.0,1237,2023-04-30T19:45,0,99000
529,2378989,80,159000,0,93.0,65,2023-04-30T19:45,0,159000
530,636821,81,160500,169000,93.0,2599,2023-04-30T19:45,-24075,136425
531,501198,82,132000,139000,95.0,2785,2023-04-30T19:45,-6600,125400
532,3218328,83,265050,279000,0.0,0,2023-04-30T19:45,-15903,249147
533,1891202,84,165000,0,98.0,113,2023-04-30T19:45,-9900,155100
534,2036670,85,300000,0,97.0,781,2023-04-30T19:45,0,300000
535,3103381,86,65000,0,96.0,85,2023-04-30T19:45,0,65000
536,2919224,87,670000,1000000,0.0,0,2023-04-30T19:45,-20000,650000
537,1699941,88,67150,79000,97.0,4989,2023-04-30T19:45,-10073,57077
538,3124959,89,55100,58000,97.0,87,2023-04-30T19:45,-8265,46835
539,2440524,90,69000,0,97.0,1698,2023-04-30T19:45,0,69000
540,1214164,1,36000,0,96.0,25205,2023-04-30T19:45,0,36000
541,2356713,2,39000,0,97.0,1624,2023-04-30T19:45,-5850,33150
542,2280117,3,35100,39000,97.0,6624,2023-04-30T19:45,0,35100
543,2134140,4,39000,0,97.0,3798,2023-04-30T19:45,-5850,33150
544,1822717,5,56050,59000,97.0,4441,2023-04-30T19:45,0,56050
545,1907733,6,29900,39000,96.0,3970,2023-04-30T19:45,-8970,20930
546,1214174,7,36000,0,97.0,15190,2023-04-30T19:45,0,36000
547,1920929,8,39000,0,97.0,4173,2023-04-30T19:45,-5850,33150
548,1022013,9,79000,0,96.0,6346,2023-04-30T19:45,0,79000
549,2879419,10,48900,55000,98.0,942,2023-04-30T19:45,-7335,41565
550,2287131,11,29600,37000,95.0,1822,2023-04-30T19:45,-4440,25160
551,2356711,12,39000,0,97.0,1627,2023-04-30T19:45,-5850,33150
552,1272626,13,36000,0,96.0,14317,2023-04-30T19:45,0,36000
553,1022014,14,79000,0,96.0,11524,2023-04-30T19:45,0,79000
554,1836699,15,79000,0,96.0,278,2023-04-30T19:45,0,79000
555,1214173,16,36000,0,96.0,5691,2023-04-30T19:45,0,36000
556,1771137,17,29000,0,97.0,12771,2023-04-30T19:45,0,29000
557,1214109,18,36000,0,97.0,8276,2023-04-30T19:45,0,36000
558,2134158,19,39000,0,97.0,2639,2023-04-30T19:45,-5850,33150
559,1214317,20,36000,0,97.0,11609,2023-04-30T19:45,0,36000
560,2875051,21,138000,207000,97.0,35,2023-04-30T19:45,-27600,110400
561,2560668,22,48300,69000,97.0,1320,2023-04-30T19:45,0,48300
562,2286829,23,31450,37000,95.0,5156,2023-04-30T19:45,-4718,26732
563,2795310,24,657000,780000,100.0,6,2023-04-30T19:45,-30000,627000
564,2356693,25,39000,0,97.0,1600,2023-04-30T19:45,-5850,33150
565,3012243,26,29900,39900,99.0,108,2023-04-30T19:45,-4485,25415
566,1855444,27,39900,42000,97.0,3127,2023-04-30T19:45,-5985,33915
567,1771132,28,29000,0,96.0,5423,2023-04-30T19:45,0,29000
568,3039055,29,36550,43000,96.0,90,2023-04-30T19:45,-5483,31067
569,2672186,30,20900,30000,96.0,659,2023-04-30T19:45,-2299,18601
570,2864918,31,49000,0,99.0,160,2023-04-30T19:45,0,49000
571,2107999,32,36000,0,97.0,2748,2023-04-30T19:45,0,36000
572,3232889,33,35010,38900,94.0,15,2023-04-30T19:45,-3501,31509
573,2221221,34,35100,39000,96.0,1937,2023-04-30T19:45,0,35100
574,2028240,35,39000,0,98.0,3417,2023-04-30T19:45,-5850,33150
575,1524720,36,36000,0,96.0,3474,2023-04-30T19:45,0,36000
576,1907732,37,27900,39000,95.0,834,2023-04-30T19:45,-8370,19530
577,1497550,38,29600,37000,95.0,5780,2023-04-30T19:45,0,29600
578,1771133,39,29000,0,97.0,5803,2023-04-30T19:45,0,29000
579,1300684,40,41300,59000,93.0,276,2023-04-30T19:45,0,41300
580,2622323,41,19890,39000,96.0,70,2023-04-30T19:45,-5967,13923
581,2687157,42,45000,0,97.0,1119,2023-04-30T19:45,-6750,38250
582,3263326,43,49000,0,0.0,0,2023-04-30T19:45,0,49000
583,1452917,44,69000,0,96.0,2443,2023-04-30T19:45,0,69000
584,2507080,45,39000,0,98.0,457,2023-04-30T19:45,-5850,33150
585,3039061,46,33150,39000,96.0,74,2023-04-30T19:45,-4973,28177
586,3260187,47,69000,0,0.0,0,2023-04-30T19:45,0,69000
587,2329375,48,34710,39000,96.0,2162,2023-04-30T19:45,0,34710
588,2930563,49,160000,238000,96.0,12,2023-04-30T19:45,-30000,130000
589,363169,50,17900,26000,95.0,4422,2023-04-30T19:45,0,17900
590,1214169,51,36000,0,96.0,5433,2023-04-30T19:45,0,36000
591,2859190,52,33300,37000,96.0,533,2023-04-30T19:45,-4995,28305
592,3129450,53,49000,0,97.0,37,2023-04-30T19:45,-9800,39200
593,1214171,54,36000,0,97.0,1754,2023-04-30T19:45,0,36000
594,2329376,55,34710,39000,96.0,621,2023-04-30T19:45,0,34710
595,3088383,56,32400,36000,95.0,44,2023-04-30T19:45,0,32400
596,1920840,57,39000,0,98.0,1413,2023-04-30T19:45,-5850,33150
597,2879425,58,48900,55000,98.0,383,2023-04-30T19:45,-7335,41565
598,2467196,59,69000,0,99.0,82,2023-04-30T19:45,0,69000
599,3162857,60,150000,0,0.0,0,2023-04-30T19:45,0,150000
600,2164773,61,69000,0,97.0,533,2023-04-30T19:45,0,69000
601,2289281,62,28500,38000,96.0,935,2023-04-30T19:45,0,28500
602,2851288,63,9750,39000,94.0,56,2023-04-30T19:45,0,9750
603,3088359,64,35100,39000,97.0,26,2023-04-30T19:45,0,35100
604,3185986,65,49000,0,100.0,4,2023-04-30T19:45,0,49000
605,2149507,66,9860,29000,95.0,465,2023-04-30T19:45,0,9860
606,2444602,67,54000,0,97.0,141,2023-04-30T19:45,0,54000
607,2879417,68,48900,55000,98.0,246,2023-04-30T19:45,-7335,41565
608,3088347,69,35100,39000,95.0,52,2023-04-30T19:45,0,35100
609,3039062,70,33150,39000,97.0,41,2023-04-30T19:45,-4973,28177
610,2287158,71,33300,37000,95.0,1275,2023-04-30T19:45,-4995,28305
611,1925814,72,35100,39000,96.0,1737,2023-04-30T19:45,0,35100
612,3099126,73,54000,0,98.0,34,2023-04-30T19:45,0,54000
613,3125919,74,69000,0,97.0,14,2023-04-30T19:45,-13800,55200
614,2435766,75,37900,39900,98.0,227,2023-04-30T19:45,-5685,32215
615,2381807,76,48300,69000,98.0,1200,2023-04-30T19:45,0,48300
616,2280146,77,35100,39000,97.0,989,2023-04-30T19:45,0,35100
617,2507021,78,42000,0,96.0,416,2023-04-30T19:45,-6300,35700
618,2573131,79,39900,42000,97.0,752,2023-04-30T19:45,-5985,33915
619,2134295,80,39000,0,97.0,439,2023-04-30T19:45,0,39000
620,2244284,81,36000,0,97.0,618,2023-04-30T19:45,0,36000
621,3065903,82,48300,69000,99.0,33,2023-04-30T19:45,0,48300
622,2591291,83,39200,49000,97.0,1071,2023-04-30T19:45,0,39200
623,2337876,84,19890,39000,95.0,165,2023-04-30T19:45,-5967,13923
624,2599112,85,40500,45000,98.0,120,2023-04-30T19:45,-6075,34425
625,1760824,86,49700,59000,97.0,337,2023-04-30T19:45,0,49700
626,2658143,87,35100,39000,96.0,295,2023-04-30T19:45,0,35100
627,3088375,88,41400,46000,99.0,20,2023-04-30T19:45,0,41400
628,2747819,89,36000,45000,98.0,53,2023-04-30T19:45,-7200,28800
629,1126959,90,29250,39000,91.0,2622,2023-04-30T19:45,0,29250
630,2512635,1,35400,59000,96.0,240,2023-04-30T19:45,-10620,24780
631,2457512,2,237300,339000,98.0,40,2023-04-30T19:45,0,237300
632,3008189,3,334000,478000,100.0,10,2023-04-30T19:45,-60120,273880
633,2091668,4,339000,0,80.0,1,2023-04-30T19:45,0,339000
634,2605850,5,94000,0,97.0,184,2023-04-30T19:45,0,94000
635,2070402,6,195300,279000,0.0,0,2023-04-30T19:45,0,195300
636,2712722,7,46900,79000,96.0,32,2023-04-30T19:45,-14070,32830
637,3250317,8,160550,169000,0.0,0,2023-04-30T19:45,0,160550
638,3205629,9,175000,219000,0.0,0,2023-04-30T19:45,-8750,166250
639,3171882,10,141600,149000,100.0,5,2023-04-30T19:45,0,141600
640,3228639,11,135150,159000,80.0,1,2023-04-30T19:45,0,135150
641,1103286,12,94000,0,94.0,788,2023-04-30T19:45,0,94000
642,3106487,13,133200,148000,98.0,39,2023-04-30T19:45,0,133200
643,2388209,14,94000,0,97.0,161,2023-04-30T19:45,0,94000
644,3081772,15,189000,0,96.0,5,2023-04-30T19:45,0,189000
645,2496520,16,398000,0,100.0,6,2023-04-30T19:45,-70000,328000
646,2848613,17,86900,0,100.0,3,2023-04-30T19:45,0,86900
647,2457511,18,339000,0,100.0,17,2023-04-30T19:45,0,339000
648,2489894,19,150100,158000,98.0,111,2023-04-30T19:45,0,150100
649,3084760,20,119000,0,100.0,2,2023-04-30T19:45,0,119000
650,1779568,21,54400,64000,95.0,300,2023-04-30T19:45,-8160,46240
651,3059119,22,161100,179000,92.0,29,2023-04-30T19:45,-28998,132102
652,1467467,23,175200,219000,85.0,4,2023-04-30T19:45,-26280,148920
653,2392489,24,31900,0,97.0,745,2023-04-30T19:45,0,31900
654,1875664,25,33190,36900,96.0,578,2023-04-30T19:45,0,33190
655,3112830,26,342000,360000,100.0,3,2023-04-30T19:45,-61560,280440
656,3230036,27,190800,212000,0.0,0,2023-04-30T19:45,-9540,181260
657,3228633,28,135150,159000,0.0,0,2023-04-30T19:45,0,135150
658,2568529,29,220000,0,100.0,17,2023-04-30T19:45,0,220000
659,3053225,30,159000,0,100.0,5,2023-04-30T19:45,0,159000
660,2153636,31,173600,248000,98.0,32,2023-04-30T19:45,0,173600
661,3230039,32,190800,212000,0.0,0,2023-04-30T19:45,-9540,181260
662,2070409,33,237300,339000,0.0,0,2023-04-30T19:45,0,237300
663,2377832,34,195000,0,95.0,182,2023-04-30T19:45,0,195000
664,2070650,35,181300,259000,0.0,0,2023-04-30T19:45,0,181300
665,3149931,36,109000,0,100.0,8,2023-04-30T19:45,0,109000
666,3098634,37,222740,259000,100.0,1,2023-04-30T19:45,-40094,182646
667,3047082,38,66750,89000,0.0,0,2023-04-30T19:45,-10013,56737
668,3242733,39,224000,0,0.0,0,2023-04-30T19:45,0,224000
669,3251832,40,169000,0,100.0,1,2023-04-30T19:45,0,169000
670,3259574,41,238000,0,0.0,0,2023-04-30T19:45,-42840,195160
671,3074709,42,107100,119000,100.0,3,2023-04-30T19:45,0,107100
672,3117209,43,236600,338000,100.0,2,2023-04-30T19:45,-42588,194012
673,3207216,44,235600,248000,0.0,0,2023-04-30T19:45,-35340,200260
674,3207242,45,235600,248000,0.0,0,2023-04-30T19:45,-35340,200260
675,2552066,46,229000,0,0.0,0,2023-04-30T19:45,0,229000
676,3217675,47,109000,0,100.0,1,2023-04-30T19:45,-16350,92650
677,3234937,48,229000,0,0.0,0,2023-04-30T19:45,-11450,217550
678,3156875,49,224000,0,0.0,0,2023-04-30T19:45,-44800,179200
679,3202314,50,75200,94000,100.0,6,2023-04-30T19:45,-11280,63920
680,3050173,51,166600,238000,100.0,7,2023-04-30T19:45,0,166600
681,3196932,52,159000,0,100.0,2,2023-04-30T19:45,0,159000
682,3130633,53,149000,0,100.0,8,2023-04-30T19:45,0,149000
683,3201355,54,59900,99000,0.0,0,2023-04-30T19:45,-8985,50915
684,3081770,55,189000,0,96.0,6,2023-04-30T19:45,0,189000
685,2590832,56,218000,0,0.0,0,2023-04-30T19:45,0,218000
686,3037449,57,199000,0,80.0,3,2023-04-30T19:45,0,199000
687,1489950,58,198000,0,95.0,27,2023-04-30T19:45,0,198000
688,3225475,59,39100,46000,0.0,0,2023-04-30T19:45,0,39100
689,2336390,60,209300,299000,0.0,0,2023-04-30T19:45,0,209300
690,3063569,61,209250,279000,0.0,0,2023-04-30T19:45,-31388,177862
691,2452062,62,98100,109000,97.0,48,2023-04-30T19:45,0,98100
692,3053223,63,179000,0,100.0,4,2023-04-30T19:45,0,179000
693,2830893,64,189000,0,100.0,5,2023-04-30T19:45,0,189000
694,3120621,65,197100,219000,100.0,1,2023-04-30T19:45,-39420,157680
695,1489949,66,198000,0,100.0,3,2023-04-30T19:45,0,198000
696,3206508,67,158000,0,80.0,1,2023-04-30T19:45,0,158000
697,3124599,68,198000,0,0.0,0,2023-04-30T19:45,-29700,168300
698,1998501,69,198000,0,0.0,0,2023-04-30T19:45,0,198000
699,3099416,70,44910,49900,97.0,7,2023-04-30T19:45,-8982,35928
700,3146767,71,179000,0,0.0,0,2023-04-30T19:45,-35800,143200
701,2979051,72,194000,0,100.0,1,2023-04-30T19:45,0,194000
702,3250312,73,160550,169000,0.0,0,2023-04-30T19:45,0,160550
703,3083230,74,159000,0,93.0,9,2023-04-30T19:45,0,159000
704,3069674,75,179100,199000,0.0,0,2023-04-30T19:45,-35820,143280
705,3122381,76,168000,0,94.0,7,2023-04-30T19:45,-30240,137760
706,2478601,77,188000,0,0.0,0,2023-04-30T19:45,0,188000
707,3134492,78,75050,79000,97.0,7,2023-04-30T19:45,0,75050
708,2424645,79,125300,179000,92.0,17,2023-04-30T19:45,-22554,102746
709,3135234,80,62300,89000,95.0,8,2023-04-30T19:45,-9345,52955
710,3228630,81,135150,159000,0.0,0,2023-04-30T19:45,0,135150
711,2612807,82,178000,0,0.0,0,2023-04-30T19:45,0,178000
712,2620206,83,159600,228000,100.0,6,2023-04-30T19:45,0,159600
713,2621820,84,176000,0,0.0,0,2023-04-30T19:45,0,176000
714,3206504,85,168000,0,0.0,0,2023-04-30T19:45,0,168000
715,3119153,86,160600,169000,0.0,0,2023-04-30T19:45,0,160600
716,3190217,87,165000,0,0.0,0,2023-04-30T19:45,0,165000
717,1875663,88,33190,36900,95.0,843,2023-04-30T19:45,0,33190
718,3130645,89,119000,0,100.0,2,2023-04-30T19:45,0,119000
719,3225126,90,129000,0,100.0,2,2023-04-30T19:45,0,129000
720,2643318,1,138000,0,94.0,18,2023-04-30T19:45,-24840,113160
721,2830762,2,139000,0,99.0,49,2023-04-30T19:45,0,139000
722,2852784,3,223200,279000,0.0,0,2023-04-30T19:45,-33480,189720
723,2551401,4,37900,0,94.0,361,2023-04-30T19:45,0,37900
724,3122265,5,138000,0,90.0,6,2023-04-30T19:45,-24840,113160
725,3147257,6,378000,0,0.0,0,2023-04-30T19:45,-68040,309960
726,3070528,7,168000,0,97.0,7,2023-04-30T19:45,0,168000
727,3062952,8,98100,109000,100.0,23,2023-04-30T19:45,0,98100
728,2716675,9,39900,59000,96.0,217,2023-04-30T19:45,-5985,33915
729,3081344,10,358000,0,0.0,0,2023-04-30T19:45,-64440,293560
730,3242636,11,359000,0,0.0,0,2023-04-30T19:45,0,359000
731,3144344,12,66000,82000,96.0,6,2023-04-30T19:45,-9900,56100
732,2713339,13,329000,470000,94.0,10,2023-04-30T19:45,0,329000
733,3170471,14,139000,0,100.0,3,2023-04-30T19:45,0,139000
734,3228597,15,75650,89000,100.0,2,2023-04-30T19:45,0,75650
735,3069542,16,152100,169000,0.0,0,2023-04-30T19:45,-30420,121680
736,3197575,17,309000,0,0.0,0,2023-04-30T19:45,-15450,293550
737,2864414,18,69300,99000,95.0,111,2023-04-30T19:45,-10395,58905
738,3171252,19,305100,339000,0.0,0,2023-04-30T19:45,-54918,250182
739,2414122,20,93000,0,95.0,16,2023-04-30T19:45,0,93000
740,1944553,21,36900,0,96.0,231,2023-04-30T19:45,-3690,33210
741,3190572,22,264000,378000,100.0,1,2023-04-30T19:45,-47520,216480
742,2879963,23,276000,0,100.0,2,2023-04-30T19:45,0,276000
743,3241784,24,97000,0,0.0,0,2023-04-30T19:45,0,97000
744,1944554,25,36900,0,96.0,580,2023-04-30T19:45,-3690,33210
745,3051036,26,83300,119000,100.0,18,2023-04-30T19:45,0,83300
746,3051709,27,43900,0,100.0,7,2023-04-30T19:45,0,43900
747,3112847,28,247000,260000,0.0,0,2023-04-30T19:45,-44460,202540
748,3112848,29,247000,260000,100.0,3,2023-04-30T19:45,-44460,202540
749,1645762,30,39390,43900,94.0,360,2023-04-30T19:45,0,39390
750,2925522,31,65000,0,96.0,144,2023-04-30T19:45,0,65000
751,2830788,32,139000,0,95.0,28,2023-04-30T19:45,0,139000
752,2836351,33,48240,72000,96.0,501,2023-04-30T19:45,-7236,41004
753,2360537,34,77900,82000,96.0,90,2023-04-30T19:45,0,77900
754,3208955,35,238000,0,0.0,0,2023-04-30T19:45,-35700,202300
755,2942764,36,189000,0,97.0,16,2023-04-30T19:45,-28350,160650
756,3063419,37,34900,65000,98.0,16,2023-04-30T19:45,-10470,24430
757,1324169,38,29900,0,95.0,1367,2023-04-30T19:45,0,29900
758,2117249,39,29590,32900,94.0,473,2023-04-30T19:45,-2959,26631
759,2408582,40,230000,329000,0.0,0,2023-04-30T19:45,0,230000
760,2664574,41,223000,0,100.0,2,2023-04-30T19:45,-40140,182860
761,2017521,42,218000,0,100.0,1,2023-04-30T19:45,0,218000
762,3174804,43,223200,248000,0.0,0,2023-04-30T19:45,-40176,183024
763,3174796,44,223200,248000,0.0,0,2023-04-30T19:45,-40176,183024
764,3058674,45,116100,129000,0.0,0,2023-04-30T19:45,-20898,95202
765,3073252,46,178000,0,95.0,8,2023-04-30T19:45,-32040,145960
766,3144417,47,71100,79000,100.0,3,2023-04-30T19:45,0,71100
767,3121042,48,208600,298000,0.0,0,2023-04-30T19:45,-37548,171052
768,1645760,49,43900,0,96.0,356,2023-04-30T19:45,0,43900
769,2377805,50,198000,0,94.0,22,2023-04-30T19:45,-35640,162360
770,2776678,51,98000,0,93.0,26,2023-04-30T19:45,0,98000
771,3247855,52,102600,114000,0.0,0,2023-04-30T19:45,-15390,87210
772,3069510,53,170100,189000,100.0,4,2023-04-30T19:45,-34020,136080
773,3031104,54,48300,69000,98.0,91,2023-04-30T19:45,-7245,41055
774,3081767,55,169000,0,93.0,9,2023-04-30T19:45,0,169000
775,3122274,56,188000,0,0.0,0,2023-04-30T19:45,-33840,154160
776,3040753,57,100000,125000,0.0,0,2023-04-30T19:45,-15000,85000
777,3198566,58,59000,0,88.0,15,2023-04-30T19:45,-8850,50150
778,2378594,59,88200,98000,95.0,132,2023-04-30T19:45,0,88200
779,3083213,60,132000,0,92.0,8,2023-04-30T19:45,0,132000
780,2894755,61,261000,735000,0.0,0,2023-04-30T19:45,0,261000
781,2836289,62,29500,59000,94.0,228,2023-04-30T19:45,-4425,25075
782,3081769,63,169000,0,100.0,1,2023-04-30T19:45,0,169000
783,3037454,64,149000,0,88.0,10,2023-04-30T19:45,0,149000
784,3052037,65,174000,249000,0.0,0,2023-04-30T19:45,0,174000
785,3223318,66,113050,119000,100.0,1,2023-04-30T19:45,0,113050
786,3135305,67,38500,55000,96.0,17,2023-04-30T19:45,-5775,32725
787,3098355,68,161100,179000,0.0,0,2023-04-30T19:45,-28998,132102
788,2830808,69,139000,0,97.0,15,2023-04-30T19:45,0,139000
789,3125458,70,171000,0,0.0,0,2023-04-30T19:45,-25650,145350
790,1931894,71,37900,0,95.0,549,2023-04-30T19:45,0,37900
791,2745024,72,166600,238000,96.0,16,2023-04-30T19:45,-29988,136612
792,3105568,73,159000,0,0.0,0,2023-04-30T19:45,0,159000
793,3038103,74,168000,0,0.0,0,2023-04-30T19:45,-25200,142800
794,3053122,75,167300,239000,0.0,0,2023-04-30T19:45,-25095,142205
795,2978108,76,38990,45900,100.0,1,2023-04-30T19:45,0,38990
796,3126113,77,55300,79000,90.0,19,2023-04-30T19:45,-8295,47005
797,2867750,78,135000,0,96.0,51,2023-04-30T19:45,0,135000
798,1819994,79,36500,43000,92.0,676,2023-04-30T19:45,0,36500
799,2509358,80,153300,219000,100.0,1,2023-04-30T19:45,0,153300
800,2533425,81,30400,38000,96.0,219,2023-04-30T19:45,0,30400
801,3153652,82,152100,169000,0.0,0,2023-04-30T19:45,-22815,129285
802,2745019,83,152600,218000,92.0,22,2023-04-30T19:45,0,152600
803,3038047,84,107100,119000,100.0,6,2023-04-30T19:45,0,107100
804,2313073,85,53100,59000,96.0,237,2023-04-30T19:45,0,53100
805,2300718,86,43900,0,95.0,254,2023-04-30T19:45,0,43900
806,3124534,87,152150,179000,0.0,0,2023-04-30T19:45,0,152150
807,2390967,88,33630,59000,93.0,225,2023-04-30T19:45,-3363,30267
808,3147609,89,149000,0,0.0,0,2023-04-30T19:45,0,149000
809,2405836,90,128000,0,88.0,9,2023-04-30T19:45,0,128000
810,991339,1,17890,19900,97.0,54012,2023-04-30T19:45,0,17890
811,1477845,2,15400,22000,96.0,10002,2023-04-30T19:45,-4620,10780
812,1986031,3,23690,27900,97.0,11008,2023-04-30T19:45,0,23690
813,998051,4,15200,24000,97.0,165557,2023-04-30T19:45,0,15200
814,991340,5,15890,19900,97.0,31216,2023-04-30T19:45,0,15890
815,792919,6,15190,16900,96.0,18065,2023-04-30T19:45,0,15190
816,763821,7,16200,22000,96.0,31684,2023-04-30T19:45,0,16200
817,479245,8,15400,22000,93.0,5495,2023-04-30T19:45,-4620,10780
818,1996702,9,25090,27900,97.0,2015,2023-04-30T19:45,0,25090
819,1094835,10,15900,0,97.0,6380,2023-04-30T19:45,0,15900
820,1094748,11,19900,0,97.0,19427,2023-04-30T19:45,0,19900
821,1342874,12,16900,33000,97.0,13278,2023-04-30T19:45,0,16900
822,2845854,13,13000,18900,97.0,390,2023-04-30T19:45,-2600,10400
823,1547562,14,15400,22000,95.0,1390,2023-04-30T19:45,-4620,10780
824,746158,15,19390,22900,96.0,20634,2023-04-30T19:45,0,19390
825,2297277,16,19900,22000,96.0,354,2023-04-30T19:45,-5970,13930
826,1477846,17,15400,22000,96.0,2719,2023-04-30T19:45,-4620,10780
827,991341,18,16890,19900,96.0,10353,2023-04-30T19:45,0,16890
828,1443937,19,12900,24000,97.0,8402,2023-04-30T19:45,0,12900
829,1986029,20,27900,0,97.0,4048,2023-04-30T19:45,0,27900
830,1996705,21,23690,27900,98.0,2795,2023-04-30T19:45,0,23690
831,3033249,22,15000,0,95.0,343,2023-04-30T19:45,0,15000
832,1729576,23,9600,13900,97.0,16546,2023-04-30T19:45,-1440,8160
833,734085,24,13200,19800,96.0,65432,2023-04-30T19:45,0,13200
834,1092994,25,19390,22900,96.0,2687,2023-04-30T19:45,0,19390
835,1821485,26,30000,0,96.0,1313,2023-04-30T19:45,0,30000
836,991570,27,13300,20000,97.0,19302,2023-04-30T19:45,0,13300
837,2960555,28,19000,0,94.0,142,2023-04-30T19:45,0,19000
838,1346009,29,9500,12000,97.0,6814,2023-04-30T19:45,-1425,8075
839,746159,30,19390,22900,95.0,28788,2023-04-30T19:45,0,19390
840,1094836,31,15900,0,97.0,1346,2023-04-30T19:45,0,15900
841,792921,32,15190,16900,95.0,7852,2023-04-30T19:45,0,15190
842,2293399,33,19900,22000,95.0,646,2023-04-30T19:45,-5970,13930
843,2973952,34,28800,48000,95.0,21,2023-04-30T19:45,-5184,23616
844,792920,35,15190,16900,96.0,9757,2023-04-30T19:45,0,15190
845,1094837,36,13490,15900,96.0,1801,2023-04-30T19:45,0,13490
846,2832613,37,11900,33000,97.0,897,2023-04-30T19:45,0,11900
847,3009680,38,12590,14900,98.0,197,2023-04-30T19:45,0,12590
848,2829586,39,13000,18900,97.0,49,2023-04-30T19:45,-2600,10400
849,746154,40,17900,0,96.0,5251,2023-04-30T19:45,0,17900
850,2467197,41,30000,0,95.0,153,2023-04-30T19:45,0,30000
851,3181894,42,22000,0,100.0,7,2023-04-30T19:45,-6600,15400
852,2295818,43,19900,22000,95.0,196,2023-04-30T19:45,-5970,13930
853,1358721,44,14200,22000,96.0,1186,2023-04-30T19:45,-2130,12070
854,1974077,45,37490,46900,97.0,915,2023-04-30T19:45,0,37490
855,1996704,46,22290,27900,97.0,739,2023-04-30T19:45,0,22290
856,2959925,47,22000,27500,98.0,146,2023-04-30T19:45,-1100,20900
857,2477854,48,16890,19900,98.0,1505,2023-04-30T19:45,0,16890
858,3147419,49,12900,15000,100.0,4,2023-04-30T19:45,0,12900
859,2973894,50,22000,27500,98.0,36,2023-04-30T19:45,-1100,20900
860,2347097,51,14900,24000,98.0,1681,2023-04-30T19:45,-2235,12665
861,1348077,52,10900,16500,97.0,1909,2023-04-30T19:45,0,10900
862,2011850,53,21490,23900,98.0,881,2023-04-30T19:45,0,21490
863,1260388,54,20900,0,95.0,700,2023-04-30T19:45,0,20900
864,1260384,55,19900,0,95.0,1817,2023-04-30T19:45,0,19900
865,2821598,56,19390,22900,97.0,180,2023-04-30T19:45,0,19390
866,3220486,57,18000,0,85.0,7,2023-04-30T19:45,0,18000
867,1062063,58,9490,15900,97.0,2240,2023-04-30T19:45,0,9490
868,1260383,59,19900,0,95.0,1473,2023-04-30T19:45,0,19900
869,1475055,60,16200,22000,96.0,1198,2023-04-30T19:45,-2430,13770
870,1286366,61,12500,24000,97.0,9889,2023-04-30T19:45,0,12500
871,3220488,62,18000,0,91.0,7,2023-04-30T19:45,0,18000
872,1094750,63,16890,19900,97.0,3609,2023-04-30T19:45,0,16890
873,1821487,64,30000,0,97.0,686,2023-04-30T19:45,0,30000
874,472686,65,9500,14800,94.0,794,2023-04-30T19:45,0,9500
875,746155,66,17900,0,95.0,1284,2023-04-30T19:45,0,17900
876,1986030,67,27900,0,97.0,1747,2023-04-30T19:45,0,27900
877,2342849,68,15120,18900,92.0,135,2023-04-30T19:45,0,15120
878,2812523,69,20000,25000,97.0,110,2023-04-30T19:45,-6000,14000
879,752821,70,9900,0,95.0,23932,2023-04-30T19:45,0,9900
880,2829802,71,13000,18900,97.0,38,2023-04-30T19:45,-2600,10400
881,2821592,72,15590,20900,98.0,166,2023-04-30T19:45,0,15590
882,2618262,73,39200,49000,89.0,39,2023-04-30T19:45,-1960,37240
883,2509300,74,19900,0,96.0,409,2023-04-30T19:45,0,19900
884,2821590,75,19690,21900,98.0,56,2023-04-30T19:45,0,19690
885,2346958,76,18200,24000,98.0,560,2023-04-30T19:45,-2730,15470
886,1392773,77,16890,19900,95.0,1490,2023-04-30T19:45,0,16890
887,2821589,78,19690,21900,96.0,49,2023-04-30T19:45,0,19690
888,3171964,79,22000,0,80.0,3,2023-04-30T19:45,-6600,15400
889,2819024,80,12800,16000,96.0,56,2023-04-30T19:45,-3840,8960
890,1094749,81,19900,0,96.0,5009,2023-04-30T19:45,0,19900
891,1094834,82,20290,23900,96.0,2494,2023-04-30T19:45,0,20290
892,2870865,83,15900,19900,95.0,84,2023-04-30T19:45,-3180,12720
893,2964177,84,20520,36000,93.0,16,2023-04-30T19:45,0,20520
894,3118094,85,28800,32000,98.0,13,2023-04-30T19:45,-4320,24480
895,2003714,86,15200,22000,97.0,437,2023-04-30T19:45,-2280,12920
896,3047676,87,13500,15000,97.0,35,2023-04-30T19:45,-2025,11475
897,2821588,88,19690,21900,97.0,67,2023-04-30T19:45,0,19690
898,2652523,89,9500,12000,98.0,129,2023-04-30T19:45,-1425,8075
899,1821480,90,30000,0,97.0,246,2023-04-30T19:45,0,30000
