,item_id,rank,price,del_price,rating,rating_count,time,coupon,real_price
0,3154715,1,49500,66000,0.0,0,2023-04-03T22:29,-4950,44550
1,3154716,2,49500,66000,0.0,0,2023-04-03T22:29,-4950,44550
2,3154714,3,49500,66000,0.0,0,2023-04-03T22:29,-4950,44550
3,3154712,4,49500,66000,0.0,0,2023-04-03T22:29,-4950,44550
4,3154713,5,49500,66000,0.0,0,2023-04-03T22:29,-4950,44550
5,3154710,6,49500,66000,0.0,0,2023-04-03T22:29,-4950,44550
6,3154711,7,49500,66000,0.0,0,2023-04-03T22:29,-4950,44550
7,2272830,8,35910,39900,97.0,18997,2023-04-03T22:29,-3591,32319
8,1848166,9,44100,49000,97.0,40898,2023-04-03T22:29,0,44100
9,2479911,10,49400,76000,97.0,4092,2023-04-03T22:29,0,49400
10,994588,11,39900,53000,93.0,5981,2023-04-03T22:29,-3990,35910
11,2646350,12,59800,94000,95.0,4028,2023-04-03T22:29,-5980,53820
12,2086653,13,16900,0,97.0,39191,2023-04-03T22:29,0,16900
13,2442409,14,39000,78000,96.0,8801,2023-04-03T22:29,-7800,31200
14,345889,15,29900,47900,95.0,9688,2023-04-03T22:29,0,29900
15,3187851,16,49900,110000,100.0,4,2023-04-03T22:29,0,49900
16,2377269,17,38250,45000,97.0,3815,2023-04-03T22:29,0,38250
17,2149254,18,37800,0,97.0,32875,2023-04-03T22:29,-5670,32130
18,1921901,19,36900,70500,96.0,7536,2023-04-03T22:29,0,36900
19,1778065,20,101000,0,90.0,21,2023-04-03T22:29,0,101000
20,1706633,21,199000,0,97.0,2379,2023-04-03T22:29,0,199000
21,2996536,22,39900,59000,96.0,469,2023-04-03T22:29,0,39900
22,1763157,23,49400,52000,95.0,2618,2023-04-03T22:29,0,49400
23,1498103,24,199000,0,96.0,849,2023-04-03T22:29,0,199000
24,1939099,25,34300,49000,97.0,11676,2023-04-03T22:29,0,34300
25,1005680,26,17500,35000,95.0,9011,2023-04-03T22:29,0,17500
26,1944612,27,35800,59700,97.0,2830,2023-04-03T22:29,-1790,34010
27,2996252,28,64000,117000,100.0,2,2023-04-03T22:29,0,64000
28,1706634,29,199000,0,97.0,1522,2023-04-03T22:29,0,199000
29,2375962,30,59000,62000,98.0,5326,2023-04-03T22:29,-8850,50150
30,2775713,31,39800,49000,93.0,2911,2023-04-03T22:29,0,39800
31,1943792,32,34400,43000,96.0,5294,2023-04-03T22:29,0,34400
32,1706635,33,199000,0,96.0,477,2023-04-03T22:29,0,199000
33,996177,34,15900,0,95.0,77431,2023-04-03T22:29,0,15900
34,1828538,35,39900,69900,95.0,2906,2023-04-03T22:29,0,39900
35,1884943,36,29900,39000,96.0,18844,2023-04-03T22:29,0,29900
36,2038497,37,36000,45000,95.0,16238,2023-04-03T22:29,-3600,32400
37,2396645,38,39900,59000,96.0,23353,2023-04-03T22:29,0,39900
38,2043036,39,59900,97900,95.0,7437,2023-04-03T22:29,0,59900
39,1005683,40,17500,35000,95.0,10710,2023-04-03T22:29,0,17500
40,2376229,41,36000,0,97.0,3815,2023-04-03T22:29,0,36000
41,1817394,42,59900,150000,93.0,7129,2023-04-03T22:29,0,59900
42,2314616,43,39000,43000,97.0,8200,2023-04-03T22:29,0,39000
43,2409397,44,31500,45000,97.0,2713,2023-04-03T22:29,-3150,28350
44,2034137,45,31800,0,97.0,16891,2023-04-03T22:29,-4770,27030
45,1763123,46,84550,89000,96.0,1658,2023-04-03T22:29,-4228,80322
46,1899755,47,29900,39000,96.0,4916,2023-04-03T22:29,0,29900
47,2453556,48,39900,42000,97.0,6246,2023-04-03T22:29,0,39900
48,3133234,49,32500,50000,87.0,20,2023-04-03T22:29,0,32500
49,2326935,50,63200,79000,96.0,12906,2023-04-03T22:29,-12640,50560
50,2708999,51,49800,62500,96.0,622,2023-04-03T22:29,-2490,47310
51,1582356,52,49200,82000,96.0,16064,2023-04-03T22:29,-2460,46740
52,2575342,53,39900,59000,96.0,825,2023-04-03T22:29,0,39900
53,2368712,54,38700,43000,97.0,5553,2023-04-03T22:29,-1935,36765
54,2313388,55,76500,85000,96.0,2104,2023-04-03T22:29,0,76500
55,3056893,56,47520,72000,94.0,56,2023-04-03T22:29,0,47520
56,2376233,57,36000,0,97.0,2202,2023-04-03T22:29,0,36000
57,2392759,58,39900,49600,95.0,3966,2023-04-03T22:29,0,39900
58,1417691,59,13900,0,97.0,18431,2023-04-03T22:29,0,13900
59,2359137,60,40200,67000,97.0,1306,2023-04-03T22:29,0,40200
60,1911516,61,48900,81900,95.0,6150,2023-04-03T22:29,0,48900
61,854337,62,33900,0,95.0,17270,2023-04-03T22:29,0,33900
62,2471760,63,31200,39000,97.0,6473,2023-04-03T22:29,-6240,24960
63,2572338,64,66900,0,96.0,469,2023-04-03T22:29,0,66900
64,1336398,65,40200,67000,96.0,19032,2023-04-03T22:29,0,40200
65,2913656,66,47900,64000,96.0,278,2023-04-03T22:29,-4790,43110
66,3034895,67,101150,119000,98.0,351,2023-04-03T22:29,0,101150
67,3010633,68,71200,89000,97.0,113,2023-04-03T22:29,-14240,56960
68,1420730,69,35000,58000,95.0,35925,2023-04-03T22:29,0,35000
69,2065703,70,59000,62000,98.0,5464,2023-04-03T22:29,-8850,50150
70,2403601,71,32500,50000,96.0,2185,2023-04-03T22:29,0,32500
71,2122566,72,33800,0,97.0,15737,2023-04-03T22:29,-6760,27040
72,997738,73,29800,42000,95.0,2184,2023-04-03T22:29,0,29800
73,1846930,74,27300,39000,96.0,8290,2023-04-03T22:29,0,27300
74,2015684,75,39000,0,94.0,6353,2023-04-03T22:29,0,39000
75,1779737,76,20800,32000,96.0,7203,2023-04-03T22:29,0,20800
76,1503352,77,39900,42000,97.0,8383,2023-04-03T22:29,0,39900
77,1820701,78,35000,0,96.0,5545,2023-04-03T22:29,0,35000
78,1841764,79,31200,39000,96.0,13045,2023-04-03T22:29,-6240,24960
79,2456003,80,39900,82900,95.0,2201,2023-04-03T22:29,0,39900
80,3080282,81,34800,58000,96.0,41,2023-04-03T22:29,0,34800
81,3133241,82,42250,65000,97.0,9,2023-04-03T22:29,0,42250
82,3051599,83,34300,49000,97.0,109,2023-04-03T22:29,-6860,27440
83,903340,84,35000,0,96.0,25129,2023-04-03T22:29,0,35000
84,1763164,85,49400,52000,96.0,2364,2023-04-03T22:29,0,49400
85,1608272,86,39800,65590,96.0,4078,2023-04-03T22:29,0,39800
86,1458655,87,49800,65000,96.0,756,2023-04-03T22:29,0,49800
87,3064420,88,58100,69000,97.0,30,2023-04-03T22:29,-2905,55195
88,2305840,89,59700,0,97.0,3946,2023-04-03T22:29,0,59700
89,404474,90,27900,47800,94.0,44143,2023-04-03T22:29,0,27900
90,1571879,1,79900,112900,96.0,6999,2023-04-03T22:29,0,79900
91,1558197,2,73690,81900,97.0,32213,2023-04-03T22:29,0,73690
92,1778404,3,42000,45000,96.0,66948,2023-04-03T22:29,0,42000
93,2723218,4,69900,109000,97.0,2106,2023-04-03T22:29,-6990,62910
94,1790383,5,59000,86000,95.0,5371,2023-04-03T22:29,0,59000
95,1283757,6,75490,83900,96.0,26565,2023-04-03T22:29,0,75490
96,3074540,7,53000,97000,100.0,2,2023-04-03T22:29,0,53000
97,2471405,8,89000,138000,97.0,2012,2023-04-03T22:29,0,89000
98,2064545,9,59800,94000,97.0,11027,2023-04-03T22:29,-2990,56810
99,841230,10,154000,172000,96.0,7236,2023-04-03T22:29,0,154000
100,2293391,11,72000,124000,96.0,1798,2023-04-03T22:29,-3600,68400
101,1856181,12,35910,39900,97.0,7246,2023-04-03T22:29,-3591,32319
102,1571878,13,79900,112900,96.0,4641,2023-04-03T22:29,0,79900
103,1833230,14,108800,136000,97.0,5389,2023-04-03T22:29,0,108800
104,1576700,15,89000,129000,97.0,16642,2023-04-03T22:29,0,89000
105,2788216,16,146000,159000,98.0,88,2023-04-03T22:29,0,146000
106,2715055,17,159000,189000,97.0,1968,2023-04-03T22:29,0,159000
107,3012082,18,59900,79000,96.0,899,2023-04-03T22:29,0,59900
108,1618312,19,83900,0,97.0,7063,2023-04-03T22:29,0,83900
109,1530517,20,69900,79000,96.0,2042,2023-04-03T22:29,0,69900
110,3074541,21,53000,97000,92.0,5,2023-04-03T22:29,0,53000
111,2159724,22,29900,32000,95.0,2225,2023-04-03T22:29,0,29900
112,2297046,23,179100,199000,97.0,1674,2023-04-03T22:29,0,179100
113,2732486,24,109000,179000,98.0,640,2023-04-03T22:29,0,109000
114,2329532,25,119200,149000,97.0,3923,2023-04-03T22:29,0,119200
115,3036129,26,59800,94000,95.0,1647,2023-04-03T22:29,-2990,56810
116,1108007,27,79900,0,95.0,47849,2023-04-03T22:29,0,79900
117,1139192,28,71100,94900,97.0,14352,2023-04-03T22:29,-7110,63990
118,1778408,29,42000,45000,95.0,11625,2023-04-03T22:29,0,42000
119,2184463,30,389000,0,98.0,390,2023-04-03T22:29,0,389000
120,1737051,31,62300,89000,96.0,5070,2023-04-03T22:29,0,62300
121,3083811,32,69900,139000,100.0,10,2023-04-03T22:29,0,69900
122,3010527,33,237150,279000,98.0,197,2023-04-03T22:29,0,237150
123,1751722,34,53910,59900,97.0,3351,2023-04-03T22:29,-5391,48519
124,2343198,35,119000,129000,97.0,4976,2023-04-03T22:29,0,119000
125,3098417,36,159000,199000,97.0,517,2023-04-03T22:29,0,159000
126,1337094,37,69900,0,95.0,5333,2023-04-03T22:29,0,69900
127,2752332,38,94700,105300,95.0,2508,2023-04-03T22:29,0,94700
128,3033224,39,59900,74000,97.0,587,2023-04-03T22:29,0,59900
129,1530516,40,69900,79000,96.0,2267,2023-04-03T22:29,0,69900
130,1760177,41,139200,174000,97.0,313,2023-04-03T22:29,0,139200
131,1558683,42,81900,0,97.0,6187,2023-04-03T22:29,0,81900
132,1731130,43,161100,179000,96.0,1774,2023-04-03T22:29,0,161100
133,1195307,44,82400,103000,96.0,12567,2023-04-03T22:29,-8240,74160
134,1776552,45,65000,69000,94.0,6092,2023-04-03T22:29,0,65000
135,3079799,46,95000,159000,100.0,7,2023-04-03T22:29,0,95000
136,2284220,47,79900,112900,96.0,1665,2023-04-03T22:29,0,79900
137,2122596,48,39800,57000,96.0,2632,2023-04-03T22:29,0,39800
138,2288704,49,121000,132000,97.0,3318,2023-04-03T22:29,0,121000
139,3033083,50,97900,109000,95.0,34,2023-04-03T22:29,0,97900
140,2668986,51,35910,39900,96.0,3443,2023-04-03T22:29,-3591,32319
141,3029811,52,63200,79000,97.0,226,2023-04-03T22:29,0,63200
142,3083810,53,69900,139000,0.0,0,2023-04-03T22:29,0,69900
143,2723772,54,109900,169000,94.0,983,2023-04-03T22:29,0,109900
144,2759592,55,59000,79000,96.0,288,2023-04-03T22:29,-11800,47200
145,2712632,56,107000,0,97.0,1314,2023-04-03T22:29,0,107000
146,2890926,57,79200,99000,98.0,49,2023-04-03T22:29,0,79200
147,2718413,58,126650,149000,97.0,1406,2023-04-03T22:29,0,126650
148,1758197,59,59800,94000,97.0,14733,2023-04-03T22:29,-2990,56810
149,1337096,60,69900,0,97.0,2929,2023-04-03T22:29,0,69900
150,2723216,61,69900,109000,97.0,1045,2023-04-03T22:29,-6990,62910
151,3039158,62,259000,0,99.0,20,2023-04-03T22:29,0,259000
152,3042936,63,90900,105000,97.0,309,2023-04-03T22:29,0,90900
153,2379844,64,97300,139000,95.0,119,2023-04-03T22:29,0,97300
154,2288426,65,79000,109000,94.0,795,2023-04-03T22:29,0,79000
155,2286964,66,66300,110500,97.0,4844,2023-04-03T22:29,0,66300
156,1817381,67,47900,69000,96.0,1024,2023-04-03T22:29,0,47900
157,1567183,68,75900,94900,97.0,7401,2023-04-03T22:29,-7590,68310
158,3055246,69,159000,0,98.0,44,2023-04-03T22:29,0,159000
159,2375909,70,80890,89900,98.0,1512,2023-04-03T22:29,0,80890
160,1280576,71,37200,62000,96.0,25141,2023-04-03T22:29,0,37200
161,3037477,72,69900,109000,97.0,204,2023-04-03T22:29,-6990,62910
162,2697873,73,107000,0,97.0,820,2023-04-03T22:29,0,107000
163,1776365,74,71200,89000,96.0,4595,2023-04-03T22:29,-14240,56960
164,3042939,75,88900,95000,93.0,21,2023-04-03T22:29,0,88900
165,1075395,76,137000,228000,95.0,1290,2023-04-03T22:29,0,137000
166,3079674,77,46500,155000,98.0,10,2023-04-03T22:29,0,46500
167,2322836,78,139200,174000,97.0,996,2023-04-03T22:29,0,139200
168,3081572,79,109000,0,96.0,26,2023-04-03T22:29,-10900,98100
169,3010524,80,237150,279000,99.0,37,2023-04-03T22:29,0,237150
170,864404,81,108000,135000,95.0,13370,2023-04-03T22:29,0,108000
171,1593755,82,89360,111700,97.0,14430,2023-04-03T22:29,0,89360
172,1558688,83,73690,81900,97.0,5704,2023-04-03T22:29,0,73690
173,1633664,84,76300,109000,97.0,4155,2023-04-03T22:29,0,76300
174,2683549,85,119200,149000,97.0,2535,2023-04-03T22:29,-5960,113240
175,2110493,86,389000,0,96.0,622,2023-04-03T22:29,0,389000
176,2086731,87,95000,129000,97.0,2198,2023-04-03T22:29,0,95000
177,3058495,88,198000,220000,98.0,60,2023-04-03T22:29,0,198000
178,2343199,89,119000,129000,98.0,1785,2023-04-03T22:29,0,119000
179,2702015,90,79800,99000,95.0,708,2023-04-03T22:29,0,79800
180,3154689,1,49800,63000,0.0,0,2023-04-03T22:29,-4980,44820
181,3154647,2,49800,63000,0.0,0,2023-04-03T22:29,-4980,44820
182,3154694,3,49800,63000,0.0,0,2023-04-03T22:29,-4980,44820
183,3154696,4,49800,63000,0.0,0,2023-04-03T22:29,-4980,44820
184,3154688,5,49800,63000,0.0,0,2023-04-03T22:29,-4980,44820
185,3154648,6,49800,63000,0.0,0,2023-04-03T22:29,-4980,44820
186,3154697,7,49800,63000,0.0,0,2023-04-03T22:29,-4980,44820
187,3154699,8,49800,63000,0.0,0,2023-04-03T22:29,-4980,44820
188,3154691,9,49800,63000,0.0,0,2023-04-03T22:29,-4980,44820
189,2112059,10,36400,0,97.0,42610,2023-04-03T22:29,-3640,32760
190,3154652,11,49800,63000,0.0,0,2023-04-03T22:29,-4980,44820
191,750908,12,34900,54000,96.0,83817,2023-04-03T22:29,0,34900
192,3154690,13,49800,63000,0.0,0,2023-04-03T22:29,-4980,44820
193,3154649,14,49800,63000,0.0,0,2023-04-03T22:29,-4980,44820
194,3154692,15,49800,63000,0.0,0,2023-04-03T22:29,-4980,44820
195,1149329,16,39900,0,96.0,85756,2023-04-03T22:29,0,39900
196,1551840,17,39000,0,97.0,83390,2023-04-03T22:29,0,39000
197,2060719,18,55200,69000,96.0,5035,2023-04-03T22:29,-2760,52440
198,2092852,19,42000,52800,96.0,10993,2023-04-03T22:29,-2100,39900
199,2929838,20,69550,107000,96.0,349,2023-04-03T22:29,0,69550
200,1168906,21,41900,0,97.0,70841,2023-04-03T22:29,0,41900
201,1149328,22,39900,0,96.0,94399,2023-04-03T22:29,0,39900
202,858911,23,39000,49000,95.0,66769,2023-04-03T22:29,0,39000
203,1370101,24,39000,89000,96.0,22736,2023-04-03T22:29,-1950,37050
204,1568057,25,49600,62000,96.0,22167,2023-04-03T22:29,0,49600
205,999426,26,37900,56800,94.0,45535,2023-04-03T22:29,0,37900
206,2028327,27,49900,0,97.0,8985,2023-04-03T22:29,0,49900
207,2112061,28,33900,52000,97.0,14506,2023-04-03T22:29,0,33900
208,1924274,29,49900,66000,95.0,22441,2023-04-03T22:29,-4990,44910
209,1844581,30,43900,65800,96.0,4624,2023-04-03T22:29,0,43900
210,2060717,31,55200,69000,95.0,3701,2023-04-03T22:29,-2760,52440
211,2060720,32,55200,69000,95.0,2518,2023-04-03T22:29,-2760,52440
212,2711142,33,39800,54000,96.0,943,2023-04-03T22:29,0,39800
213,1736085,34,39900,59800,96.0,36545,2023-04-03T22:29,0,39900
214,1552753,35,62400,78000,97.0,28098,2023-04-03T22:29,-6240,56160
215,1926048,36,32000,0,97.0,14599,2023-04-03T22:29,0,32000
216,1573215,37,133200,148000,98.0,9244,2023-04-03T22:29,0,133200
217,1551839,38,39000,0,97.0,23366,2023-04-03T22:29,0,39000
218,2678399,39,33900,69000,96.0,611,2023-04-03T22:29,0,33900
219,2184087,40,49000,89000,96.0,4059,2023-04-03T22:29,-2450,46550
220,2297033,41,134100,149000,97.0,1828,2023-04-03T22:29,0,134100
221,1867371,42,39900,49000,96.0,2036,2023-04-03T22:29,0,39900
222,1222184,43,41900,0,97.0,48276,2023-04-03T22:29,0,41900
223,3098372,44,89000,139000,97.0,808,2023-04-03T22:29,0,89000
224,3037465,45,45500,56900,94.0,211,2023-04-03T22:29,-4550,40950
225,2060743,46,33000,55000,95.0,3505,2023-04-03T22:29,0,33000
226,2060759,47,59800,74800,97.0,7131,2023-04-03T22:29,-2990,56810
227,2737165,48,69000,79000,96.0,2589,2023-04-03T22:29,-3450,65550
228,1477272,49,44200,68000,96.0,17764,2023-04-03T22:29,0,44200
229,2723714,50,52000,58000,96.0,1488,2023-04-03T22:29,0,52000
230,2789091,51,79200,99000,96.0,719,2023-04-03T22:29,-3960,75240
231,1555407,52,62400,78000,97.0,11478,2023-04-03T22:29,-6240,56160
232,890338,53,39000,49000,95.0,47626,2023-04-03T22:29,0,39000
233,1224095,54,35890,39900,97.0,24347,2023-04-03T22:29,0,35890
234,2754954,55,64350,99000,96.0,244,2023-04-03T22:29,0,64350
235,2392464,56,33900,0,95.0,3722,2023-04-03T22:29,0,33900
236,2131950,57,39000,49000,96.0,3793,2023-04-03T22:29,0,39000
237,2503133,58,42000,52800,96.0,3067,2023-04-03T22:29,-2100,39900
238,2092849,59,42000,52800,96.0,9700,2023-04-03T22:29,-2100,39900
239,1568032,60,49600,62000,96.0,6087,2023-04-03T22:29,0,49600
240,3141395,61,49900,73900,97.0,149,2023-04-03T22:29,-4990,44910
241,890521,62,39800,63000,94.0,11048,2023-04-03T22:29,0,39800
242,2351467,63,29000,54000,96.0,6030,2023-04-03T22:29,0,29000
243,2706287,64,39800,54000,95.0,3688,2023-04-03T22:29,0,39800
244,2411327,65,65000,139000,97.0,4034,2023-04-03T22:29,0,65000
245,1595607,66,57900,89000,97.0,5673,2023-04-03T22:29,-5790,52110
246,2569078,67,79000,0,96.0,2410,2023-04-03T22:29,0,79000
247,1985223,68,39000,89000,96.0,1599,2023-04-03T22:29,-1950,37050
248,1666442,69,49900,0,97.0,10874,2023-04-03T22:29,0,49900
249,1985224,70,39000,89000,96.0,1776,2023-04-03T22:29,-1950,37050
250,1627892,71,43900,0,97.0,10748,2023-04-03T22:29,0,43900
251,1440874,72,39900,0,95.0,15111,2023-04-03T22:29,0,39900
252,3098405,73,99000,149000,96.0,759,2023-04-03T22:29,0,99000
253,2578996,74,39900,59000,95.0,4640,2023-04-03T22:29,0,39900
254,2789111,75,79200,99000,97.0,790,2023-04-03T22:29,-3960,75240
255,2028326,76,49900,0,97.0,6088,2023-04-03T22:29,0,49900
256,1323090,77,73600,92000,96.0,5958,2023-04-03T22:29,0,73600
257,2744549,78,49600,62000,97.0,5014,2023-04-03T22:29,0,49600
258,2562527,79,29400,42000,97.0,3944,2023-04-03T22:29,-2940,26460
259,2392465,80,33900,0,95.0,2427,2023-04-03T22:29,0,33900
260,2032901,81,39900,0,97.0,6760,2023-04-03T22:29,0,39900
261,2534798,82,43400,62000,96.0,1945,2023-04-03T22:29,0,43400
262,2503134,83,42000,52800,96.0,5296,2023-04-03T22:29,-2100,39900
263,2742472,84,121500,135000,98.0,74,2023-04-03T22:29,0,121500
264,2479983,85,55200,69000,95.0,945,2023-04-03T22:29,-5520,49680
265,1168922,86,43900,0,96.0,18122,2023-04-03T22:29,0,43900
266,2749153,87,66600,74000,97.0,539,2023-04-03T22:29,0,66600
267,2049103,88,62400,78000,97.0,7113,2023-04-03T22:29,-6240,56160
268,2479939,89,51750,69000,94.0,2139,2023-04-03T22:29,-5175,46575
269,2346629,90,99000,130000,97.0,699,2023-04-03T22:29,0,99000
270,1789507,1,69900,79000,98.0,25745,2023-04-03T22:29,-6990,62910
271,1034480,2,135000,150000,97.0,18000,2023-04-03T22:29,0,135000
272,1969507,3,88000,0,98.0,5339,2023-04-03T22:29,0,88000
273,2066837,4,69000,119000,97.0,6443,2023-04-03T22:29,-13800,55200
274,1264107,5,65000,90000,97.0,6323,2023-04-03T22:29,0,65000
275,3034751,6,64800,72000,97.0,413,2023-04-03T22:29,0,64800
276,2702033,7,127200,159000,97.0,392,2023-04-03T22:29,-25440,101760
277,2344538,8,119000,0,98.0,6328,2023-04-03T22:29,0,119000
278,2235274,9,145000,0,97.0,681,2023-04-03T22:29,0,145000
279,3038000,10,74700,83000,96.0,322,2023-04-03T22:29,-14940,59760
280,2584181,11,57600,72000,98.0,967,2023-04-03T22:29,0,57600
281,2320927,12,39000,51000,97.0,2095,2023-04-03T22:29,-3900,35100
282,693318,13,79000,110000,96.0,13151,2023-04-03T22:29,0,79000
283,1842449,14,84000,99000,97.0,5352,2023-04-03T22:29,0,84000
284,2344540,15,96000,0,98.0,9168,2023-04-03T22:29,0,96000
285,342189,16,39500,52000,95.0,15696,2023-04-03T22:29,0,39500
286,1744101,17,103500,109000,98.0,2885,2023-04-03T22:29,0,103500
287,2911060,18,413000,650000,95.0,14,2023-04-03T22:29,0,413000
288,1581689,19,75600,89000,97.0,3943,2023-04-03T22:29,-3780,71820
289,3050558,20,2089000,3290000,100.0,1,2023-04-03T22:29,0,2089000
290,2271789,21,71100,79000,97.0,2492,2023-04-03T22:29,0,71100
291,1564343,22,92800,119000,98.0,8076,2023-04-03T22:29,-6496,86304
292,3011494,23,69900,79000,96.0,222,2023-04-03T22:29,0,69900
293,2325729,24,87200,109000,97.0,782,2023-04-03T22:29,-17440,69760
294,1969488,25,88000,0,98.0,1717,2023-04-03T22:29,0,88000
295,2753709,26,1790000,2268000,100.0,12,2023-04-03T22:29,0,1790000
296,2558648,27,119000,0,98.0,1246,2023-04-03T22:29,0,119000
297,1528287,28,49000,0,96.0,4572,2023-04-03T22:29,0,49000
298,2770508,29,138000,0,97.0,325,2023-04-03T22:29,0,138000
299,1790465,30,141000,188000,98.0,607,2023-04-03T22:29,-28200,112800
300,2306062,31,79000,139000,97.0,1169,2023-04-03T22:29,-15800,63200
301,1964770,32,59400,66000,97.0,2476,2023-04-03T22:29,-11880,47520
302,2789785,33,140600,148000,97.0,575,2023-04-03T22:29,0,140600
303,3047568,34,109650,129000,95.0,41,2023-04-03T22:29,0,109650
304,2343665,35,89000,0,97.0,4546,2023-04-03T22:29,0,89000
305,2514819,36,55000,66000,97.0,803,2023-04-03T22:29,-2750,52250
306,2930578,37,1508000,2290000,100.0,5,2023-04-03T22:29,0,1508000
307,3048800,38,2081000,4630000,0.0,0,2023-04-03T22:29,0,2081000
308,1736022,39,169200,188000,95.0,426,2023-04-03T22:29,-16920,152280
309,2630526,40,100000,0,96.0,613,2023-04-03T22:29,0,100000
310,2679537,41,145800,162000,95.0,94,2023-04-03T22:29,-14580,131220
311,3142123,42,290000,0,100.0,12,2023-04-03T22:29,0,290000
312,1910358,43,89100,99000,98.0,2455,2023-04-03T22:29,0,89100
313,2930265,44,91000,0,98.0,541,2023-04-03T22:29,0,91000
314,938746,45,80100,89000,95.0,12509,2023-04-03T22:29,0,80100
315,2657250,46,125400,149000,98.0,114,2023-04-03T22:29,0,125400
316,2624678,47,145000,0,96.0,130,2023-04-03T22:29,0,145000
317,2856864,48,1339000,2167000,0.0,0,2023-04-03T22:29,0,1339000
318,1320752,49,67800,135000,97.0,4722,2023-04-03T22:29,-3390,64410
319,1758217,50,43900,56000,97.0,13104,2023-04-03T22:29,-2195,41705
320,3045584,51,130500,145000,97.0,3766,2023-04-03T22:29,0,130500
321,3029926,52,285000,0,99.0,46,2023-04-03T22:29,-28500,256500
322,3020963,53,322150,379000,100.0,6,2023-04-03T22:29,0,322150
323,3034745,54,84000,0,97.0,163,2023-04-03T22:29,0,84000
324,1597319,55,89100,99000,97.0,577,2023-04-03T22:29,-8910,80190
325,2408317,56,145800,162000,96.0,362,2023-04-03T22:29,-14580,131220
326,2422175,57,137700,162000,98.0,196,2023-04-03T22:29,0,137700
327,2998775,58,142200,158000,96.0,476,2023-04-03T22:29,0,142200
328,2527611,59,88000,0,98.0,253,2023-04-03T22:29,0,88000
329,1534526,60,55000,0,97.0,2418,2023-04-03T22:29,0,55000
330,1216585,61,29800,59000,95.0,13905,2023-04-03T22:29,-2980,26820
331,2744332,62,143100,159000,98.0,193,2023-04-03T22:29,0,143100
332,2975285,63,55250,65000,98.0,301,2023-04-03T22:29,0,55250
333,1969479,64,88000,0,98.0,1103,2023-04-03T22:29,0,88000
334,3101111,65,179000,0,96.0,40,2023-04-03T22:29,0,179000
335,2902041,66,357000,599000,98.0,34,2023-04-03T22:29,0,357000
336,2002697,67,67900,76000,97.0,3444,2023-04-03T22:29,-6790,61110
337,2245910,68,46000,69000,95.0,713,2023-04-03T22:29,-4600,41400
338,2688604,69,139000,159000,97.0,841,2023-04-03T22:29,-13900,125100
339,2059496,70,71200,89000,97.0,1522,2023-04-03T22:29,-4984,66216
340,1323612,71,238000,0,97.0,3820,2023-04-03T22:29,-11900,226100
341,3082387,72,139000,0,98.0,118,2023-04-03T22:29,-13900,125100
342,2993947,73,100000,0,96.0,141,2023-04-03T22:29,0,100000
343,2344209,74,109000,0,97.0,589,2023-04-03T22:29,0,109000
344,2235273,75,145000,0,98.0,178,2023-04-03T22:29,0,145000
345,1884626,76,36800,46000,97.0,4902,2023-04-03T22:29,0,36800
346,2131984,77,151050,159000,97.0,232,2023-04-03T22:29,-7553,143497
347,3038001,78,74700,83000,97.0,77,2023-04-03T22:29,-14940,59760
348,2112607,79,178000,0,97.0,347,2023-04-03T22:29,0,178000
349,1453531,80,53000,59000,96.0,2981,2023-04-03T22:29,-5300,47700
350,1247560,81,69900,79000,96.0,4252,2023-04-03T22:29,-6990,62910
351,3034749,82,64800,72000,97.0,404,2023-04-03T22:29,0,64800
352,2954959,83,95000,0,95.0,191,2023-04-03T22:29,0,95000
353,913402,84,83000,98000,95.0,8028,2023-04-03T22:29,0,83000
354,1745100,85,103500,109000,97.0,981,2023-04-03T22:29,0,103500
355,2614124,86,98000,0,97.0,269,2023-04-03T22:29,0,98000
356,2371565,87,888000,1072000,100.0,1,2023-04-03T22:29,0,888000
357,2668835,88,107100,119000,98.0,870,2023-04-03T22:29,-10710,96390
358,1524204,89,62100,69000,96.0,3398,2023-04-03T22:29,0,62100
359,2491355,90,74610,82900,98.0,458,2023-04-03T22:29,0,74610
360,2673444,1,89900,149000,96.0,255,2023-04-03T22:29,0,89900
361,1762407,2,260000,0,97.0,3174,2023-04-03T22:29,0,260000
362,1762406,3,260000,0,98.0,3279,2023-04-03T22:29,0,260000
363,2638067,4,99000,139000,97.0,3009,2023-04-03T22:29,0,99000
364,810034,5,85500,95000,97.0,45146,2023-04-03T22:29,0,85500
365,969541,6,69000,0,97.0,29364,2023-04-03T22:29,0,69000
366,2859859,7,62900,79000,94.0,159,2023-04-03T22:29,0,62900
367,695334,8,78900,99000,96.0,9300,2023-04-03T22:29,0,78900
368,2293400,9,129000,0,96.0,936,2023-04-03T22:29,0,129000
369,1622068,10,119000,0,97.0,6565,2023-04-03T22:29,0,119000
370,311052,11,53100,59000,97.0,41103,2023-04-03T22:29,0,53100
371,2970200,12,79000,0,98.0,461,2023-04-03T22:29,0,79000
372,490136,13,76000,95000,98.0,2179,2023-04-03T22:29,0,76000
373,810033,14,89100,99000,97.0,34217,2023-04-03T22:29,0,89100
374,2854905,15,87000,109000,97.0,980,2023-04-03T22:29,0,87000
375,1990244,16,129000,0,98.0,1058,2023-04-03T22:29,0,129000
376,2970197,17,79000,0,98.0,207,2023-04-03T22:29,0,79000
377,181907,18,89900,119000,97.0,7098,2023-04-03T22:29,0,89900
378,490135,19,75900,95000,97.0,3238,2023-04-03T22:29,0,75900
379,810032,20,85500,95000,97.0,13725,2023-04-03T22:29,0,85500
380,3091287,21,119000,0,98.0,277,2023-04-03T22:29,0,119000
381,577636,22,99900,139000,95.0,31137,2023-04-03T22:29,0,99900
382,3017614,23,84900,109000,94.0,7,2023-04-03T22:29,0,84900
383,2320478,24,129000,0,97.0,483,2023-04-03T22:29,0,129000
384,1493265,25,85500,95000,98.0,4878,2023-04-03T22:29,0,85500
385,2161992,26,69900,95000,98.0,3247,2023-04-03T22:29,0,69900
386,1478592,27,75900,95000,97.0,2957,2023-04-03T22:29,0,75900
387,2120895,28,55000,69000,95.0,1439,2023-04-03T22:29,0,55000
388,2741233,29,109000,0,97.0,2686,2023-04-03T22:29,0,109000
389,3079037,30,195000,0,97.0,208,2023-04-03T22:29,0,195000
390,2731878,31,67900,79000,97.0,1604,2023-04-03T22:29,0,67900
391,3030422,32,139000,0,96.0,822,2023-04-03T22:29,0,139000
392,2233180,33,75900,109000,97.0,14153,2023-04-03T22:29,0,75900
393,490134,34,75900,95000,97.0,1980,2023-04-03T22:29,0,75900
394,102620,35,69000,0,97.0,17812,2023-04-03T22:29,0,69000
395,2801304,36,414000,700000,98.0,181,2023-04-03T22:29,0,414000
396,1493263,37,89100,99000,98.0,4194,2023-04-03T22:29,0,89100
397,816033,38,70900,89000,96.0,13254,2023-04-03T22:29,0,70900
398,3033248,39,109000,0,97.0,620,2023-04-03T22:29,0,109000
399,1686571,40,76900,129000,97.0,5420,2023-04-03T22:29,0,76900
400,311050,41,53100,59000,97.0,9012,2023-04-03T22:29,0,53100
401,1955217,42,69000,109000,96.0,5160,2023-04-03T22:29,-13800,55200
402,3096431,43,139000,0,99.0,31,2023-04-03T22:29,0,139000
403,2733049,44,79900,119000,96.0,502,2023-04-03T22:29,0,79900
404,2469965,45,94900,149000,96.0,1085,2023-04-03T22:29,0,94900
405,186610,46,75900,85000,97.0,16500,2023-04-03T22:29,0,75900
406,1900410,47,129000,0,97.0,4865,2023-04-03T22:29,0,129000
407,1792640,48,99000,0,98.0,3486,2023-04-03T22:29,0,99000
408,2756002,49,125800,148000,95.0,100,2023-04-03T22:29,-6290,119510
409,1296778,50,99000,0,98.0,2076,2023-04-03T22:29,0,99000
410,2233178,51,75900,109000,97.0,4927,2023-04-03T22:29,0,75900
411,2440110,52,59900,0,97.0,967,2023-04-03T22:29,-4010,55890
412,1473136,53,119900,149000,97.0,10771,2023-04-03T22:29,0,119900
413,1296776,54,99000,0,98.0,2924,2023-04-03T22:29,0,99000
414,2524840,55,139000,0,97.0,836,2023-04-03T22:29,0,139000
415,2778805,56,99000,0,97.0,970,2023-04-03T22:29,0,99000
416,1608838,57,85000,0,97.0,12595,2023-04-03T22:29,0,85000
417,810036,58,85500,95000,97.0,5122,2023-04-03T22:29,0,85500
418,311051,59,58500,65000,97.0,19550,2023-04-03T22:29,0,58500
419,1494180,60,71100,79000,95.0,5233,2023-04-03T22:29,0,71100
420,1256468,61,109000,0,97.0,3552,2023-04-03T22:29,0,109000
421,1744960,62,119900,149000,97.0,8216,2023-04-03T22:29,0,119900
422,2239046,63,306000,0,98.0,253,2023-04-03T22:29,-45900,260100
423,2616945,64,43900,85000,96.0,126,2023-04-03T22:29,0,43900
424,2616946,65,39900,85000,93.0,55,2023-04-03T22:29,0,39900
425,716244,66,54900,95000,98.0,1147,2023-04-03T22:29,0,54900
426,2909715,67,119000,0,96.0,82,2023-04-03T22:29,0,119000
427,1729744,68,76500,85000,97.0,3334,2023-04-03T22:29,0,76500
428,1594352,69,85000,0,97.0,5563,2023-04-03T22:29,0,85000
429,2312772,70,69900,139800,96.0,1352,2023-04-03T22:29,0,69900
430,2786814,71,149000,0,98.0,173,2023-04-03T22:29,0,149000
431,1635193,72,69900,0,96.0,3667,2023-04-03T22:29,0,69900
432,957758,73,89000,0,97.0,4424,2023-04-03T22:29,0,89000
433,3023103,74,260000,0,98.0,71,2023-04-03T22:29,0,260000
434,2622254,75,109000,0,98.0,885,2023-04-03T22:29,0,109000
435,1130307,76,109000,0,97.0,6040,2023-04-03T22:29,0,109000
436,1853613,77,130000,0,96.0,100,2023-04-03T22:29,0,130000
437,2662649,78,485000,790000,98.0,192,2023-04-03T22:29,0,485000
438,2691016,79,306000,0,98.0,187,2023-04-03T22:29,-45900,260100
439,2795941,80,135000,150000,100.0,1,2023-04-03T22:29,0,135000
440,1943503,81,25000,69000,95.0,460,2023-04-03T22:29,0,25000
441,3005191,82,169000,0,96.0,176,2023-04-03T22:29,0,169000
442,3023097,83,230000,0,98.0,89,2023-04-03T22:29,0,230000
443,2631192,84,98100,109000,98.0,349,2023-04-03T22:29,0,98100
444,2638808,85,139000,0,97.0,746,2023-04-03T22:29,0,139000
445,2266983,86,85500,95000,98.0,436,2023-04-03T22:29,0,85500
446,3136289,87,89100,99000,99.0,29,2023-04-03T22:29,0,89100
447,2229208,88,109000,0,97.0,1599,2023-04-03T22:29,0,109000
448,2916273,89,159000,0,98.0,151,2023-04-03T22:29,0,159000
449,2893832,90,59900,99000,91.0,45,2023-04-03T22:29,0,59900
450,1092992,1,69000,0,97.0,37743,2023-04-03T22:29,0,69000
451,2816812,2,119900,0,92.0,1514,2023-04-03T22:29,0,119900
452,2091749,3,75650,89000,95.0,6202,2023-04-03T22:29,0,75650
453,1339622,4,42900,59000,97.0,16238,2023-04-03T22:29,0,42900
454,2430426,5,169000,0,98.0,725,2023-04-03T22:29,0,169000
455,595040,6,210000,0,95.0,8727,2023-04-03T22:29,0,210000
456,3161736,7,67900,158000,0.0,0,2023-04-03T22:29,0,67900
457,1419869,8,66600,74000,95.0,10544,2023-04-03T22:29,0,66600
458,595039,9,210000,0,97.0,3495,2023-04-03T22:29,0,210000
459,3024585,10,59000,0,97.0,95,2023-04-03T22:29,0,59000
460,2433538,11,86700,102000,96.0,2367,2023-04-03T22:29,0,86700
461,1890398,12,132000,168000,96.0,2710,2023-04-03T22:29,0,132000
462,1720813,13,149000,0,97.0,409,2023-04-03T22:29,0,149000
463,2395327,14,149000,0,97.0,543,2023-04-03T22:29,0,149000
464,2432733,15,44900,59000,97.0,2756,2023-04-03T22:29,0,44900
465,2735953,16,207000,230000,98.0,397,2023-04-03T22:29,0,207000
466,2101924,17,99900,0,96.0,1356,2023-04-03T22:29,0,99900
467,1568047,18,143100,159000,95.0,12002,2023-04-03T22:29,0,143100
468,1334438,19,170000,0,96.0,4385,2023-04-03T22:29,0,170000
469,1021359,20,76000,100000,94.0,5375,2023-04-03T22:29,0,76000
470,2440524,21,69000,0,97.0,1500,2023-04-03T22:29,-6900,62100
471,1720827,22,169000,0,98.0,571,2023-04-03T22:29,0,169000
472,3062046,23,78300,87000,97.0,82,2023-04-03T22:29,0,78300
473,1439535,24,49000,0,96.0,16301,2023-04-03T22:29,0,49000
474,1730340,25,258000,0,97.0,4160,2023-04-03T22:29,0,258000
475,595038,26,210000,0,96.0,1322,2023-04-03T22:29,0,210000
476,1129750,27,69000,0,97.0,3905,2023-04-03T22:29,0,69000
477,2419871,28,44900,59000,97.0,891,2023-04-03T22:29,0,44900
478,1952910,29,265500,295000,98.0,1723,2023-04-03T22:29,0,265500
479,3156676,30,259000,299000,98.0,19,2023-04-03T22:29,-12950,246050
480,2664372,31,65000,0,97.0,1027,2023-04-03T22:29,0,65000
481,2624538,32,40900,59000,97.0,1411,2023-04-03T22:29,0,40900
482,2355318,33,109900,0,96.0,638,2023-04-03T22:29,0,109900
483,3075621,34,339000,0,98.0,63,2023-04-03T22:29,0,339000
484,1720822,35,209000,0,97.0,294,2023-04-03T22:29,0,209000
485,3061996,36,88200,98000,97.0,61,2023-04-03T22:29,0,88200
486,607298,37,53600,59000,93.0,15569,2023-04-03T22:29,0,53600
487,1262089,38,300000,0,97.0,1587,2023-04-03T22:29,0,300000
488,2379000,39,151500,159000,97.0,109,2023-04-03T22:29,0,151500
489,2363570,40,39900,55000,97.0,966,2023-04-03T22:29,0,39900
490,2305529,41,132000,168000,98.0,85,2023-04-03T22:29,0,132000
491,2856859,42,924000,1663000,0.0,0,2023-04-03T22:29,0,924000
492,3049313,43,57100,64900,97.0,499,2023-04-03T22:29,0,57100
493,2306631,44,24900,0,96.0,2062,2023-04-03T22:29,0,24900
494,1215246,45,54300,110000,95.0,355,2023-04-03T22:29,0,54300
495,501198,46,129000,139000,95.0,2739,2023-04-03T22:29,0,129000
496,3084457,47,138000,197000,100.0,5,2023-04-03T22:29,-13800,124200
497,1562988,48,260000,0,97.0,1477,2023-04-03T22:29,0,260000
498,2143833,49,91800,108000,96.0,2400,2023-04-03T22:29,0,91800
499,3143034,50,47500,79000,0.0,0,2023-04-03T22:29,0,47500
500,2330198,51,59000,0,97.0,392,2023-04-03T22:29,0,59000
501,1973858,52,143200,179000,98.0,1183,2023-04-03T22:29,0,143200
502,3132471,53,79000,0,0.0,0,2023-04-03T22:29,-7900,71100
503,1419871,54,66600,74000,94.0,1818,2023-04-03T22:29,0,66600
504,3093902,55,169000,0,98.0,16,2023-04-03T22:29,0,169000
505,2664373,56,65000,0,97.0,996,2023-04-03T22:29,0,65000
506,3124961,57,62100,69000,97.0,48,2023-04-03T22:29,0,62100
507,1755977,58,31500,45000,95.0,4152,2023-04-03T22:29,0,31500
508,2257886,59,109000,119000,95.0,1429,2023-04-03T22:29,0,109000
509,1699941,60,67150,79000,97.0,4815,2023-04-03T22:29,0,67150
510,2435822,61,94500,99000,97.0,224,2023-04-03T22:29,0,94500
511,2599641,62,67830,119000,96.0,1995,2023-04-03T22:29,-3392,64438
512,1754219,63,31200,39000,96.0,2241,2023-04-03T22:29,0,31200
513,2910082,64,265500,295000,98.0,463,2023-04-03T22:29,0,265500
514,2383245,65,99000,0,98.0,809,2023-04-03T22:29,0,99000
515,2910086,66,265500,295000,98.0,181,2023-04-03T22:29,0,265500
516,2621831,67,64000,85000,95.0,706,2023-04-03T22:29,-6400,57600
517,1995630,68,210000,0,97.0,142,2023-04-03T22:29,0,210000
518,499300,69,220000,0,96.0,880,2023-04-03T22:29,0,220000
519,2816816,70,159900,0,97.0,1847,2023-04-03T22:29,0,159900
520,3097632,71,95000,0,0.0,0,2023-04-03T22:29,0,95000
521,3132539,72,69000,0,100.0,2,2023-04-03T22:29,-6900,62100
522,2071613,73,99000,0,92.0,1494,2023-04-03T22:29,0,99000
523,1438359,74,98000,0,97.0,1170,2023-04-03T22:29,0,98000
524,3132541,75,69000,0,100.0,8,2023-04-03T22:29,-6900,62100
525,1815709,76,132000,168000,96.0,7122,2023-04-03T22:29,0,132000
526,2541536,77,170000,0,97.0,64,2023-04-03T22:29,0,170000
527,324275,78,59000,0,94.0,12910,2023-04-03T22:29,0,59000
528,1419860,79,62100,69000,92.0,4072,2023-04-03T22:29,0,62100
529,2741208,80,98890,109900,96.0,175,2023-04-03T22:29,0,98890
530,3052437,81,139500,155000,97.0,39,2023-04-03T22:29,-27900,111600
531,1334440,82,119000,170000,96.0,2053,2023-04-03T22:29,0,119000
532,451851,83,268000,0,97.0,1946,2023-04-03T22:29,0,268000
533,3062069,84,71100,79000,98.0,24,2023-04-03T22:29,0,71100
534,2931969,85,390000,815000,100.0,2,2023-04-03T22:29,0,390000
535,1419850,86,62100,69000,94.0,1724,2023-04-03T22:29,0,62100
536,1439527,87,49000,0,95.0,13424,2023-04-03T22:29,0,49000
537,1262092,88,250000,0,96.0,766,2023-04-03T22:29,0,250000
538,2210201,89,259000,299000,94.0,193,2023-04-03T22:29,-12950,246050
539,3143035,90,47500,79000,0.0,0,2023-04-03T22:29,0,47500
540,1214164,1,36000,0,96.0,24863,2023-04-03T22:29,0,36000
541,2280117,2,35100,39000,97.0,6185,2023-04-03T22:29,0,35100
542,1771137,3,29000,0,97.0,12430,2023-04-03T22:29,0,29000
543,2134140,4,39000,0,97.0,3476,2023-04-03T22:29,0,39000
544,1214174,5,36000,0,97.0,14989,2023-04-03T22:29,0,36000
545,1272626,6,36000,0,96.0,14093,2023-04-03T22:29,0,36000
546,2879419,7,46900,55000,98.0,657,2023-04-03T22:29,0,46900
547,1214109,8,36000,0,97.0,8085,2023-04-03T22:29,0,36000
548,1214173,9,36000,0,96.0,5542,2023-04-03T22:29,0,36000
549,2286829,10,37000,0,95.0,4897,2023-04-03T22:29,0,37000
550,1822717,11,56050,59000,97.0,4277,2023-04-03T22:29,-2803,53247
551,1907733,12,29900,39000,96.0,3806,2023-04-03T22:29,0,29900
552,1214317,13,36000,0,97.0,11458,2023-04-03T22:29,0,36000
553,2356711,14,39000,0,98.0,1473,2023-04-03T22:29,0,39000
554,1214169,15,36000,0,97.0,5308,2023-04-03T22:29,0,36000
555,2123132,16,39000,0,97.0,6373,2023-04-03T22:29,-3900,35100
556,1771132,17,29000,0,96.0,5224,2023-04-03T22:29,0,29000
557,1855444,18,37800,42000,97.0,2996,2023-04-03T22:29,0,37800
558,1925814,19,35100,39000,96.0,1637,2023-04-03T22:29,0,35100
559,1022013,20,79000,0,96.0,6254,2023-04-03T22:29,0,79000
560,2879425,21,46900,55000,98.0,254,2023-04-03T22:29,0,46900
561,3012243,22,29900,39900,98.0,58,2023-04-03T22:29,0,29900
562,1920929,23,39000,0,97.0,3960,2023-04-03T22:29,0,39000
563,1524720,24,36000,0,96.0,3367,2023-04-03T22:29,0,36000
564,2221221,25,35100,39000,96.0,1846,2023-04-03T22:29,0,35100
565,1906772,26,37800,42000,97.0,3042,2023-04-03T22:29,0,37800
566,1771133,27,29000,0,97.0,5664,2023-04-03T22:29,0,29000
567,2356713,28,39000,0,97.0,1436,2023-04-03T22:29,0,39000
568,2329375,29,34710,39000,96.0,2068,2023-04-03T22:29,0,34710
569,3039055,30,34400,43000,92.0,28,2023-04-03T22:29,0,34400
570,1214106,31,36000,0,96.0,9718,2023-04-03T22:29,0,36000
571,2028240,32,39000,0,98.0,3336,2023-04-03T22:29,0,39000
572,2672186,33,20900,30000,96.0,556,2023-04-03T22:29,-2090,18810
573,2280146,34,35100,39000,97.0,914,2023-04-03T22:29,0,35100
574,1335132,35,29000,0,95.0,1100,2023-04-03T22:29,0,29000
575,2464070,36,44000,55000,96.0,329,2023-04-03T22:29,-2200,41800
576,2287131,37,37000,0,95.0,1597,2023-04-03T22:29,0,37000
577,3142351,38,49000,0,100.0,8,2023-04-03T22:29,-4900,44100
578,2107999,39,36000,0,97.0,2652,2023-04-03T22:29,0,36000
579,1452917,40,69000,0,96.0,2406,2023-04-03T22:29,0,69000
580,2134158,41,39000,0,97.0,2480,2023-04-03T22:29,0,39000
581,2687157,42,45000,0,97.0,1020,2023-04-03T22:29,0,45000
582,3129450,43,44100,49000,0.0,0,2023-04-03T22:29,0,44100
583,2962388,44,31200,39000,96.0,116,2023-04-03T22:29,0,31200
584,3153584,45,45000,0,99.0,21,2023-04-03T22:29,-2250,42750
585,1022014,46,79000,0,96.0,11422,2023-04-03T22:29,0,79000
586,2324622,47,35700,42000,96.0,73,2023-04-03T22:29,0,35700
587,1497550,48,29600,37000,95.0,5667,2023-04-03T22:29,0,29600
588,2424822,49,35100,39000,96.0,1041,2023-04-03T22:29,-7020,28080
589,2560668,50,58650,69000,97.0,1236,2023-04-03T22:29,0,58650
590,2922336,51,52000,0,97.0,134,2023-04-03T22:29,0,52000
591,1214171,52,36000,0,97.0,1697,2023-04-03T22:29,0,36000
592,2280751,53,29000,0,97.0,1332,2023-04-03T22:29,0,29000
593,2591291,54,39200,49000,97.0,1016,2023-04-03T22:29,0,39200
594,2715553,55,68000,0,95.0,255,2023-04-03T22:29,0,68000
595,3132121,56,37800,42000,0.0,0,2023-04-03T22:29,0,37800
596,1300684,57,41300,59000,92.0,245,2023-04-03T22:29,0,41300
597,1086824,58,29600,37000,95.0,18609,2023-04-03T22:29,0,29600
598,2364344,59,26600,38000,97.0,1678,2023-04-03T22:29,0,26600
599,3142358,60,63000,0,100.0,1,2023-04-03T22:29,-6300,56700
600,2051581,61,33000,0,96.0,856,2023-04-03T22:29,0,33000
601,1744607,62,27300,39000,95.0,271,2023-04-03T22:29,0,27300
602,2894906,63,154000,207000,98.0,11,2023-04-03T22:29,0,154000
603,2650964,64,46900,53000,98.0,181,2023-04-03T22:29,0,46900
604,2089719,65,36000,0,97.0,2396,2023-04-03T22:29,0,36000
605,1760824,66,49700,59000,97.0,300,2023-04-03T22:29,0,49700
606,1433907,67,29250,39000,93.0,1474,2023-04-03T22:29,0,29250
607,1945782,68,56000,0,97.0,2505,2023-04-03T22:29,0,56000
608,2573131,69,37800,42000,98.0,686,2023-04-03T22:29,0,37800
609,3142357,70,63000,0,95.0,4,2023-04-03T22:29,-6300,56700
610,3012258,71,29900,39900,99.0,28,2023-04-03T22:29,0,29900
611,1879865,72,29600,37000,96.0,1010,2023-04-03T22:29,0,29600
612,1771121,73,29000,0,96.0,2267,2023-04-03T22:29,0,29000
613,2864918,74,49000,0,99.0,116,2023-04-03T22:29,0,49000
614,2707659,75,42000,0,97.0,507,2023-04-03T22:29,0,42000
615,2053753,76,42000,0,98.0,4119,2023-04-03T22:29,0,42000
616,2383631,77,36000,0,98.0,332,2023-04-03T22:29,0,36000
617,1157471,78,41650,49000,96.0,929,2023-04-03T22:29,0,41650
618,2864774,79,49000,0,98.0,90,2023-04-03T22:29,0,49000
619,1433913,80,31500,42000,94.0,3583,2023-04-03T22:29,0,31500
620,2329376,81,34710,39000,97.0,587,2023-04-03T22:29,0,34710
621,2759077,82,98000,0,100.0,6,2023-04-03T22:29,0,98000
622,2289281,83,29640,38000,96.0,870,2023-04-03T22:29,0,29640
623,1214316,84,36000,0,97.0,1982,2023-04-03T22:29,0,36000
624,2157077,85,37800,42000,95.0,725,2023-04-03T22:29,0,37800
625,1214193,86,39000,0,97.0,15333,2023-04-03T22:29,0,39000
626,3125906,87,80100,89000,100.0,3,2023-04-03T22:29,0,80100
627,2998516,88,29000,0,96.0,137,2023-04-03T22:29,0,29000
628,2164773,89,69000,0,97.0,514,2023-04-03T22:29,0,69000
629,3155974,90,33300,37000,100.0,5,2023-04-03T22:29,-3330,29970
630,3106487,1,148000,0,99.0,24,2023-04-03T22:29,0,148000
631,2489894,2,142200,158000,98.0,102,2023-04-03T22:29,0,142200
632,3053225,3,159000,0,100.0,2,2023-04-03T22:29,0,159000
633,2753697,4,696000,1353000,100.0,1,2023-04-03T22:29,0,696000
634,2605850,5,94000,0,97.0,164,2023-04-03T22:29,0,94000
635,3050173,6,166600,238000,100.0,1,2023-04-03T22:29,0,166600
636,2568529,7,220000,0,100.0,10,2023-04-03T22:29,0,220000
637,1103286,8,94000,0,94.0,780,2023-04-03T22:29,0,94000
638,1455772,9,94000,0,96.0,208,2023-04-03T22:29,0,94000
639,2153636,10,173600,248000,97.0,29,2023-04-03T22:29,0,173600
640,3081770,11,189000,0,96.0,5,2023-04-03T22:29,0,189000
641,3135234,12,80100,89000,0.0,0,2023-04-03T22:29,-8010,72090
642,3099002,13,159000,0,100.0,1,2023-04-03T22:29,0,159000
643,2712722,14,46900,79000,97.0,25,2023-04-03T22:29,0,46900
644,3175382,15,79000,0,100.0,3,2023-04-03T22:29,0,79000
645,3119153,16,169000,0,0.0,0,2023-04-03T22:29,0,169000
646,3053218,17,159000,0,86.0,3,2023-04-03T22:29,0,159000
647,3122381,18,151200,168000,92.0,5,2023-04-03T22:29,-15120,136080
648,3135904,19,92000,0,100.0,2,2023-04-03T22:29,0,92000
649,3073781,20,289000,0,100.0,3,2023-04-03T22:29,-14450,274550
650,3039222,21,79050,93000,100.0,5,2023-04-03T22:29,0,79050
651,3179874,22,148000,0,0.0,0,2023-04-03T22:29,0,148000
652,3094822,23,289000,0,0.0,0,2023-04-03T22:29,-14450,274550
653,1579103,24,126400,158000,96.0,97,2023-04-03T22:29,0,126400
654,2457512,25,237300,339000,98.0,34,2023-04-03T22:29,0,237300
655,3158252,26,278000,0,100.0,1,2023-04-03T22:29,-27800,250200
656,3135233,27,99000,110000,0.0,0,2023-04-03T22:29,-9900,89100
657,3115357,28,268200,298000,0.0,0,2023-04-03T22:29,0,268200
658,3046091,29,198400,248000,100.0,3,2023-04-03T22:29,0,198400
659,2662640,30,194000,980000,0.0,0,2023-04-03T22:29,0,194000
660,3059119,31,179000,0,91.0,19,2023-04-03T22:29,-35800,143200
661,2377832,32,195000,0,95.0,174,2023-04-03T22:29,0,195000
662,3074707,33,119000,0,100.0,3,2023-04-03T22:29,0,119000
663,3084760,34,119000,0,100.0,1,2023-04-03T22:29,0,119000
664,2714533,35,48300,69000,93.0,232,2023-04-03T22:29,-9660,38640
665,3171882,36,149000,0,100.0,2,2023-04-03T22:29,0,149000
666,3155026,37,58500,78000,100.0,2,2023-04-03T22:29,-11700,46800
667,2872175,38,228000,285000,100.0,3,2023-04-03T22:29,0,228000
668,3130645,39,119000,0,0.0,0,2023-04-03T22:29,0,119000
669,3077360,40,98000,0,93.0,3,2023-04-03T22:29,0,98000
670,2714524,41,48300,69000,95.0,393,2023-04-03T22:29,-9660,38640
671,2742939,42,189000,0,100.0,2,2023-04-03T22:29,0,189000
672,1961152,43,216600,228000,98.0,17,2023-04-03T22:29,0,216600
673,3124594,44,198000,0,0.0,0,2023-04-03T22:29,-29700,168300
674,3173636,45,178000,0,0.0,0,2023-04-03T22:29,0,178000
675,1431138,46,179000,0,100.0,6,2023-04-03T22:29,0,179000
676,3069357,47,199000,0,0.0,0,2023-04-03T22:29,0,199000
677,2457508,48,153300,219000,97.0,31,2023-04-03T22:29,0,153300
678,2478652,49,57800,68000,94.0,329,2023-04-03T22:29,0,57800
679,3146695,50,187200,208000,0.0,0,2023-04-03T22:29,0,187200
680,2585630,51,198000,0,0.0,0,2023-04-03T22:29,0,198000
681,2703252,52,167300,239000,96.0,11,2023-04-03T22:29,-8365,158935
682,3156576,53,191200,239000,0.0,0,2023-04-03T22:29,0,191200
683,2492543,54,169000,0,95.0,13,2023-04-03T22:29,-8450,160550
684,1511131,55,168000,0,96.0,57,2023-04-03T22:29,0,168000
685,1421770,56,165600,184000,95.0,41,2023-04-03T22:29,0,165600
686,1779568,57,57600,64000,95.0,289,2023-04-03T22:29,0,57600
687,1792563,58,181300,259000,0.0,0,2023-04-03T22:29,0,181300
688,1871030,59,133600,167000,95.0,97,2023-04-03T22:29,0,133600
689,3134492,60,79000,0,100.0,3,2023-04-03T22:29,0,79000
690,1881469,61,165000,0,94.0,19,2023-04-03T22:29,0,165000
691,3147129,62,169000,0,100.0,2,2023-04-03T22:29,0,169000
692,3037449,63,139300,199000,80.0,3,2023-04-03T22:29,0,139300
693,3117921,64,168000,0,0.0,0,2023-04-03T22:29,0,168000
694,2786189,65,167300,239000,0.0,0,2023-04-03T22:29,-8365,158935
695,3190544,66,159000,0,0.0,0,2023-04-03T22:29,0,159000
696,987370,67,41300,59000,93.0,179,2023-04-03T22:29,0,41300
697,2485837,68,164000,0,100.0,3,2023-04-03T22:29,0,164000
698,3192300,69,129000,0,0.0,0,2023-04-03T22:29,0,129000
699,3128690,70,159000,0,0.0,0,2023-04-03T22:29,0,159000
700,3123539,71,143100,159000,0.0,0,2023-04-03T22:29,0,143100
701,2212062,72,158000,0,0.0,0,2023-04-03T22:29,0,158000
702,2801900,73,59900,79900,95.0,8,2023-04-03T22:29,0,59900
703,2453664,74,148400,185500,100.0,5,2023-04-03T22:29,0,148400
704,2806283,75,145600,208000,86.0,3,2023-04-03T22:29,0,145600
705,1909495,76,129000,0,85.0,15,2023-04-03T22:29,0,129000
706,2392489,77,31900,0,97.0,725,2023-04-03T22:29,0,31900
707,2612357,78,69000,139000,96.0,15,2023-04-03T22:29,0,69000
708,3104789,79,119000,0,0.0,0,2023-04-03T22:29,-5950,113050
709,3065781,80,125300,179000,0.0,0,2023-04-03T22:29,0,125300
710,2707978,81,145000,0,100.0,3,2023-04-03T22:29,0,145000
711,2512635,82,35400,59000,96.0,205,2023-04-03T22:29,0,35400
712,2403765,83,145600,208000,93.0,3,2023-04-03T22:29,0,145600
713,2578440,84,139300,199000,0.0,0,2023-04-03T22:29,0,139300
714,3130642,85,119000,0,0.0,0,2023-04-03T22:29,0,119000
715,3137344,86,139000,0,0.0,0,2023-04-03T22:29,0,139000
716,2957670,87,131600,188000,0.0,0,2023-04-03T22:29,0,131600
717,2500573,88,34300,49000,96.0,43,2023-04-03T22:29,0,34300
718,3155023,89,58500,78000,0.0,0,2023-04-03T22:29,-11700,46800
719,3158888,90,105000,0,0.0,0,2023-04-03T22:29,0,105000
720,2864414,1,69300,99000,94.0,84,2023-04-03T22:29,0,69300
721,3051039,2,95200,119000,100.0,17,2023-04-03T22:29,-19040,76160
722,3051036,3,95200,119000,100.0,4,2023-04-03T22:29,-19040,76160
723,3031104,4,55200,69000,98.0,52,2023-04-03T22:29,-11040,44160
724,3000422,5,59000,0,97.0,25,2023-04-03T22:29,0,59000
725,2377814,6,188100,198000,96.0,70,2023-04-03T22:29,-9405,178695
726,3119334,7,379000,0,0.0,0,2023-04-03T22:29,0,379000
727,3149629,8,125100,139000,0.0,0,2023-04-03T22:29,-6255,118845
728,2551401,9,37900,0,94.0,297,2023-04-03T22:29,0,37900
729,3040745,10,88000,110000,94.0,14,2023-04-03T22:29,-4400,83600
730,2516907,11,340000,0,0.0,0,2023-04-03T22:29,0,340000
731,3074719,12,84550,89000,88.0,5,2023-04-03T22:29,0,84550
732,2925522,13,58500,65000,95.0,95,2023-04-03T22:29,0,58500
733,2867750,14,135000,0,97.0,41,2023-04-03T22:29,0,135000
734,2448899,15,39490,43900,95.0,134,2023-04-03T22:29,0,39490
735,3038057,16,107100,119000,88.0,7,2023-04-03T22:29,0,107100
736,2942714,17,149000,0,0.0,0,2023-04-03T22:29,0,149000
737,3103899,18,299000,0,0.0,0,2023-04-03T22:29,0,299000
738,2448900,19,39490,43900,96.0,92,2023-04-03T22:29,0,39490
739,2836351,20,49680,72000,96.0,443,2023-04-03T22:29,-9936,39744
740,3038069,21,89100,99000,100.0,12,2023-04-03T22:29,0,89100
741,2551400,22,39900,0,93.0,133,2023-04-03T22:29,0,39900
742,2535468,23,270400,338000,100.0,6,2023-04-03T22:29,0,270400
743,3109158,24,31850,49000,95.0,8,2023-04-03T22:29,0,31850
744,2390967,25,39530,59000,93.0,205,2023-04-03T22:29,-7906,31624
745,2829644,26,264600,378000,0.0,0,2023-04-03T22:29,0,264600
746,2643770,27,124000,138000,98.0,18,2023-04-03T22:29,-6200,117800
747,2850491,28,250600,358000,100.0,4,2023-04-03T22:29,-25060,225540
748,2544025,29,189000,270000,100.0,3,2023-04-03T22:29,0,189000
749,3074718,30,84550,89000,0.0,0,2023-04-03T22:29,0,84550
750,2063240,31,55200,69000,93.0,72,2023-04-03T22:29,0,55200
751,1645760,32,39390,43900,96.0,338,2023-04-03T22:29,0,39390
752,2533484,33,35200,44000,94.0,99,2023-04-03T22:29,0,35200
753,2362484,34,80100,89000,96.0,202,2023-04-03T22:29,0,80100
754,2353343,35,48300,69000,94.0,90,2023-04-03T22:29,0,48300
755,3109155,36,41650,49000,93.0,15,2023-04-03T22:29,-8330,33320
756,3070528,37,168000,0,100.0,1,2023-04-03T22:29,0,168000
757,2858429,38,111300,159000,0.0,0,2023-04-03T22:29,-5565,105735
758,2806614,39,107100,119000,97.0,105,2023-04-03T22:29,0,107100
759,1931894,40,37900,0,95.0,503,2023-04-03T22:29,0,37900
760,3125453,41,55200,89900,93.0,3,2023-04-03T22:29,-2760,52440
761,2391576,42,39440,58000,96.0,307,2023-04-03T22:29,-7888,31552
762,3142895,43,89100,99000,0.0,0,2023-04-03T22:29,0,89100
763,1807814,44,65550,69000,97.0,246,2023-04-03T22:29,0,65550
764,3134481,45,188340,219000,0.0,0,2023-04-03T22:29,-9417,178923
765,3040758,46,83200,111000,98.0,10,2023-04-03T22:29,-4160,79040
766,3122265,47,124200,138000,88.0,5,2023-04-03T22:29,-12420,111780
767,2448902,48,37290,43900,94.0,96,2023-04-03T22:29,0,37290
768,2836289,49,39530,59000,95.0,199,2023-04-03T22:29,-7906,31624
769,2794722,50,199000,0,0.0,0,2023-04-03T22:29,0,199000
770,3144417,51,79000,0,0.0,0,2023-04-03T22:29,0,79000
771,3132879,52,189000,0,0.0,0,2023-04-03T22:29,0,189000
772,2378593,53,88200,98000,94.0,70,2023-04-03T22:29,0,88200
773,2811583,54,179000,0,90.0,6,2023-04-03T22:29,0,179000
774,2533486,55,35200,44000,96.0,69,2023-04-03T22:29,0,35200
775,3125457,56,55200,89900,80.0,2,2023-04-03T22:29,-2760,52440
776,2117253,57,43900,0,94.0,254,2023-04-03T22:29,0,43900
777,2377812,58,188100,198000,96.0,58,2023-04-03T22:29,-9405,178695
778,3150273,59,186000,0,0.0,0,2023-04-03T22:29,0,186000
779,2751624,60,188300,269000,0.0,0,2023-04-03T22:29,-9415,178885
780,2738716,61,134400,168000,93.0,25,2023-04-03T22:29,0,134400
781,3063419,62,49900,65000,97.0,8,2023-04-03T22:29,0,49900
782,1819994,63,36500,43000,92.0,657,2023-04-03T22:29,0,36500
783,1324169,64,29900,0,95.0,1330,2023-04-03T22:29,0,29900
784,2756335,65,125400,132000,96.0,56,2023-04-03T22:29,0,125400
785,3037454,66,126650,149000,0.0,0,2023-04-03T22:29,0,126650
786,3081767,67,169000,0,80.0,2,2023-04-03T22:29,0,169000
787,2809789,68,179000,0,0.0,0,2023-04-03T22:29,0,179000
788,3081768,69,169000,0,100.0,3,2023-04-03T22:29,0,169000
789,2571671,70,149000,0,100.0,7,2023-04-03T22:29,0,149000
790,2796164,71,59200,74000,96.0,105,2023-04-03T22:29,0,59200
791,3144187,72,175000,0,0.0,0,2023-04-03T22:29,0,175000
792,1944553,73,36900,0,96.0,214,2023-04-03T22:29,0,36900
793,3153423,74,125100,139000,100.0,2,2023-04-03T22:29,0,125100
794,2300718,75,39390,43900,95.0,237,2023-04-03T22:29,0,39390
795,3038073,76,89100,99000,100.0,2,2023-04-03T22:29,0,89100
796,3053120,77,167300,239000,0.0,0,2023-04-03T22:29,0,167300
797,3098349,78,170100,189000,0.0,0,2023-04-03T22:29,-8505,161595
798,3121084,79,168000,0,0.0,0,2023-04-03T22:29,0,168000
799,1979473,80,35400,59000,94.0,658,2023-04-03T22:29,0,35400
800,2316501,81,51200,64000,94.0,71,2023-04-03T22:29,0,51200
801,3122278,82,160200,178000,100.0,1,2023-04-03T22:29,-16020,144180
802,3071045,83,148000,0,100.0,1,2023-04-03T22:29,0,148000
803,2830788,84,139000,0,96.0,26,2023-04-03T22:29,0,139000
804,3149612,85,125100,139000,0.0,0,2023-04-03T22:29,-6255,118845
805,3087610,86,89000,0,0.0,0,2023-04-03T22:29,0,89000
806,2551409,87,37900,0,95.0,119,2023-04-03T22:29,0,37900
807,2864423,88,69300,99000,92.0,13,2023-04-03T22:29,0,69300
808,3085410,89,159000,0,0.0,0,2023-04-03T22:29,0,159000
809,3120257,90,149000,0,100.0,1,2023-04-03T22:29,0,149000
810,991339,1,17890,19900,97.0,52497,2023-04-03T22:29,0,17890
811,1986031,2,24990,27900,97.0,10474,2023-04-03T22:29,0,24990
812,1094748,3,19900,0,97.0,19039,2023-04-03T22:29,0,19900
813,998051,4,12900,24000,97.0,162086,2023-04-03T22:29,0,12900
814,763821,5,13900,22000,96.0,31293,2023-04-03T22:29,0,13900
815,991340,6,17890,19900,97.0,30740,2023-04-03T22:29,0,17890
816,792919,7,15190,16900,96.0,17901,2023-04-03T22:29,0,15190
817,1477845,8,15400,22000,96.0,9589,2023-04-03T22:29,0,15400
818,1342874,9,16900,33000,97.0,12681,2023-04-03T22:29,0,16900
819,1094835,10,14290,15900,97.0,6182,2023-04-03T22:29,0,14290
820,1986029,11,27900,0,97.0,3905,2023-04-03T22:29,0,27900
821,991570,12,12900,20000,97.0,19010,2023-04-03T22:29,0,12900
822,746158,13,22900,0,96.0,20499,2023-04-03T22:29,0,22900
823,1996702,14,23690,27900,97.0,1913,2023-04-03T22:29,0,23690
824,479245,15,15400,22000,93.0,5376,2023-04-03T22:29,0,15400
825,1443937,16,12900,24000,97.0,7802,2023-04-03T22:29,0,12900
826,991341,17,16890,19900,96.0,10176,2023-04-03T22:29,0,16890
827,734085,18,10900,19800,96.0,64594,2023-04-03T22:29,0,10900
828,1996705,19,23690,27900,98.0,2677,2023-04-03T22:29,0,23690
829,1986030,20,23690,27900,97.0,1653,2023-04-03T22:29,0,23690
830,792920,21,15190,16900,96.0,9653,2023-04-03T22:29,0,15190
831,2832613,22,11200,33000,97.0,626,2023-04-03T22:29,0,11200
832,1821485,23,30000,0,96.0,1246,2023-04-03T22:29,0,30000
833,746154,24,17900,0,96.0,5145,2023-04-03T22:29,-1790,16110
834,2297277,25,19900,22000,95.0,274,2023-04-03T22:29,0,19900
835,2845854,26,14900,18900,97.0,204,2023-04-03T22:29,0,14900
836,1729576,27,9500,13900,97.0,15970,2023-04-03T22:29,0,9500
837,1346009,28,9900,12000,97.0,6671,2023-04-03T22:29,0,9900
838,2011852,29,21490,23900,97.0,1300,2023-04-03T22:29,0,21490
839,1094749,30,19900,0,96.0,4943,2023-04-03T22:29,0,19900
840,1094750,31,16890,19900,97.0,3542,2023-04-03T22:29,0,16890
841,1094834,32,21490,23900,96.0,2453,2023-04-03T22:29,0,21490
842,1094836,33,14290,15900,97.0,1309,2023-04-03T22:29,0,14290
843,792921,34,15190,16900,95.0,7806,2023-04-03T22:29,0,15190
844,2821598,35,19390,22900,97.0,141,2023-04-03T22:29,0,19390
845,2347097,36,14900,24000,98.0,1536,2023-04-03T22:29,0,14900
846,2509300,37,19900,0,96.0,390,2023-04-03T22:29,0,19900
847,1358721,38,14200,22000,96.0,1112,2023-04-03T22:29,0,14200
848,2821588,39,19690,21900,98.0,51,2023-04-03T22:29,0,19690
849,2960555,40,19000,0,94.0,97,2023-04-03T22:29,0,19000
850,1996704,41,22290,27900,97.0,695,2023-04-03T22:29,0,22290
851,2821590,42,19690,21900,98.0,44,2023-04-03T22:29,0,19690
852,1094837,43,13490,15900,96.0,1750,2023-04-03T22:29,0,13490
853,2821589,44,19690,21900,95.0,33,2023-04-03T22:29,0,19690
854,746159,45,20590,22900,95.0,28710,2023-04-03T22:29,0,20590
855,1475055,46,16200,22000,96.0,1165,2023-04-03T22:29,0,16200
856,1821487,47,30000,0,97.0,676,2023-04-03T22:29,0,30000
857,2649999,48,12800,16000,94.0,73,2023-04-03T22:29,0,12800
858,1121544,49,15190,16900,96.0,861,2023-04-03T22:29,0,15190
859,2990345,50,27900,0,99.0,45,2023-04-03T22:29,0,27900
860,1821480,51,30000,0,98.0,229,2023-04-03T22:29,0,30000
861,2929635,52,15900,27000,97.0,503,2023-04-03T22:29,0,15900
862,1477846,53,15400,22000,96.0,2661,2023-04-03T22:29,0,15400
863,2477854,54,17890,19900,98.0,1449,2023-04-03T22:29,0,17890
864,2821591,55,15590,20900,96.0,101,2023-04-03T22:29,0,15590
865,3009680,56,12590,14900,98.0,96,2023-04-03T22:29,0,12590
866,1392772,57,16890,19900,96.0,1137,2023-04-03T22:29,0,16890
867,1547562,58,15400,22000,95.0,1356,2023-04-03T22:29,0,15400
868,3121424,59,49000,0,0.0,0,2023-04-03T22:29,0,49000
869,1573974,60,39790,46900,97.0,1450,2023-04-03T22:29,0,39790
870,1974077,61,42090,46900,97.0,892,2023-04-03T22:29,0,42090
871,472686,62,9500,14800,94.0,710,2023-04-03T22:29,0,9500
872,1348077,63,10900,16500,97.0,1856,2023-04-03T22:29,0,10900
873,746155,64,17900,0,95.0,1261,2023-04-03T22:29,-1790,16110
874,1360044,65,19900,0,97.0,1755,2023-04-03T22:29,0,19900
875,752821,66,9900,0,94.0,23718,2023-04-03T22:29,0,9900
876,1346070,67,9900,12000,97.0,1865,2023-04-03T22:29,0,9900
877,2584266,68,9900,12000,98.0,402,2023-04-03T22:29,0,9900
878,3106972,69,19900,0,92.0,8,2023-04-03T22:29,0,19900
879,2346958,70,18200,24000,98.0,508,2023-04-03T22:29,0,18200
880,2433154,71,30000,0,95.0,88,2023-04-03T22:29,0,30000
881,2711708,72,26100,29000,98.0,66,2023-04-03T22:29,-5220,20880
882,2835702,73,13900,15800,97.0,54,2023-04-03T22:29,-1390,12510
883,1475031,74,16900,27000,96.0,1721,2023-04-03T22:29,0,16900
884,1286366,75,11900,24000,97.0,9787,2023-04-03T22:29,0,11900
885,2821592,76,15590,20900,98.0,143,2023-04-03T22:29,0,15590
886,2652523,77,9500,12000,98.0,107,2023-04-03T22:29,0,9500
887,2122868,78,9500,13900,97.0,3828,2023-04-03T22:29,0,9500
888,2477852,79,17890,19900,98.0,676,2023-04-03T22:29,0,17890
889,2957994,80,9500,0,100.0,7,2023-04-03T22:29,0,9500
890,1260384,81,19900,0,95.0,1796,2023-04-03T22:29,0,19900
891,2293399,82,19900,22000,96.0,621,2023-04-03T22:29,0,19900
892,3135613,83,9200,13900,100.0,3,2023-04-03T22:29,0,9200
893,2821599,84,22900,0,97.0,116,2023-04-03T22:29,0,22900
894,1062063,85,9490,15900,96.0,2133,2023-04-03T22:29,0,9490
895,2011850,86,21490,23900,98.0,855,2023-04-03T22:29,0,21490
896,1246150,87,16900,33600,95.0,3548,2023-04-03T22:29,0,16900
897,1666349,88,12900,0,93.0,61,2023-04-03T22:29,0,12900
898,1777081,89,8000,12800,96.0,1156,2023-04-03T22:29,0,8000
899,1387502,90,12690,15900,95.0,511,2023-04-03T22:29,0,12690
