,item_id,rank,price,del_price,rating,rating_count,time,coupon,real_price
0,3071087,1,84550,89000,95.0,281,2023-03-29T01:43,0,84550
1,2272830,2,35910,39900,97.0,18409,2023-03-29T01:43,-3591,32319
2,2086653,3,16900,0,97.0,38624,2023-03-29T01:43,0,16900
3,1848166,4,44100,49000,97.0,40741,2023-03-29T01:43,0,44100
4,2453556,5,39900,42000,97.0,6172,2023-03-29T01:43,0,39900
5,1503352,6,39900,42000,97.0,8320,2023-03-29T01:43,0,39900
6,2149254,7,37800,0,97.0,32285,2023-03-29T01:43,-5670,32130
7,345889,8,29900,47900,95.0,9548,2023-03-29T01:43,0,29900
8,2479911,9,49400,76000,97.0,4000,2023-03-29T01:43,0,49400
9,2453552,10,39900,42000,97.0,2869,2023-03-29T01:43,0,39900
10,3065990,11,69000,0,0.0,0,2023-03-29T01:43,0,69000
11,2396645,12,39900,59000,96.0,23095,2023-03-29T01:43,0,39900
12,1782641,13,39900,42000,97.0,2572,2023-03-29T01:43,0,39900
13,3065991,14,69000,0,0.0,0,2023-03-29T01:43,0,69000
14,2204747,15,71250,75000,97.0,2093,2023-03-29T01:43,0,71250
15,2313388,16,76500,85000,96.0,2064,2023-03-29T01:43,0,76500
16,1549281,17,71250,75000,97.0,5729,2023-03-29T01:43,0,71250
17,2314616,18,39000,43000,97.0,8050,2023-03-29T01:43,0,39000
18,2038497,19,36000,45000,95.0,16133,2023-03-29T01:43,-3600,32400
19,3153427,20,48000,0,0.0,0,2023-03-29T01:43,-2400,45600
20,1817394,21,59900,150000,93.0,7046,2023-03-29T01:43,0,59900
21,3153428,22,48000,0,0.0,0,2023-03-29T01:43,-2400,45600
22,3153446,23,89000,0,0.0,0,2023-03-29T01:43,-4450,84550
23,2375962,24,59000,62000,98.0,5154,2023-03-29T01:43,-8850,50150
24,1582356,25,49200,82000,96.0,15965,2023-03-29T01:43,-2460,46740
25,1939099,26,29400,49000,97.0,11582,2023-03-29T01:43,0,29400
26,2646350,27,59800,94000,95.0,3930,2023-03-29T01:43,-5980,53820
27,2660716,28,50400,72000,96.0,2166,2023-03-29T01:43,0,50400
28,1782647,29,39900,42000,97.0,3475,2023-03-29T01:43,0,39900
29,3153429,30,48000,0,0.0,0,2023-03-29T01:43,-2400,45600
30,2326935,31,63200,79000,96.0,12813,2023-03-29T01:43,-12640,50560
31,2065712,32,59000,62000,98.0,6590,2023-03-29T01:43,-8850,50150
32,3071084,33,51300,54000,95.0,108,2023-03-29T01:43,0,51300
33,2392759,34,39900,49600,95.0,3880,2023-03-29T01:43,-7980,31920
34,3109230,35,89000,0,98.0,30,2023-03-29T01:43,0,89000
35,3169692,36,169000,0,0.0,0,2023-03-29T01:43,0,169000
36,2354252,37,71250,75000,97.0,1736,2023-03-29T01:43,0,71250
37,3071089,38,84550,89000,98.0,89,2023-03-29T01:43,0,84550
38,3043051,39,76500,85000,96.0,49,2023-03-29T01:43,0,76500
39,3034895,40,101150,119000,98.0,326,2023-03-29T01:43,0,101150
40,996177,41,15900,0,95.0,77218,2023-03-29T01:43,0,15900
41,2996536,42,39900,59000,97.0,382,2023-03-29T01:43,0,39900
42,854337,43,33900,0,95.0,17141,2023-03-29T01:43,-3390,30510
43,3052036,44,59400,66000,95.0,111,2023-03-29T01:43,0,59400
44,2684358,45,109000,0,97.0,3167,2023-03-29T01:43,0,109000
45,2775713,46,39800,49000,93.0,2842,2023-03-29T01:43,-3980,35820
46,1943792,47,34400,43000,96.0,5209,2023-03-29T01:43,0,34400
47,2034137,48,31800,0,97.0,16676,2023-03-29T01:43,-4770,27030
48,3032250,49,44800,64000,95.0,726,2023-03-29T01:43,-8960,35840
49,2122566,50,33800,0,97.0,15322,2023-03-29T01:43,-6760,27040
50,2442409,51,39000,78000,96.0,8709,2023-03-29T01:43,-7800,31200
51,2740193,52,71250,75000,96.0,772,2023-03-29T01:43,0,71250
52,1706633,53,199000,0,97.0,2365,2023-03-29T01:43,0,199000
53,2364807,54,219000,0,96.0,690,2023-03-29T01:43,0,219000
54,3109227,55,89000,0,98.0,24,2023-03-29T01:43,0,89000
55,1608272,56,39800,65590,96.0,4003,2023-03-29T01:43,0,39800
56,3066025,57,129000,0,0.0,0,2023-03-29T01:43,0,129000
57,2377269,58,45000,0,97.0,3760,2023-03-29T01:43,0,45000
58,1336398,59,40200,67000,96.0,18971,2023-03-29T01:43,0,40200
59,2106705,60,41900,57000,98.0,5457,2023-03-29T01:43,0,41900
60,1776344,61,34500,69000,96.0,5011,2023-03-29T01:43,0,34500
61,3153426,62,48000,0,0.0,0,2023-03-29T01:43,-2400,45600
62,3165127,63,52000,80000,0.0,0,2023-03-29T01:43,0,52000
63,2065708,64,59000,62000,98.0,6459,2023-03-29T01:43,-8850,50150
64,1574201,65,71100,79000,97.0,4541,2023-03-29T01:43,0,71100
65,2226767,66,68400,76000,97.0,7125,2023-03-29T01:43,0,68400
66,3153443,67,85000,0,0.0,0,2023-03-29T01:43,-4250,80750
67,994588,68,39900,53000,93.0,5934,2023-03-29T01:43,-1720,38180
68,3163734,69,67150,79000,100.0,1,2023-03-29T01:43,0,67150
69,2099802,70,62300,89000,97.0,3881,2023-03-29T01:43,0,62300
70,1557508,71,27600,69000,96.0,14966,2023-03-29T01:43,0,27600
71,1763157,72,49400,52000,95.0,2587,2023-03-29T01:43,0,49400
72,2758254,73,31050,69000,97.0,625,2023-03-29T01:43,0,31050
73,1417691,74,13900,0,97.0,18287,2023-03-29T01:43,0,13900
74,1382658,75,16900,0,94.0,47132,2023-03-29T01:43,0,16900
75,2740197,76,71250,75000,97.0,526,2023-03-29T01:43,0,71250
76,1884943,77,29900,39000,96.0,18797,2023-03-29T01:43,0,29900
77,1622019,78,32800,82000,96.0,4297,2023-03-29T01:43,0,32800
78,2065703,79,59000,62000,98.0,5369,2023-03-29T01:43,-8850,50150
79,2740213,80,71250,75000,97.0,773,2023-03-29T01:43,0,71250
80,2453499,81,42750,45000,96.0,1115,2023-03-29T01:43,0,42750
81,1870605,82,39900,42000,95.0,649,2023-03-29T01:43,0,39900
82,1549284,83,71250,75000,97.0,3706,2023-03-29T01:43,0,71250
83,3094141,84,98000,0,93.0,33,2023-03-29T01:43,0,98000
84,1211169,85,49680,69000,95.0,5682,2023-03-29T01:43,0,49680
85,3040933,86,51300,54000,95.0,41,2023-03-29T01:43,0,51300
86,2722805,87,71100,79000,96.0,894,2023-03-29T01:43,0,71100
87,1828538,88,39900,69900,95.0,2867,2023-03-29T01:43,0,39900
88,2913656,89,47900,64000,95.0,244,2023-03-29T01:43,-2395,45505
89,407067,90,29250,39000,95.0,21391,2023-03-29T01:43,0,29250
90,1778404,1,42000,45000,96.0,66539,2023-03-29T01:43,0,42000
91,2288704,2,121000,132000,97.0,3206,2023-03-29T01:43,0,121000
92,2064545,3,74900,94000,97.0,10896,2023-03-29T01:43,-3745,71155
93,1790383,4,59000,86000,95.0,5178,2023-03-29T01:43,-5900,53100
94,1558197,5,73690,81900,97.0,32010,2023-03-29T01:43,-7369,66321
95,2723218,6,69900,109000,97.0,1957,2023-03-29T01:43,0,69900
96,1576700,7,89000,129000,97.0,16418,2023-03-29T01:43,0,89000
97,1139262,8,146000,159000,97.0,1837,2023-03-29T01:43,0,146000
98,2110493,9,389000,0,96.0,608,2023-03-29T01:43,0,389000
99,1530516,10,69900,79000,96.0,2177,2023-03-29T01:43,0,69900
100,841230,11,154000,172000,96.0,7198,2023-03-29T01:43,0,154000
101,3066067,12,199000,0,0.0,0,2023-03-29T01:43,0,199000
102,3012082,13,59900,79000,97.0,807,2023-03-29T01:43,-5990,53910
103,2343199,14,119000,129000,98.0,1728,2023-03-29T01:43,0,119000
104,2788216,15,135000,159000,98.0,84,2023-03-29T01:43,0,135000
105,1337094,16,69900,0,95.0,5251,2023-03-29T01:43,-6990,62910
106,1283757,17,75490,83900,96.0,26461,2023-03-29T01:43,-7549,67941
107,1195307,18,82400,103000,96.0,12494,2023-03-29T01:43,-8240,74160
108,2752332,19,89900,105300,95.0,2416,2023-03-29T01:43,0,89900
109,1608372,20,121000,132000,96.0,3185,2023-03-29T01:43,0,121000
110,1108007,21,79900,0,95.0,47791,2023-03-29T01:43,-7990,71910
111,2053138,22,146000,159000,97.0,636,2023-03-29T01:43,0,146000
112,2732486,23,109000,179000,98.0,566,2023-03-29T01:43,0,109000
113,1530517,24,69900,79000,96.0,1965,2023-03-29T01:43,0,69900
114,1571879,25,79900,112900,96.0,6972,2023-03-29T01:43,-7990,71910
115,2788219,26,135000,159000,96.0,256,2023-03-29T01:43,0,135000
116,1833230,27,95200,136000,97.0,5349,2023-03-29T01:43,0,95200
117,1856181,28,35910,39900,97.0,6968,2023-03-29T01:43,-3591,32319
118,3031450,29,146000,159000,96.0,57,2023-03-29T01:43,0,146000
119,3010527,30,237150,279000,98.0,156,2023-03-29T01:43,0,237150
120,1618312,31,83900,0,97.0,6992,2023-03-29T01:43,0,83900
121,2715055,32,159000,189000,97.0,1929,2023-03-29T01:43,-31800,127200
122,3054929,33,99900,0,96.0,19,2023-03-29T01:43,-9990,89910
123,3029811,34,63200,79000,98.0,184,2023-03-29T01:43,0,63200
124,1291017,35,67900,96000,95.0,12843,2023-03-29T01:43,0,67900
125,3036129,36,79800,94000,95.0,1578,2023-03-29T01:43,-3990,75810
126,2471405,37,99000,138000,97.0,1954,2023-03-29T01:43,0,99000
127,3033224,38,59900,74000,96.0,499,2023-03-29T01:43,-5990,53910
128,3042936,39,90900,105000,97.0,287,2023-03-29T01:43,0,90900
129,2293391,40,98000,124000,96.0,1753,2023-03-29T01:43,-4900,93100
130,1593755,41,89360,111700,97.0,14386,2023-03-29T01:43,-17872,71488
131,1778408,42,42000,45000,95.0,11527,2023-03-29T01:43,0,42000
132,1280576,43,37200,62000,96.0,25032,2023-03-29T01:43,-7440,29760
133,2343198,44,119000,129000,97.0,4905,2023-03-29T01:43,0,119000
134,1337096,45,69900,0,96.0,2843,2023-03-29T01:43,-6990,62910
135,2100438,46,63890,79900,97.0,3667,2023-03-29T01:43,-6389,57501
136,2159724,47,29900,32000,95.0,2144,2023-03-29T01:43,0,29900
137,1620285,48,299000,0,97.0,152,2023-03-29T01:43,0,299000
138,1139192,49,71100,94900,97.0,14293,2023-03-29T01:43,-7110,63990
139,3039655,50,69700,83000,96.0,446,2023-03-29T01:43,0,69700
140,2496650,51,43900,109000,96.0,709,2023-03-29T01:43,0,43900
141,2322836,52,139200,174000,97.0,964,2023-03-29T01:43,0,139200
142,1571878,53,79900,112900,96.0,4591,2023-03-29T01:43,-7990,71910
143,1776552,54,65000,69000,94.0,6044,2023-03-29T01:43,0,65000
144,3042244,55,159200,199000,97.0,50,2023-03-29T01:43,-31840,127360
145,2284220,56,79900,112900,96.0,1623,2023-03-29T01:43,0,79900
146,3056018,57,62300,89000,97.0,282,2023-03-29T01:43,0,62300
147,2723772,58,109900,169000,94.0,957,2023-03-29T01:43,0,109900
148,2329532,59,119200,149000,97.0,3888,2023-03-29T01:43,0,119200
149,2732428,60,146000,159000,97.0,256,2023-03-29T01:43,0,146000
150,1737051,61,62300,89000,96.0,5035,2023-03-29T01:43,0,62300
151,1558683,62,81900,0,97.0,6142,2023-03-29T01:43,-8190,73710
152,2286964,63,66300,110500,97.0,4778,2023-03-29T01:43,-9945,56355
153,3010431,64,135150,159000,98.0,105,2023-03-29T01:43,0,135150
154,2184463,65,389000,0,98.0,372,2023-03-29T01:43,0,389000
155,2086731,66,95000,129000,97.0,2141,2023-03-29T01:43,0,95000
156,2102243,67,69900,129000,96.0,2801,2023-03-29T01:43,-3495,66405
157,1576682,68,245000,339000,97.0,8506,2023-03-29T01:43,0,245000
158,1751722,69,53910,59900,97.0,3295,2023-03-29T01:43,-5391,48519
159,1873073,70,75490,83900,97.0,4013,2023-03-29T01:43,-7549,67941
160,2701889,71,58200,97000,95.0,4098,2023-03-29T01:43,0,58200
161,2375909,72,80890,89900,97.0,1470,2023-03-29T01:43,0,80890
162,1760177,73,139200,174000,97.0,299,2023-03-29T01:43,0,139200
163,3031457,74,146000,159000,96.0,27,2023-03-29T01:43,0,146000
164,2064478,75,79900,138000,95.0,21161,2023-03-29T01:43,-3995,75905
165,1116010,76,154000,172000,96.0,2226,2023-03-29T01:43,0,154000
166,3054930,77,99900,0,97.0,18,2023-03-29T01:43,-9990,89910
167,3153343,78,95000,0,0.0,0,2023-03-29T01:43,-4750,90250
168,3029809,79,63200,79000,99.0,98,2023-03-29T01:43,0,63200
169,1758197,80,79800,94000,97.0,14689,2023-03-29T01:43,-3990,75810
170,1731130,81,143200,179000,96.0,1744,2023-03-29T01:43,-28640,114560
171,3062283,82,157500,175000,96.0,28,2023-03-29T01:43,0,157500
172,2723216,83,69900,109000,97.0,968,2023-03-29T01:43,0,69900
173,2102252,84,69900,129000,94.0,6239,2023-03-29T01:43,-3495,66405
174,3071114,85,131100,138000,89.0,57,2023-03-29T01:43,0,131100
175,2293881,86,34500,69000,96.0,514,2023-03-29T01:43,0,34500
176,3047180,87,119200,149000,98.0,66,2023-03-29T01:43,0,119200
177,3071109,88,140600,148000,91.0,33,2023-03-29T01:43,0,140600
178,2712632,89,107000,0,97.0,1280,2023-03-29T01:43,0,107000
179,1817381,90,47900,69000,96.0,938,2023-03-29T01:43,0,47900
180,1149329,1,39900,0,96.0,85387,2023-03-29T01:43,-3990,35910
181,1551840,2,39000,0,97.0,82874,2023-03-29T01:43,-3900,35100
182,2112059,3,36400,52000,97.0,42199,2023-03-29T01:43,-3640,32760
183,750908,4,34900,54000,96.0,83473,2023-03-29T01:43,0,34900
184,1551839,5,39000,0,97.0,23087,2023-03-29T01:43,-3900,35100
185,2060719,6,47800,69000,96.0,4860,2023-03-29T01:43,-2390,45410
186,1168906,7,41900,0,97.0,70538,2023-03-29T01:43,-4190,37710
187,1854665,8,139000,0,97.0,1027,2023-03-29T01:43,0,139000
188,1149328,9,39900,0,96.0,94214,2023-03-29T01:43,-3990,35910
189,2092852,10,42000,52800,96.0,10805,2023-03-29T01:43,-2100,39900
190,2028327,11,49900,0,97.0,8797,2023-03-29T01:43,-4990,44910
191,2112061,12,33900,52000,97.0,14308,2023-03-29T01:43,0,33900
192,1568057,13,43400,62000,96.0,21964,2023-03-29T01:43,0,43400
193,1573215,14,133200,148000,98.0,9189,2023-03-29T01:43,0,133200
194,1370101,15,39000,89000,96.0,22480,2023-03-29T01:43,0,39000
195,858911,16,44100,49000,95.0,66573,2023-03-29T01:43,0,44100
196,2028326,17,49900,0,97.0,5963,2023-03-29T01:43,-4990,44910
197,3065919,18,149000,0,100.0,5,2023-03-29T01:43,0,149000
198,1222184,19,41900,0,97.0,48114,2023-03-29T01:43,-4190,37710
199,2060717,20,55200,69000,95.0,3604,2023-03-29T01:43,-2760,52440
200,2060759,21,59800,74800,97.0,7052,2023-03-29T01:43,-8970,50830
201,2060720,22,55200,69000,95.0,2449,2023-03-29T01:43,-2760,52440
202,3091296,23,129000,0,95.0,9,2023-03-29T01:43,0,129000
203,2084435,24,99000,109000,97.0,1283,2023-03-29T01:43,-9810,89190
204,890521,25,39800,63000,94.0,10909,2023-03-29T01:43,0,39800
205,396185,26,109000,0,95.0,8679,2023-03-29T01:43,-21800,87200
206,2789111,27,79200,99000,97.0,740,2023-03-29T01:43,-3960,75240
207,1168922,28,43900,0,96.0,18042,2023-03-29T01:43,-4390,39510
208,1552753,29,62400,78000,97.0,27976,2023-03-29T01:43,-6240,56160
209,2184087,30,49000,89000,96.0,3957,2023-03-29T01:43,0,49000
210,1555407,31,62400,78000,97.0,11373,2023-03-29T01:43,-6240,56160
211,2358429,32,159000,0,98.0,2565,2023-03-29T01:43,0,159000
212,2028329,33,49900,0,96.0,6405,2023-03-29T01:43,-4990,44910
213,1323090,34,73600,92000,96.0,5906,2023-03-29T01:43,-7360,66240
214,3163314,35,63700,98000,96.0,141,2023-03-29T01:43,-6370,57330
215,2131950,36,44100,49000,97.0,3634,2023-03-29T01:43,0,44100
216,1736085,37,39900,59800,96.0,36238,2023-03-29T01:43,0,39900
217,2351467,38,39800,54000,96.0,5893,2023-03-29T01:43,-3980,35820
218,1568032,39,43400,62000,96.0,5988,2023-03-29T01:43,0,43400
219,2060743,40,33000,55000,95.0,3437,2023-03-29T01:43,0,33000
220,890338,41,44100,49000,95.0,47488,2023-03-29T01:43,0,44100
221,2749153,42,66600,74000,97.0,504,2023-03-29T01:43,0,66600
222,1666442,43,49900,0,97.0,10816,2023-03-29T01:43,0,49900
223,1403480,44,77000,98000,97.0,7652,2023-03-29T01:43,-11550,65450
224,1595607,45,57900,89000,97.0,5612,2023-03-29T01:43,-5790,52110
225,2092849,46,42000,52800,96.0,9616,2023-03-29T01:43,-2100,39900
226,1477272,47,44200,68000,96.0,17634,2023-03-29T01:43,0,44200
227,2723714,48,52000,58000,96.0,1375,2023-03-29T01:43,0,52000
228,1854661,49,139000,0,96.0,431,2023-03-29T01:43,0,139000
229,2391746,50,49900,0,95.0,1698,2023-03-29T01:43,-4990,44910
230,2737165,51,59800,79000,96.0,2531,2023-03-29T01:43,-8970,50830
231,1224095,52,35890,39900,97.0,24226,2023-03-29T01:43,-3589,32301
232,2578996,53,39900,59000,95.0,4584,2023-03-29T01:43,-5985,33915
233,2709031,54,36700,52800,96.0,3407,2023-03-29T01:43,-1835,34865
234,2032901,55,39900,0,97.0,6670,2023-03-29T01:43,-3990,35910
235,1960424,56,49500,59000,95.0,1094,2023-03-29T01:43,0,49500
236,2411327,57,65000,139000,97.0,3978,2023-03-29T01:43,-13000,52000
237,2744549,58,43400,62000,97.0,4877,2023-03-29T01:43,0,43400
238,1212776,59,28690,31900,96.0,23111,2023-03-29T01:43,0,28690
239,2392464,60,27090,33900,94.0,3652,2023-03-29T01:43,0,27090
240,1905022,61,149000,0,96.0,502,2023-03-29T01:43,0,149000
241,2107115,62,121500,135000,98.0,11607,2023-03-29T01:43,0,121500
242,1924274,63,49900,66000,95.0,22390,2023-03-29T01:43,-4990,44910
243,2391744,64,49900,0,96.0,1328,2023-03-29T01:43,-4990,44910
244,1627892,65,43900,0,97.0,10291,2023-03-29T01:43,0,43900
245,2261213,66,121500,135000,98.0,4043,2023-03-29T01:43,0,121500
246,2706287,67,39800,54000,95.0,3521,2023-03-29T01:43,-3980,35820
247,3163720,68,135150,159000,100.0,1,2023-03-29T01:43,0,135150
248,3070909,69,125100,139000,100.0,3,2023-03-29T01:43,0,125100
249,241111,70,69000,0,96.0,10502,2023-03-29T01:43,-13800,55200
250,1926048,71,32000,0,97.0,14511,2023-03-29T01:43,-3200,28800
251,2319844,72,85600,107000,98.0,3785,2023-03-29T01:43,0,85600
252,1246215,73,52000,65000,96.0,6247,2023-03-29T01:43,0,52000
253,2069525,74,41900,0,96.0,3647,2023-03-29T01:43,-4190,37710
254,2049103,75,62400,78000,97.0,7045,2023-03-29T01:43,-6240,56160
255,3098372,76,109000,139000,97.0,700,2023-03-29T01:43,-21800,87200
256,3043508,77,71200,89000,98.0,71,2023-03-29T01:43,-3560,67640
257,1212777,78,27090,31900,96.0,21520,2023-03-29T01:43,0,27090
258,3141395,79,49900,73900,98.0,78,2023-03-29T01:43,-4990,44910
259,3070218,80,38900,49000,100.0,6,2023-03-29T01:43,-1945,36955
260,1100326,81,57900,89000,95.0,36946,2023-03-29T01:43,-5790,52110
261,1736562,82,39000,0,97.0,5917,2023-03-29T01:43,-3900,35100
262,1985224,83,39000,89000,96.0,1716,2023-03-29T01:43,0,39000
263,3022892,84,44100,49000,96.0,309,2023-03-29T01:43,0,44100
264,2383020,85,69000,0,96.0,968,2023-03-29T01:43,-13800,55200
265,1885631,86,44100,49000,96.0,23635,2023-03-29T01:43,0,44100
266,1985223,87,39000,89000,96.0,1527,2023-03-29T01:43,0,39000
267,1322221,88,49900,0,96.0,10216,2023-03-29T01:43,-4990,44910
268,2569079,89,67150,79000,96.0,1075,2023-03-29T01:43,0,67150
269,2150457,90,119250,159000,97.0,3694,2023-03-29T01:43,0,119250
270,1789507,1,79000,0,98.0,25600,2023-03-29T01:43,0,79000
271,1034480,2,135000,150000,97.0,17897,2023-03-29T01:43,0,135000
272,1969507,3,88000,0,98.0,5258,2023-03-29T01:43,0,88000
273,3175966,4,87000,0,0.0,0,2023-03-29T01:43,0,87000
274,2344538,5,119000,0,98.0,6262,2023-03-29T01:43,0,119000
275,3038000,6,66400,83000,96.0,279,2023-03-29T01:43,-9960,56440
276,2558648,7,119000,0,98.0,1217,2023-03-29T01:43,0,119000
277,2344540,8,96000,0,98.0,9071,2023-03-29T01:43,0,96000
278,1264107,9,65000,90000,97.0,6239,2023-03-29T01:43,0,65000
279,2514819,10,59000,66000,97.0,767,2023-03-29T01:43,0,59000
280,2343665,11,89000,0,97.0,4488,2023-03-29T01:43,0,89000
281,1564343,12,92800,119000,98.0,8050,2023-03-29T01:43,-6496,86304
282,2998775,13,142200,158000,96.0,438,2023-03-29T01:43,0,142200
283,2902040,14,390000,600000,100.0,35,2023-03-29T01:43,-30000,360000
284,2577899,15,138000,0,98.0,288,2023-03-29T01:43,0,138000
285,1842449,16,84000,99000,97.0,5304,2023-03-29T01:43,0,84000
286,1581689,17,75600,89000,97.0,3919,2023-03-29T01:43,0,75600
287,2271789,18,71100,79000,97.0,2447,2023-03-29T01:43,0,71100
288,3034751,19,64800,72000,97.0,337,2023-03-29T01:43,0,64800
289,342189,20,39500,52000,95.0,15646,2023-03-29T01:43,0,39500
290,1969488,21,88000,0,98.0,1693,2023-03-29T01:43,0,88000
291,2584181,22,57600,72000,98.0,797,2023-03-29T01:43,0,57600
292,2789785,23,140600,148000,97.0,556,2023-03-29T01:43,0,140600
293,693318,24,79000,110000,96.0,13106,2023-03-29T01:43,0,79000
294,1744101,25,103500,109000,98.0,2828,2023-03-29T01:43,0,103500
295,2954959,26,95000,0,95.0,176,2023-03-29T01:43,0,95000
296,2789787,27,140600,148000,96.0,311,2023-03-29T01:43,0,140600
297,2777025,28,308000,485000,100.0,43,2023-03-29T01:43,-30000,278000
298,2458214,29,1879000,3395000,100.0,11,2023-03-29T01:43,-30000,1849000
299,2066837,30,69000,119000,97.0,6360,2023-03-29T01:43,-13800,55200
300,2320927,31,39000,51000,97.0,2012,2023-03-29T01:43,0,39000
301,2760920,32,80100,89000,97.0,210,2023-03-29T01:43,0,80100
302,3034749,33,64800,72000,97.0,351,2023-03-29T01:43,0,64800
303,2753709,34,1790000,2268000,100.0,12,2023-03-29T01:43,-30000,1760000
304,2852648,35,1980000,3250000,100.0,1,2023-03-29T01:43,-30000,1950000
305,2789786,36,150100,158000,97.0,209,2023-03-29T01:43,0,150100
306,2777282,37,1705000,2270000,100.0,1,2023-03-29T01:43,-30000,1675000
307,2657250,38,125400,149000,98.0,102,2023-03-29T01:43,0,125400
308,1576725,39,137000,197000,97.0,5219,2023-03-29T01:43,0,137000
309,1964770,40,59400,66000,97.0,2445,2023-03-29T01:43,0,59400
310,1528287,41,46500,49000,96.0,4521,2023-03-29T01:43,0,46500
311,913402,42,83000,98000,95.0,8000,2023-03-29T01:43,0,83000
312,3028885,43,143100,159000,96.0,16,2023-03-29T01:43,0,143100
313,2856867,44,1579000,1663000,0.0,0,2023-03-29T01:43,-30000,1549000
314,1263004,45,159000,0,97.0,5234,2023-03-29T01:43,0,159000
315,3024801,46,138000,0,100.0,13,2023-03-29T01:43,0,138000
316,2930578,47,1508000,2290000,100.0,5,2023-03-29T01:43,-30000,1478000
317,3061872,48,89000,0,93.0,27,2023-03-29T01:43,0,89000
318,2325729,49,87200,109000,97.0,763,2023-03-29T01:43,-13080,74120
319,1910358,50,89100,99000,98.0,2435,2023-03-29T01:43,0,89100
320,1320752,51,69800,135000,97.0,4701,2023-03-29T01:43,0,69800
321,1835080,52,98000,0,97.0,2697,2023-03-29T01:43,0,98000
322,3072371,53,125100,139000,96.0,101,2023-03-29T01:43,-12510,112590
323,2979853,54,1391000,1670000,0.0,0,2023-03-29T01:43,-30000,1361000
324,3082387,55,139000,0,98.0,101,2023-03-29T01:43,0,139000
325,3142123,56,290000,0,100.0,7,2023-03-29T01:43,0,290000
326,1727788,57,126000,150000,96.0,350,2023-03-29T01:43,-12600,113400
327,2131978,58,132050,139000,97.0,234,2023-03-29T01:43,-6603,125447
328,1456515,59,49500,55000,97.0,8679,2023-03-29T01:43,0,49500
329,3045584,60,130500,145000,97.0,3747,2023-03-29T01:43,-13050,117450
330,3030194,61,229000,470000,0.0,0,2023-03-29T01:43,-30000,199000
331,2770504,62,138000,0,95.0,128,2023-03-29T01:43,0,138000
332,2491355,63,74610,82900,98.0,440,2023-03-29T01:43,0,74610
333,1745100,64,103500,109000,97.0,974,2023-03-29T01:43,0,103500
334,2725940,65,1130000,1570000,0.0,0,2023-03-29T01:43,-30000,1100000
335,693525,66,46800,65000,96.0,3939,2023-03-29T01:43,0,46800
336,1884626,67,36800,46000,97.0,4881,2023-03-29T01:43,0,36800
337,2771875,68,349000,0,96.0,97,2023-03-29T01:43,0,349000
338,2702033,69,127200,159000,97.0,373,2023-03-29T01:43,-25440,101760
339,2624678,70,145000,0,96.0,130,2023-03-29T01:43,0,145000
340,1758217,71,43900,56000,97.0,13052,2023-03-29T01:43,-2195,41705
341,3176942,72,71100,79000,0.0,0,2023-03-29T01:43,0,71100
342,3111136,73,129600,144000,100.0,22,2023-03-29T01:43,0,129600
343,3011494,74,69900,79000,96.0,208,2023-03-29T01:43,-6990,62910
344,2123839,75,74610,82900,97.0,1272,2023-03-29T01:43,0,74610
345,2777545,76,130000,0,95.0,169,2023-03-29T01:43,0,130000
346,2930265,77,91000,0,98.0,517,2023-03-29T01:43,0,91000
347,1749492,78,89100,99000,98.0,3829,2023-03-29T01:43,0,89100
348,2621696,79,234000,0,97.0,165,2023-03-29T01:43,0,234000
349,2973749,80,945000,1535000,90.0,2,2023-03-29T01:43,-30000,915000
350,1534526,81,52200,55000,97.0,2381,2023-03-29T01:43,0,52200
351,2754080,82,88000,0,97.0,451,2023-03-29T01:43,0,88000
352,276256,83,58500,98000,96.0,14648,2023-03-29T01:43,0,58500
353,2688604,84,159000,0,97.0,809,2023-03-29T01:43,0,159000
354,938746,85,80100,89000,95.0,12480,2023-03-29T01:43,0,80100
355,3070516,86,138000,0,98.0,15,2023-03-29T01:43,0,138000
356,1597319,87,89100,99000,97.0,551,2023-03-29T01:43,-8910,80190
357,3176943,88,71100,79000,0.0,0,2023-03-29T01:43,0,71100
358,2982246,89,43000,0,96.0,139,2023-03-29T01:43,0,43000
359,3047568,90,129000,0,95.0,32,2023-03-29T01:43,0,129000
360,2638067,1,99000,139000,97.0,2905,2023-03-29T01:43,0,99000
361,969541,2,69000,0,97.0,29121,2023-03-29T01:43,0,69000
362,2293400,3,129000,0,96.0,882,2023-03-29T01:43,0,129000
363,1762406,4,260000,0,98.0,3224,2023-03-29T01:43,0,260000
364,1762407,5,260000,0,97.0,3047,2023-03-29T01:43,0,260000
365,810034,6,85500,95000,97.0,45054,2023-03-29T01:43,0,85500
366,1622068,7,119000,0,97.0,6433,2023-03-29T01:43,0,119000
367,311052,8,53100,59000,97.0,40995,2023-03-29T01:43,0,53100
368,1955217,9,69000,109000,96.0,5101,2023-03-29T01:43,-13800,55200
369,3079037,10,195000,0,97.0,177,2023-03-29T01:43,0,195000
370,577636,11,99900,139000,95.0,31024,2023-03-29T01:43,0,99900
371,2622254,12,109000,0,98.0,846,2023-03-29T01:43,0,109000
372,2320478,13,129000,0,97.0,451,2023-03-29T01:43,0,129000
373,186610,14,75900,85000,97.0,16439,2023-03-29T01:43,0,75900
374,2916273,15,159000,0,98.0,138,2023-03-29T01:43,0,159000
375,181907,16,89900,119000,97.0,7033,2023-03-29T01:43,0,89900
376,3030422,17,139000,0,96.0,769,2023-03-29T01:43,0,139000
377,2741233,18,109000,0,97.0,2611,2023-03-29T01:43,0,109000
378,1792640,19,99000,0,98.0,3416,2023-03-29T01:43,0,99000
379,810033,20,89100,99000,97.0,34172,2023-03-29T01:43,0,89100
380,3033248,21,109000,0,97.0,570,2023-03-29T01:43,0,109000
381,695334,22,78900,99000,96.0,9182,2023-03-29T01:43,0,78900
382,1955210,23,69000,109000,95.0,1477,2023-03-29T01:43,-13800,55200
383,810032,24,85500,95000,97.0,13692,2023-03-29T01:43,0,85500
384,3023097,25,230000,0,98.0,81,2023-03-29T01:43,0,230000
385,102620,26,69000,0,97.0,17710,2023-03-29T01:43,0,69000
386,2778805,27,99000,0,97.0,914,2023-03-29T01:43,0,99000
387,2662649,28,485000,790000,98.0,189,2023-03-29T01:43,-30000,455000
388,2909715,29,119000,0,96.0,71,2023-03-29T01:43,0,119000
389,3071174,30,107000,164000,100.0,20,2023-03-29T01:43,-21400,85600
390,1686571,31,59900,129000,97.0,5327,2023-03-29T01:43,0,59900
391,1354129,32,67000,99000,95.0,8646,2023-03-29T01:43,-13400,53600
392,2233180,33,75900,109000,97.0,14093,2023-03-29T01:43,0,75900
393,490135,34,75900,95000,97.0,3131,2023-03-29T01:43,0,75900
394,2675279,35,41300,59000,96.0,59,2023-03-29T01:43,-8260,33040
395,2524840,36,139000,0,97.0,799,2023-03-29T01:43,0,139000
396,2268512,37,109000,0,97.0,409,2023-03-29T01:43,0,109000
397,490136,38,76000,95000,98.0,2048,2023-03-29T01:43,0,76000
398,2992063,39,280000,0,98.0,2120,2023-03-29T01:43,0,280000
399,311050,40,53100,59000,97.0,8969,2023-03-29T01:43,0,53100
400,1493265,41,85500,95000,98.0,4847,2023-03-29T01:43,0,85500
401,3091287,42,119000,0,98.0,217,2023-03-29T01:43,0,119000
402,816033,43,70900,89000,96.0,13185,2023-03-29T01:43,0,70900
403,2632730,44,150000,0,98.0,18,2023-03-29T01:43,0,150000
404,2233178,45,75900,109000,97.0,4890,2023-03-29T01:43,0,75900
405,311051,46,58500,65000,97.0,19508,2023-03-29T01:43,0,58500
406,1353454,47,67000,99000,95.0,4412,2023-03-29T01:43,-13400,53600
407,1130307,48,109000,0,97.0,6023,2023-03-29T01:43,0,109000
408,1296778,49,99000,0,98.0,2038,2023-03-29T01:43,0,99000
409,2161992,50,69900,95000,98.0,3162,2023-03-29T01:43,0,69900
410,1798273,51,75000,119000,96.0,1150,2023-03-29T01:43,0,75000
411,2493214,52,169000,0,98.0,161,2023-03-29T01:43,0,169000
412,2622252,53,109000,0,97.0,202,2023-03-29T01:43,0,109000
413,1473136,54,119900,149000,97.0,10744,2023-03-29T01:43,0,119900
414,1494180,55,71100,79000,95.0,5208,2023-03-29T01:43,0,71100
415,2737457,56,230000,0,98.0,422,2023-03-29T01:43,0,230000
416,1729744,57,76500,85000,97.0,3305,2023-03-29T01:43,0,76500
417,1296776,58,99000,0,98.0,2914,2023-03-29T01:43,0,99000
418,3100522,59,129000,0,98.0,148,2023-03-29T01:43,0,129000
419,3136271,60,89100,99000,0.0,0,2023-03-29T01:43,0,89100
420,1594352,61,85000,0,97.0,5549,2023-03-29T01:43,0,85000
421,2970200,62,79000,0,99.0,439,2023-03-29T01:43,0,79000
422,2700077,63,170000,0,100.0,11,2023-03-29T01:43,0,170000
423,104240,64,69000,0,96.0,3839,2023-03-29T01:43,0,69000
424,2355071,65,265000,0,97.0,477,2023-03-29T01:43,0,265000
425,957758,66,89000,0,97.0,4347,2023-03-29T01:43,0,89000
426,2970198,67,89000,0,97.0,191,2023-03-29T01:43,0,89000
427,1492897,68,75000,0,96.0,3033,2023-03-29T01:43,0,75000
428,1812247,69,89000,0,97.0,3018,2023-03-29T01:43,0,89000
429,1868015,70,119900,129000,97.0,1916,2023-03-29T01:43,0,119900
430,1817778,71,69000,0,97.0,4072,2023-03-29T01:43,0,69000
431,165988,72,69000,0,96.0,4769,2023-03-29T01:43,0,69000
432,2861392,73,124900,139000,97.0,550,2023-03-29T01:43,0,124900
433,1017974,74,71100,79000,95.0,2911,2023-03-29T01:43,0,71100
434,2990142,75,99000,0,97.0,50,2023-03-29T01:43,0,99000
435,1017973,76,71100,79000,95.0,1176,2023-03-29T01:43,0,71100
436,1256468,77,109000,0,97.0,3545,2023-03-29T01:43,0,109000
437,1718449,78,85500,95000,97.0,2068,2023-03-29T01:43,0,85500
438,2032854,79,99000,0,97.0,57,2023-03-29T01:43,0,99000
439,2267008,80,89100,99000,98.0,488,2023-03-29T01:43,0,89100
440,2150233,81,170000,0,97.0,140,2023-03-29T01:43,0,170000
441,2861393,82,109900,139000,93.0,267,2023-03-29T01:43,0,109900
442,2700073,83,170000,0,96.0,11,2023-03-29T01:43,0,170000
443,3020491,84,78900,99000,98.0,39,2023-03-29T01:43,0,78900
444,3096431,85,139000,0,99.0,20,2023-03-29T01:43,0,139000
445,1635193,86,59390,69900,96.0,3635,2023-03-29T01:43,-5939,53451
446,2631192,87,98100,109000,98.0,328,2023-03-29T01:43,0,98100
447,1478592,88,75900,95000,97.0,2902,2023-03-29T01:43,0,75900
448,102618,89,69000,0,97.0,6011,2023-03-29T01:43,0,69000
449,810031,90,89100,99000,97.0,7842,2023-03-29T01:43,0,89100
450,1092992,1,69000,0,97.0,37610,2023-03-29T01:43,0,69000
451,2430426,2,169000,0,98.0,698,2023-03-29T01:43,0,169000
452,2114452,3,429900,478000,97.0,518,2023-03-29T01:43,0,429900
453,2091749,4,75650,89000,95.0,6160,2023-03-29T01:43,0,75650
454,1568047,5,143100,159000,95.0,11975,2023-03-29T01:43,0,143100
455,2816816,6,159900,0,97.0,1807,2023-03-29T01:43,0,159900
456,2101924,7,99900,0,96.0,1340,2023-03-29T01:43,-9990,89910
457,1562990,8,230000,0,96.0,1271,2023-03-29T01:43,0,230000
458,2433538,9,86700,102000,96.0,2323,2023-03-29T01:43,0,86700
459,1339622,10,42900,59000,97.0,16128,2023-03-29T01:43,0,42900
460,3156676,11,259000,299000,0.0,0,2023-03-29T01:43,-12950,246050
461,2910082,12,265500,295000,98.0,430,2023-03-29T01:43,0,265500
462,3024585,13,59000,0,97.0,85,2023-03-29T01:43,-11800,47200
463,2069832,14,199900,332000,95.0,747,2023-03-29T01:43,-9995,189905
464,1890398,15,132000,168000,96.0,2678,2023-03-29T01:43,0,132000
465,2143833,16,91800,108000,96.0,2372,2023-03-29T01:43,0,91800
466,2432733,17,44900,59000,97.0,2660,2023-03-29T01:43,0,44900
467,2518112,18,89250,105000,96.0,925,2023-03-29T01:43,0,89250
468,2664372,19,65000,0,97.0,982,2023-03-29T01:43,0,65000
469,2664373,20,65000,0,97.0,937,2023-03-29T01:43,0,65000
470,595039,21,210000,0,97.0,3473,2023-03-29T01:43,0,210000
471,2624538,22,40900,59000,97.0,1359,2023-03-29T01:43,0,40900
472,2816812,23,119900,0,92.0,1497,2023-03-29T01:43,0,119900
473,2210246,24,259000,299000,97.0,84,2023-03-29T01:43,-12950,246050
474,595040,25,210000,0,95.0,8696,2023-03-29T01:43,0,210000
475,2395327,26,149000,0,97.0,541,2023-03-29T01:43,0,149000
476,1129750,27,69000,0,97.0,3872,2023-03-29T01:43,0,69000
477,2858618,28,520000,685000,91.0,12,2023-03-29T01:43,-30000,490000
478,2599641,29,67830,119000,96.0,1974,2023-03-29T01:43,-3392,64438
479,1548618,30,152000,198000,96.0,3280,2023-03-29T01:43,0,152000
480,2305523,31,139000,198000,96.0,67,2023-03-29T01:43,0,139000
481,2355318,32,98790,109900,96.0,629,2023-03-29T01:43,-9879,88911
482,2979844,33,976000,1090000,0.0,0,2023-03-29T01:43,-30000,946000
483,3062046,34,78300,87000,96.0,70,2023-03-29T01:43,-3915,74385
484,2305529,35,132000,168000,98.0,76,2023-03-29T01:43,0,132000
485,1699941,36,67150,79000,97.0,4765,2023-03-29T01:43,-3358,63792
486,1952910,37,265500,295000,98.0,1719,2023-03-29T01:43,0,265500
487,3124961,38,62100,69000,94.0,20,2023-03-29T01:43,-3105,58995
488,1815709,39,132000,168000,96.0,7103,2023-03-29T01:43,0,132000
489,3049313,40,57100,64900,97.0,412,2023-03-29T01:43,0,57100
490,1334438,41,170000,0,96.0,4377,2023-03-29T01:43,0,170000
491,2217183,42,167000,239000,0.0,0,2023-03-29T01:43,-33400,133600
492,685185,43,139000,198000,95.0,12466,2023-03-29T01:43,0,139000
493,665782,44,260000,0,95.0,3634,2023-03-29T01:43,0,260000
494,1021359,45,76000,100000,94.0,5370,2023-03-29T01:43,0,76000
495,3178532,46,189000,0,0.0,0,2023-03-29T01:43,0,189000
496,2785256,47,57850,89000,94.0,34,2023-03-29T01:43,-2893,54957
497,2210179,48,259000,299000,98.0,37,2023-03-29T01:43,-12950,246050
498,2673895,49,504000,960000,100.0,3,2023-03-29T01:43,-30000,474000
499,1754219,50,31200,39000,96.0,2224,2023-03-29T01:43,0,31200
500,2752886,51,69000,99000,96.0,593,2023-03-29T01:43,-13800,55200
501,2098793,52,79200,99000,96.0,1583,2023-03-29T01:43,0,79200
502,1973858,53,143200,179000,98.0,1166,2023-03-29T01:43,0,143200
503,3030191,54,485000,1390000,0.0,0,2023-03-29T01:43,-30000,455000
504,2383245,55,99000,0,98.0,797,2023-03-29T01:43,0,99000
505,2091779,56,75600,89000,97.0,980,2023-03-29T01:43,0,75600
506,2621831,57,64000,85000,95.0,685,2023-03-29T01:43,0,64000
507,3061996,58,88200,98000,98.0,48,2023-03-29T01:43,-4410,83790
508,2355319,59,101890,119900,96.0,488,2023-03-29T01:43,0,101890
509,1262089,60,300000,0,97.0,1580,2023-03-29T01:43,0,300000
510,1296051,61,78300,87000,94.0,3445,2023-03-29T01:43,0,78300
511,1720822,62,209000,0,97.0,293,2023-03-29T01:43,0,209000
512,2257887,63,109000,119000,96.0,2332,2023-03-29T01:43,0,109000
513,716088,64,218000,0,95.0,102,2023-03-29T01:43,0,218000
514,2736110,65,154000,220000,98.0,109,2023-03-29T01:43,0,154000
515,3060326,66,658000,0,0.0,0,2023-03-29T01:43,0,658000
516,2736011,67,193200,276000,99.0,158,2023-03-29T01:43,0,193200
517,2210201,68,259000,299000,94.0,193,2023-03-29T01:43,-12950,246050
518,1439535,69,49000,0,96.0,16279,2023-03-29T01:43,0,49000
519,1264085,70,265500,295000,97.0,3367,2023-03-29T01:43,0,265500
520,1828555,71,258000,0,96.0,387,2023-03-29T01:43,0,258000
521,3095708,72,200000,0,100.0,2,2023-03-29T01:43,0,200000
522,1128656,73,86800,99000,95.0,21558,2023-03-29T01:43,0,86800
523,2556150,74,298000,373000,96.0,10,2023-03-29T01:43,0,298000
524,2437045,75,157000,218000,97.0,477,2023-03-29T01:43,0,157000
525,1262092,76,250000,0,96.0,765,2023-03-29T01:43,0,250000
526,607298,77,53600,59000,93.0,15546,2023-03-29T01:43,0,53600
527,2356342,78,103890,129900,94.0,446,2023-03-29T01:43,0,103890
528,626636,79,260000,0,96.0,1110,2023-03-29T01:43,0,260000
529,3124959,80,52200,58000,98.0,15,2023-03-29T01:43,-2610,49590
530,3045292,81,82000,0,97.0,34,2023-03-29T01:43,0,82000
531,3102922,82,89000,0,98.0,10,2023-03-29T01:43,0,89000
532,1010925,83,170000,0,96.0,2087,2023-03-29T01:43,0,170000
533,1087674,84,83700,93000,95.0,1752,2023-03-29T01:43,0,83700
534,2330198,85,59000,0,97.0,390,2023-03-29T01:43,0,59000
535,626637,86,260000,0,96.0,386,2023-03-29T01:43,0,260000
536,1438359,87,98000,0,97.0,1154,2023-03-29T01:43,0,98000
537,2114455,88,478000,0,99.0,187,2023-03-29T01:43,0,478000
538,1799984,89,247500,275000,98.0,1142,2023-03-29T01:43,0,247500
539,3075621,90,339000,0,97.0,55,2023-03-29T01:43,0,339000
540,2280117,1,35100,39000,97.0,6097,2023-03-29T01:43,0,35100
541,1214164,2,36000,0,96.0,24801,2023-03-29T01:43,0,36000
542,2879419,3,46900,55000,98.0,605,2023-03-29T01:43,0,46900
543,2134140,4,39000,0,97.0,3448,2023-03-29T01:43,0,39000
544,1214109,5,36000,0,97.0,8020,2023-03-29T01:43,0,36000
545,1272626,6,36000,0,96.0,14044,2023-03-29T01:43,0,36000
546,1771137,7,29000,0,97.0,12355,2023-03-29T01:43,0,29000
547,1214174,8,36000,0,97.0,14950,2023-03-29T01:43,0,36000
548,1822717,9,56050,59000,97.0,4248,2023-03-29T01:43,-2803,53247
549,3153584,10,45000,0,0.0,0,2023-03-29T01:43,-2250,42750
550,2286829,11,33300,37000,95.0,4790,2023-03-29T01:43,0,33300
551,1022014,12,79000,0,96.0,11402,2023-03-29T01:43,0,79000
552,1022013,13,79000,0,96.0,6235,2023-03-29T01:43,0,79000
553,2879425,14,46900,55000,97.0,230,2023-03-29T01:43,0,46900
554,2288650,15,42000,0,96.0,1500,2023-03-29T01:43,0,42000
555,1214317,16,36000,0,97.0,11429,2023-03-29T01:43,0,36000
556,1771132,17,29000,0,96.0,5181,2023-03-29T01:43,0,29000
557,2356713,18,39000,0,97.0,1420,2023-03-29T01:43,0,39000
558,3153581,19,45000,0,0.0,0,2023-03-29T01:43,-2250,42750
559,1907733,20,29900,39000,96.0,3780,2023-03-29T01:43,0,29900
560,1920929,21,39000,0,97.0,3944,2023-03-29T01:43,0,39000
561,2107999,22,36000,0,97.0,2637,2023-03-29T01:43,0,36000
562,1214173,23,36000,0,96.0,5513,2023-03-29T01:43,0,36000
563,1855444,24,37800,42000,97.0,2965,2023-03-29T01:43,0,37800
564,2221221,25,35100,39000,96.0,1827,2023-03-29T01:43,0,35100
565,2288644,26,42000,0,96.0,1186,2023-03-29T01:43,0,42000
566,2134158,27,39000,0,97.0,2452,2023-03-29T01:43,0,39000
567,3012243,28,27900,39900,98.0,51,2023-03-29T01:43,0,27900
568,1214169,29,36000,0,97.0,5293,2023-03-29T01:43,0,36000
569,2715553,30,68000,0,95.0,242,2023-03-29T01:43,0,68000
570,3146242,31,46000,0,100.0,13,2023-03-29T01:43,-4600,41400
571,2123132,32,39000,0,97.0,6343,2023-03-29T01:43,0,39000
572,1771133,33,29000,0,97.0,5636,2023-03-29T01:43,0,29000
573,2650965,34,46900,53000,98.0,355,2023-03-29T01:43,0,46900
574,2464070,35,44000,55000,97.0,288,2023-03-29T01:43,-2200,41800
575,1524720,36,36000,0,96.0,3353,2023-03-29T01:43,0,36000
576,3153577,37,45000,0,0.0,0,2023-03-29T01:43,-2250,42750
577,2560668,38,58650,69000,97.0,1220,2023-03-29T01:43,0,58650
578,3142343,39,49000,0,100.0,2,2023-03-29T01:43,-4900,44100
579,2287131,40,33300,37000,95.0,1573,2023-03-29T01:43,0,33300
580,1086824,41,29600,37000,95.0,18589,2023-03-29T01:43,0,29600
581,2707659,42,42000,0,97.0,495,2023-03-29T01:43,0,42000
582,2356711,43,39000,0,97.0,1446,2023-03-29T01:43,0,39000
583,2859190,44,33300,37000,96.0,394,2023-03-29T01:43,0,33300
584,2053753,45,33600,42000,98.0,4098,2023-03-29T01:43,0,33600
585,2922336,46,52000,0,97.0,128,2023-03-29T01:43,-5200,46800
586,2028240,47,39000,0,98.0,3321,2023-03-29T01:43,0,39000
587,2650966,48,46900,53000,97.0,174,2023-03-29T01:43,0,46900
588,2089719,49,36000,0,97.0,2384,2023-03-29T01:43,0,36000
589,3142357,50,63000,0,0.0,0,2023-03-29T01:43,-6300,56700
590,1920840,51,39000,0,98.0,1354,2023-03-29T01:43,0,39000
591,2329375,52,34710,39000,97.0,2046,2023-03-29T01:43,0,34710
592,1335132,53,29000,0,95.0,1093,2023-03-29T01:43,0,29000
593,1497550,54,29600,37000,95.0,5647,2023-03-29T01:43,0,29600
594,3129421,55,42000,0,0.0,0,2023-03-29T01:43,0,42000
595,1925814,56,35100,39000,96.0,1625,2023-03-29T01:43,0,35100
596,470355,57,16900,19000,95.0,5268,2023-03-29T01:43,0,16900
597,3142351,58,49000,0,100.0,2,2023-03-29T01:43,-4900,44100
598,2288645,59,42000,0,95.0,1021,2023-03-29T01:43,0,42000
599,1214106,60,36000,0,96.0,9704,2023-03-29T01:43,0,36000
600,3135790,61,69000,0,100.0,1,2023-03-29T01:43,0,69000
601,1433907,62,29250,39000,93.0,1467,2023-03-29T01:43,0,29250
602,3051146,63,34000,0,0.0,0,2023-03-29T01:43,-3400,30600
603,2356693,64,39000,0,97.0,1507,2023-03-29T01:43,0,39000
604,2699678,65,36000,0,98.0,250,2023-03-29T01:43,0,36000
605,3142350,66,49000,0,100.0,1,2023-03-29T01:43,-4900,44100
606,2573131,67,37800,42000,98.0,682,2023-03-29T01:43,0,37800
607,1126959,68,29250,39000,91.0,2543,2023-03-29T01:43,0,29250
608,1452917,69,69000,0,96.0,2403,2023-03-29T01:43,0,69000
609,1906772,70,37800,42000,97.0,3022,2023-03-29T01:43,0,37800
610,2672186,71,20900,30000,96.0,532,2023-03-29T01:43,-2090,18810
611,3142358,72,63000,0,0.0,0,2023-03-29T01:43,-6300,56700
612,2603392,73,42750,45000,93.0,106,2023-03-29T01:43,0,42750
613,2687157,74,36000,45000,97.0,1004,2023-03-29T01:43,0,36000
614,2591291,75,39200,49000,97.0,1003,2023-03-29T01:43,0,39200
615,2242049,76,37000,0,98.0,709,2023-03-29T01:43,0,37000
616,2921965,77,52000,0,98.0,169,2023-03-29T01:43,-5200,46800
617,2650964,78,46900,53000,98.0,164,2023-03-29T01:43,0,46900
618,1433913,79,31500,42000,94.0,3575,2023-03-29T01:43,0,31500
619,3142344,80,49000,0,0.0,0,2023-03-29T01:43,-4900,44100
620,2280146,81,35100,39000,97.0,900,2023-03-29T01:43,0,35100
621,1755276,82,44100,49000,97.0,2393,2023-03-29T01:43,0,44100
622,2715565,83,68000,0,95.0,88,2023-03-29T01:43,0,68000
623,2879422,84,46900,55000,100.0,14,2023-03-29T01:43,0,46900
624,2677207,85,59000,0,98.0,67,2023-03-29T01:43,0,59000
625,3142355,86,49000,0,100.0,2,2023-03-29T01:43,-4900,44100
626,3099130,87,54000,0,100.0,11,2023-03-29T01:43,0,54000
627,1945782,88,56000,0,97.0,2502,2023-03-29T01:43,0,56000
628,2535631,89,35100,39000,95.0,331,2023-03-29T01:43,0,35100
629,836294,90,37800,42000,94.0,2431,2023-03-29T01:43,0,37800
630,2567006,1,1563000,2906000,0.0,0,2023-03-29T01:43,-30000,1533000
631,3135904,2,92000,0,0.0,0,2023-03-29T01:43,-4600,87400
632,2605850,3,94000,0,97.0,158,2023-03-29T01:43,-4700,89300
633,3106487,4,148000,0,100.0,16,2023-03-29T01:43,0,148000
634,3059119,5,179000,0,92.0,13,2023-03-29T01:43,-35800,143200
635,2587981,6,293300,419000,0.0,0,2023-03-29T01:43,-43995,249305
636,2489894,7,150100,158000,98.0,101,2023-03-29T01:43,-7505,142595
637,1871030,8,133600,167000,95.0,96,2023-03-29T01:43,-6680,126920
638,3135497,9,150100,158000,0.0,0,2023-03-29T01:43,0,150100
639,3146212,10,69900,0,0.0,0,2023-03-29T01:43,-3495,66405
640,2478652,11,57800,68000,94.0,326,2023-03-29T01:43,-2720,55080
641,3085850,12,115200,128000,0.0,0,2023-03-29T01:43,0,115200
642,3103895,13,319000,0,0.0,0,2023-03-29T01:43,-47850,271150
643,3085822,14,115200,128000,0.0,0,2023-03-29T01:43,0,115200
644,3158246,15,278000,0,0.0,0,2023-03-29T01:43,-27800,250200
645,2393504,16,94000,0,99.0,49,2023-03-29T01:43,-4700,89300
646,3091290,17,85000,0,0.0,0,2023-03-29T01:43,0,85000
647,2485838,18,259000,0,100.0,1,2023-03-29T01:43,0,259000
648,3077360,19,98000,0,100.0,2,2023-03-29T01:43,-4900,93100
649,2722248,20,249000,329000,0.0,0,2023-03-29T01:43,-37350,211650
650,3073257,21,196200,218000,100.0,6,2023-03-29T01:43,-29430,166770
651,3119228,22,239000,0,0.0,0,2023-03-29T01:43,0,239000
652,3155026,23,58500,78000,0.0,0,2023-03-29T01:43,0,58500
653,2610670,24,234000,0,100.0,3,2023-03-29T01:43,0,234000
654,3121407,25,238000,0,0.0,0,2023-03-29T01:43,0,238000
655,2552135,26,234000,0,80.0,1,2023-03-29T01:43,0,234000
656,3099799,27,114000,120000,90.0,2,2023-03-29T01:43,0,114000
657,3082783,28,218000,0,0.0,0,2023-03-29T01:43,0,218000
658,3129903,29,176000,0,0.0,0,2023-03-29T01:43,0,176000
659,3040561,30,175750,185000,97.0,7,2023-03-29T01:43,-8788,166962
660,2825657,31,219000,0,0.0,0,2023-03-29T01:43,0,219000
661,3124594,32,198000,0,0.0,0,2023-03-29T01:43,-39600,158400
662,3053225,33,159000,0,100.0,2,2023-03-29T01:43,0,159000
663,3081772,34,189000,0,0.0,0,2023-03-29T01:43,-9450,179550
664,2540039,35,210000,0,0.0,0,2023-03-29T01:43,0,210000
665,3053760,36,178200,198000,0.0,0,2023-03-29T01:43,-8910,169290
666,3171883,37,149000,0,0.0,0,2023-03-29T01:43,0,149000
667,2512635,38,35400,59000,96.0,199,2023-03-29T01:43,0,35400
668,2871448,39,206000,0,100.0,1,2023-03-29T01:43,0,206000
669,2044442,40,70000,0,96.0,170,2023-03-29T01:43,0,70000
670,3129908,41,176000,0,0.0,0,2023-03-29T01:43,0,176000
671,2665521,42,198000,0,0.0,0,2023-03-29T01:43,0,198000
672,3124602,43,198000,0,0.0,0,2023-03-29T01:43,-39600,158400
673,3081771,44,189000,0,100.0,1,2023-03-29T01:43,-9450,179550
674,3130633,45,149000,0,100.0,3,2023-03-29T01:43,-7450,141550
675,3041848,46,168000,0,0.0,0,2023-03-29T01:43,0,168000
676,3053221,47,179000,0,0.0,0,2023-03-29T01:43,0,179000
677,3083230,48,159000,0,100.0,5,2023-03-29T01:43,-7950,151050
678,1792540,49,94250,145000,94.0,58,2023-03-29T01:43,-4713,89537
679,2568590,50,185000,0,100.0,3,2023-03-29T01:43,0,185000
680,2411317,51,182400,228000,90.0,4,2023-03-29T01:43,0,182400
681,2621818,52,178000,0,100.0,3,2023-03-29T01:43,0,178000
682,2606143,53,189000,0,0.0,0,2023-03-29T01:43,0,189000
683,2055776,54,99200,124000,88.0,26,2023-03-29T01:43,0,99200
684,3050856,55,189000,0,93.0,12,2023-03-29T01:43,-9450,179550
685,3055415,56,160000,0,93.0,3,2023-03-29T01:43,-24000,136000
686,2956040,57,188000,0,0.0,0,2023-03-29T01:43,0,188000
687,1864555,58,189000,0,0.0,0,2023-03-29T01:43,0,189000
688,3065781,59,179000,0,0.0,0,2023-03-29T01:43,-8950,170050
689,3153612,60,178200,198000,0.0,0,2023-03-29T01:43,-26730,151470
690,2786207,61,167300,239000,0.0,0,2023-03-29T01:43,-8365,158935
691,3078196,62,178000,0,60.0,2,2023-03-29T01:43,-35600,142400
692,3130637,63,169000,0,0.0,0,2023-03-29T01:43,-8450,160550
693,2492543,64,169000,0,95.0,13,2023-03-29T01:43,-25350,143650
694,3122381,65,151200,168000,100.0,3,2023-03-29T01:43,-22680,128520
695,1954215,66,90000,0,97.0,80,2023-03-29T01:43,0,90000
696,2631858,67,174000,290000,0.0,0,2023-03-29T01:43,0,174000
697,2457508,68,153300,219000,97.0,28,2023-03-29T01:43,0,153300
698,3055338,69,159000,0,100.0,2,2023-03-29T01:43,0,159000
699,3109926,70,69700,82000,86.0,3,2023-03-29T01:43,0,69700
700,2684609,71,169000,0,100.0,1,2023-03-29T01:43,0,169000
701,3041837,72,168000,0,0.0,0,2023-03-29T01:43,0,168000
702,2684605,73,164000,0,0.0,0,2023-03-29T01:43,0,164000
703,3169743,74,159000,0,0.0,0,2023-03-29T01:43,0,159000
704,3134492,75,79000,0,100.0,2,2023-03-29T01:43,0,79000
705,3092123,76,142200,158000,100.0,2,2023-03-29T01:43,-7110,135090
706,3103309,77,159000,0,0.0,0,2023-03-29T01:43,-7950,151050
707,3070801,78,112100,118000,92.0,5,2023-03-29T01:43,-5605,106495
708,2585141,79,148000,0,86.0,6,2023-03-29T01:43,0,148000
709,3137343,80,125100,139000,0.0,0,2023-03-29T01:43,0,125100
710,2966695,81,156000,0,0.0,0,2023-03-29T01:43,0,156000
711,3146767,82,152150,179000,0.0,0,2023-03-29T01:43,-22823,129327
712,3092128,83,142200,158000,100.0,1,2023-03-29T01:43,-7110,135090
713,2817718,84,150000,0,0.0,0,2023-03-29T01:43,0,150000
714,3152272,85,140000,178000,0.0,0,2023-03-29T01:43,0,140000
715,2392491,86,31900,0,96.0,393,2023-03-29T01:43,0,31900
716,2585384,87,147500,0,0.0,0,2023-03-29T01:43,0,147500
717,1579103,88,126400,158000,96.0,96,2023-03-29T01:43,-6320,120080
718,2585620,89,139000,0,100.0,2,2023-03-29T01:43,-6950,132050
719,2612357,90,69000,139000,98.0,12,2023-03-29T01:43,0,69000
720,2867750,1,135000,0,96.0,36,2023-03-29T01:43,-6750,128250
721,3051039,2,95200,119000,100.0,17,2023-03-29T01:43,-19040,76160
722,2377805,3,188100,198000,92.0,17,2023-03-29T01:43,-28215,159885
723,2551401,4,37900,0,94.0,282,2023-03-29T01:43,0,37900
724,3136729,5,538200,598000,0.0,0,2023-03-29T01:43,0,538200
725,2796166,6,51200,64000,96.0,218,2023-03-29T01:43,-2560,48640
726,3099401,7,439000,0,0.0,0,2023-03-29T01:43,0,439000
727,1931894,8,37900,0,95.0,492,2023-03-29T01:43,0,37900
728,3026955,9,86700,102000,0.0,0,2023-03-29T01:43,-4335,82365
729,2925522,10,54600,65000,96.0,83,2023-03-29T01:43,0,54600
730,3000422,11,59000,0,97.0,23,2023-03-29T01:43,0,59000
731,3119332,12,379000,0,0.0,0,2023-03-29T01:43,0,379000
732,3130182,13,165000,0,0.0,0,2023-03-29T01:43,0,165000
733,3130181,14,165000,0,0.0,0,2023-03-29T01:43,0,165000
734,3073252,15,160200,178000,100.0,1,2023-03-29T01:43,-24030,136170
735,2144842,16,65400,109000,95.0,19,2023-03-29T01:43,0,65400
736,3100903,17,159600,168000,100.0,1,2023-03-29T01:43,-23940,135660
737,2830788,18,139000,0,95.0,24,2023-03-29T01:43,-6950,132050
738,3031104,19,55200,69000,98.0,43,2023-03-29T01:43,-11040,44160
739,2806614,20,107100,119000,97.0,95,2023-03-29T01:43,0,107100
740,2350806,21,152600,218000,100.0,1,2023-03-29T01:43,-22890,129710
741,2591002,22,152600,218000,100.0,3,2023-03-29T01:43,-22890,129710
742,2836351,23,49680,72000,96.0,418,2023-03-29T01:43,-4968,44712
743,2788546,24,279000,0,100.0,3,2023-03-29T01:43,-41850,237150
744,2588036,25,293300,419000,0.0,0,2023-03-29T01:43,-43995,249305
745,3088698,26,290000,0,0.0,0,2023-03-29T01:43,0,290000
746,2551407,27,37900,0,97.0,150,2023-03-29T01:43,0,37900
747,2704640,28,278600,398000,0.0,0,2023-03-29T01:43,0,278600
748,3040824,29,74100,78000,100.0,6,2023-03-29T01:43,-3705,70395
749,2858702,30,271000,0,0.0,0,2023-03-29T01:43,-30000,241000
750,3167884,31,133200,148000,0.0,0,2023-03-29T01:43,0,133200
751,2117253,32,43900,0,94.0,252,2023-03-29T01:43,0,43900
752,3121771,33,129000,0,0.0,0,2023-03-29T01:43,-19350,109650
753,2316503,34,51200,64000,94.0,308,2023-03-29T01:43,-2560,48640
754,3142895,35,94050,99000,0.0,0,2023-03-29T01:43,0,94050
755,2111542,36,39900,0,95.0,384,2023-03-29T01:43,0,39900
756,2607685,37,238000,0,0.0,0,2023-03-29T01:43,-35700,202300
757,3051036,38,95200,119000,100.0,3,2023-03-29T01:43,-19040,76160
758,2300718,39,39390,43900,95.0,234,2023-03-29T01:43,0,39390
759,2703197,40,118300,169000,100.0,7,2023-03-29T01:43,-17745,100555
760,3070528,41,168000,0,0.0,0,2023-03-29T01:43,-8400,159600
761,3142040,42,91800,102000,80.0,2,2023-03-29T01:43,0,91800
762,2756335,43,125400,132000,96.0,52,2023-03-29T01:43,-6270,119130
763,2551406,44,37900,0,95.0,193,2023-03-29T01:43,0,37900
764,3122278,45,160200,178000,100.0,1,2023-03-29T01:43,-24030,136170
765,3040812,46,74100,78000,100.0,13,2023-03-29T01:43,-3705,70395
766,2830808,47,139000,0,97.0,15,2023-03-29T01:43,-6950,132050
767,3062954,48,103550,109000,0.0,0,2023-03-29T01:43,-4905,98645
768,3059048,49,109000,0,73.0,3,2023-03-29T01:43,-16350,92650
769,2377814,50,188100,198000,96.0,68,2023-03-29T01:43,-28215,159885
770,3179337,51,183000,0,0.0,0,2023-03-29T01:43,0,183000
771,2377812,52,188100,198000,97.0,57,2023-03-29T01:43,-28215,159885
772,1999505,53,71200,89000,94.0,33,2023-03-29T01:43,0,71200
773,3130177,54,198000,0,0.0,0,2023-03-29T01:43,0,198000
774,2417220,55,196000,0,0.0,0,2023-03-29T01:43,-29400,166600
775,2860567,56,167300,239000,0.0,0,2023-03-29T01:43,-25095,142205
776,3160571,57,199000,0,0.0,0,2023-03-29T01:43,0,199000
777,2063237,58,55200,69000,94.0,152,2023-03-29T01:43,0,55200
778,2448900,59,39490,43900,96.0,86,2023-03-29T01:43,0,39490
779,3142900,60,94050,99000,0.0,0,2023-03-29T01:43,0,94050
780,3066304,61,89000,0,97.0,7,2023-03-29T01:43,-4450,84550
781,3070525,62,148000,0,100.0,2,2023-03-29T01:43,-7400,140600
782,2944520,63,192000,320000,0.0,0,2023-03-29T01:43,0,192000
783,2739414,64,118000,0,88.0,9,2023-03-29T01:43,0,118000
784,1645760,65,39390,43900,96.0,332,2023-03-29T01:43,0,39390
785,2725422,66,36900,0,98.0,65,2023-03-29T01:43,0,36900
786,2830762,67,139000,0,99.0,44,2023-03-29T01:43,-6950,132050
787,2462456,68,186000,0,0.0,0,2023-03-29T01:43,0,186000
788,3170471,69,139000,0,0.0,0,2023-03-29T01:43,0,139000
789,2864423,70,69300,99000,73.0,3,2023-03-29T01:43,0,69300
790,2643770,71,138000,0,98.0,18,2023-03-29T01:43,-20700,117300
791,3159167,72,162000,0,0.0,0,2023-03-29T01:43,0,162000
792,3071050,73,93100,98000,100.0,2,2023-03-29T01:43,0,93100
793,3126113,74,63200,79000,40.0,1,2023-03-29T01:43,0,63200
794,2967094,75,93000,0,96.0,20,2023-03-29T01:43,-4650,88350
795,2387232,76,195000,0,0.0,0,2023-03-29T01:43,0,195000
796,3081768,77,169000,0,100.0,1,2023-03-29T01:43,0,169000
797,3066960,78,73500,98000,100.0,5,2023-03-29T01:43,-3675,69825
798,3126630,79,159000,0,0.0,0,2023-03-29T01:43,0,159000
799,2478664,80,45500,65000,96.0,34,2023-03-29T01:43,0,45500
800,3081769,81,169000,0,0.0,0,2023-03-29T01:43,0,169000
801,2716675,82,39900,59000,96.0,159,2023-03-29T01:43,0,39900
802,2794289,83,158000,0,100.0,2,2023-03-29T01:43,-23700,134300
803,2551408,84,37900,0,98.0,40,2023-03-29T01:43,0,37900
804,1324169,85,29900,0,95.0,1320,2023-03-29T01:43,0,29900
805,2551400,86,39900,0,93.0,129,2023-03-29T01:43,0,39900
806,3046322,87,83700,93000,80.0,3,2023-03-29T01:43,-8370,75330
807,3034045,88,148000,0,0.0,0,2023-03-29T01:43,-7400,140600
808,3040745,89,88000,110000,93.0,13,2023-03-29T01:43,-4400,83600
809,1618698,90,51200,64000,95.0,622,2023-03-29T01:43,-2560,48640
810,991339,1,17890,19900,97.0,52234,2023-03-29T01:43,0,17890
811,1986031,2,24990,27900,97.0,10353,2023-03-29T01:43,0,24990
812,998051,3,12900,24000,97.0,161251,2023-03-29T01:43,0,12900
813,1443937,4,12900,24000,97.0,7653,2023-03-29T01:43,0,12900
814,1094748,5,19900,0,97.0,18955,2023-03-29T01:43,0,19900
815,991340,6,17890,19900,97.0,30619,2023-03-29T01:43,0,17890
816,763821,7,13900,22000,96.0,31225,2023-03-29T01:43,0,13900
817,1477845,8,15400,22000,96.0,9489,2023-03-29T01:43,0,15400
818,1094835,9,14290,15900,97.0,6141,2023-03-29T01:43,0,14290
819,1996705,10,23690,27900,98.0,2655,2023-03-29T01:43,0,23690
820,1986029,11,27900,0,98.0,3878,2023-03-29T01:43,0,27900
821,792919,12,15190,16900,96.0,17875,2023-03-29T01:43,0,15190
822,1986030,13,23690,27900,97.0,1638,2023-03-29T01:43,0,23690
823,991341,14,16890,19900,96.0,10147,2023-03-29T01:43,0,16890
824,991570,15,12900,20000,97.0,18949,2023-03-29T01:43,0,12900
825,2297277,16,19900,22000,96.0,253,2023-03-29T01:43,0,19900
826,734085,17,10900,19800,96.0,64429,2023-03-29T01:43,0,10900
827,2845854,18,14900,18900,97.0,184,2023-03-29T01:43,0,14900
828,1996702,19,23690,27900,97.0,1900,2023-03-29T01:43,0,23690
829,1821485,20,30000,0,96.0,1237,2023-03-29T01:43,0,30000
830,746158,21,22900,0,96.0,20474,2023-03-29T01:43,0,22900
831,1342874,22,16900,33000,97.0,12580,2023-03-29T01:43,0,16900
832,1729576,23,9500,13900,97.0,15848,2023-03-29T01:43,0,9500
833,2959925,24,22000,27500,98.0,73,2023-03-29T01:43,0,22000
834,2832613,25,11200,33000,97.0,589,2023-03-29T01:43,0,11200
835,479245,26,15400,22000,93.0,5354,2023-03-29T01:43,0,15400
836,746159,27,20590,22900,95.0,28683,2023-03-29T01:43,0,20590
837,1974077,28,42090,46900,97.0,885,2023-03-29T01:43,0,42090
838,1346009,29,9900,12000,97.0,6641,2023-03-29T01:43,0,9900
839,2960555,30,19000,0,93.0,86,2023-03-29T01:43,0,19000
840,1821487,31,30000,0,97.0,669,2023-03-29T01:43,0,30000
841,2011852,32,21490,23900,97.0,1298,2023-03-29T01:43,0,21490
842,792920,33,15190,16900,96.0,9646,2023-03-29T01:43,0,15190
843,1094834,34,21490,23900,96.0,2439,2023-03-29T01:43,0,21490
844,1094750,35,16890,19900,97.0,3532,2023-03-29T01:43,0,16890
845,2821588,36,19690,21900,97.0,44,2023-03-29T01:43,0,19690
846,1647682,37,14900,23600,97.0,937,2023-03-29T01:43,0,14900
847,746161,38,20590,22900,95.0,7724,2023-03-29T01:43,0,20590
848,2477852,39,17890,19900,98.0,669,2023-03-29T01:43,0,17890
849,1094749,40,19900,0,96.0,4926,2023-03-29T01:43,0,19900
850,2821598,41,19390,22900,97.0,133,2023-03-29T01:43,0,19390
851,2973894,42,22000,27500,98.0,19,2023-03-29T01:43,0,22000
852,2821589,43,19690,21900,96.0,28,2023-03-29T01:43,0,19690
853,1777081,44,8000,12800,96.0,1118,2023-03-29T01:43,0,8000
854,792921,45,15190,16900,95.0,7805,2023-03-29T01:43,0,15190
855,3009680,46,12590,14900,98.0,89,2023-03-29T01:43,0,12590
856,3125336,47,56000,0,0.0,0,2023-03-29T01:43,0,56000
857,752821,48,9900,0,94.0,23687,2023-03-29T01:43,0,9900
858,1477846,49,15400,22000,96.0,2645,2023-03-29T01:43,0,15400
859,2649999,50,12800,16000,94.0,71,2023-03-29T01:43,0,12800
860,1821480,51,30000,0,98.0,227,2023-03-29T01:43,0,30000
861,2835702,52,13900,15800,96.0,46,2023-03-29T01:43,0,13900
862,1286366,53,11900,24000,97.0,9776,2023-03-29T01:43,0,11900
863,1475055,54,16200,22000,96.0,1163,2023-03-29T01:43,0,16200
864,1296443,55,16900,23800,97.0,919,2023-03-29T01:43,0,16900
865,1556774,56,15200,16000,96.0,465,2023-03-29T01:43,0,15200
866,1260384,57,19900,0,95.0,1792,2023-03-29T01:43,0,19900
867,3066803,58,30400,38000,100.0,5,2023-03-29T01:43,0,30400
868,1996704,59,22290,27900,97.0,691,2023-03-29T01:43,0,22290
869,1556773,60,15200,16000,96.0,674,2023-03-29T01:43,0,15200
870,2376087,61,17100,18000,96.0,343,2023-03-29T01:43,0,17100
871,472686,62,9500,14800,94.0,700,2023-03-29T01:43,0,9500
872,2959926,63,14850,16500,98.0,112,2023-03-29T01:43,0,14850
873,2738095,64,19900,0,96.0,99,2023-03-29T01:43,0,19900
874,2377936,65,25000,0,97.0,272,2023-03-29T01:43,-3750,21250
875,1222903,66,30400,32000,97.0,519,2023-03-29T01:43,0,30400
876,2971853,67,19000,0,94.0,38,2023-03-29T01:43,0,19000
877,2929635,68,15900,27000,97.0,480,2023-03-29T01:43,0,15900
878,1348077,69,10900,16500,97.0,1842,2023-03-29T01:43,0,10900
879,924947,70,14900,19800,96.0,3589,2023-03-29T01:43,0,14900
880,2122868,71,9500,13900,97.0,3799,2023-03-29T01:43,0,9500
881,1358721,72,14200,22000,96.0,1085,2023-03-29T01:43,0,14200
882,1556775,73,15200,16000,97.0,347,2023-03-29T01:43,0,15200
883,1260388,74,20900,0,96.0,660,2023-03-29T01:43,0,20900
884,2509300,75,19900,0,96.0,386,2023-03-29T01:43,0,19900
885,2821595,76,19890,24900,96.0,50,2023-03-29T01:43,0,19890
886,1360044,77,19900,0,97.0,1752,2023-03-29T01:43,0,19900
887,2477851,78,19900,0,98.0,630,2023-03-29T01:43,0,19900
888,2293399,79,19900,22000,95.0,612,2023-03-29T01:43,0,19900
889,3047676,80,14250,15000,95.0,18,2023-03-29T01:43,0,14250
890,1094836,81,14290,15900,97.0,1299,2023-03-29T01:43,0,14290
891,2657366,82,9500,12000,96.0,278,2023-03-29T01:43,0,9500
892,2347097,83,14900,24000,98.0,1514,2023-03-29T01:43,0,14900
893,1260383,84,19900,0,95.0,1449,2023-03-29T01:43,0,19900
894,2771251,85,24650,29000,96.0,79,2023-03-29T01:43,0,24650
895,2346958,86,18200,24000,98.0,503,2023-03-29T01:43,0,18200
896,2003714,87,15200,22000,97.0,421,2023-03-29T01:43,0,15200
897,1274401,88,16900,22800,96.0,299,2023-03-29T01:43,0,16900
898,2821592,89,15590,20900,98.0,136,2023-03-29T01:43,0,15590
899,2829802,90,14900,18900,97.0,21,2023-03-29T01:43,0,14900
