,item_id,rank,price,del_price,rating,rating_count,time,coupon,real_price
0,3183263,1,42000,0,0.0,0,2023-04-19T22:15,-2100,39900
1,2272830,2,35910,39900,97.0,20279,2023-04-19T22:15,-5387,30523
2,3208410,3,59900,68000,95.0,27,2023-04-19T22:15,-8985,50915
3,3183260,4,42000,0,0.0,0,2023-04-19T22:15,-2100,39900
4,1848166,5,44100,49000,97.0,41416,2023-04-19T22:15,-4410,39690
5,3174572,6,59900,82900,0.0,0,2023-04-19T22:15,-5990,53910
6,345889,7,29900,47900,95.0,10230,2023-04-19T22:15,0,29900
7,1763157,8,49400,52000,95.0,2804,2023-04-19T22:15,0,49400
8,2456003,9,54900,82900,95.0,2287,2023-04-19T22:15,-5490,49410
9,2479911,10,49400,76000,97.0,4500,2023-04-19T22:15,0,49400
10,2086653,11,16900,0,97.0,40490,2023-04-19T22:15,0,16900
11,2442409,12,39000,78000,96.0,9208,2023-04-19T22:15,-5850,33150
12,2646350,13,59800,94000,95.0,4776,2023-04-19T22:15,-5980,53820
13,3183124,14,37800,42000,0.0,0,2023-04-19T22:15,-1890,35910
14,1921901,15,36900,70500,96.0,7697,2023-04-19T22:15,0,36900
15,1779737,16,20800,32000,96.0,7401,2023-04-19T22:15,0,20800
16,3174960,17,69900,87900,0.0,0,2023-04-19T22:15,-6990,62910
17,1944612,18,35800,59700,97.0,3029,2023-04-19T22:15,0,35800
18,2149254,19,37800,0,97.0,34239,2023-04-19T22:15,-5670,32130
19,1884943,20,29900,39000,96.0,19042,2023-04-19T22:15,-4485,25415
20,2015684,21,39000,0,95.0,6512,2023-04-19T22:15,0,39000
21,2375962,22,59000,62000,98.0,5731,2023-04-19T22:15,0,59000
22,3105468,23,79000,0,98.0,100,2023-04-19T22:15,-11850,67150
23,3187851,24,49900,110000,97.0,304,2023-04-19T22:15,0,49900
24,1939099,25,29400,49000,97.0,12025,2023-04-19T22:15,0,29400
25,1882578,26,35910,39900,97.0,10504,2023-04-19T22:15,0,35910
26,2285512,27,49400,52000,96.0,1791,2023-04-19T22:15,0,49400
27,1763123,28,84550,89000,96.0,1688,2023-04-19T22:15,0,84550
28,2034137,29,31800,0,97.0,17932,2023-04-19T22:15,-4770,27030
29,2485790,30,65900,105000,94.0,83,2023-04-19T22:15,-9885,56015
30,1706633,31,199000,0,97.0,2460,2023-04-19T22:15,0,199000
31,3219911,32,69900,118000,97.0,23,2023-04-19T22:15,0,69900
32,3183137,33,37800,42000,0.0,0,2023-04-19T22:15,-1890,35910
33,2364807,34,219000,0,96.0,734,2023-04-19T22:15,0,219000
34,2032983,35,89250,119000,98.0,1464,2023-04-19T22:15,0,89250
35,3084493,36,34000,0,98.0,72,2023-04-19T22:15,-3400,30600
36,3176118,37,65550,69000,97.0,48,2023-04-19T22:15,-9833,55717
37,2305840,38,56715,59700,97.0,4081,2023-04-19T22:15,-2836,53879
38,1498105,39,189000,0,97.0,2053,2023-04-19T22:15,0,189000
39,2518501,40,69900,116000,98.0,15,2023-04-19T22:15,-10485,59415
40,2401885,41,35900,59000,96.0,3581,2023-04-19T22:15,-3590,32310
41,2453556,42,39900,42000,97.0,6362,2023-04-19T22:15,0,39900
42,1503352,43,39900,42000,97.0,8536,2023-04-19T22:15,0,39900
43,2326935,44,47400,79000,96.0,13099,2023-04-19T22:15,-9480,37920
44,2454238,45,97200,108000,97.0,1630,2023-04-19T22:15,-14580,82620
45,3094141,46,83000,98000,96.0,96,2023-04-19T22:15,-16600,66400
46,2575342,47,39900,59000,96.0,927,2023-04-19T22:15,0,39900
47,1899755,48,29900,39000,96.0,5062,2023-04-19T22:15,-4485,25415
48,2032985,49,89250,119000,97.0,1856,2023-04-19T22:15,0,89250
49,2313388,50,68000,85000,96.0,2244,2023-04-19T22:15,0,68000
50,3064420,51,61500,69000,97.0,110,2023-04-19T22:15,0,61500
51,2870838,52,97300,139000,97.0,475,2023-04-19T22:15,0,97300
52,3183119,53,37800,42000,0.0,0,2023-04-19T22:15,-1890,35910
53,2445771,54,56715,59700,97.0,939,2023-04-19T22:15,-2836,53879
54,2457846,55,54900,82900,95.0,1489,2023-04-19T22:15,-5490,49410
55,2398380,56,31500,45000,96.0,1693,2023-04-19T22:15,-3150,28350
56,3174658,57,35900,39000,0.0,0,2023-04-19T22:15,-3590,32310
57,994588,58,39900,53000,93.0,6150,2023-04-19T22:15,0,39900
58,1582356,59,49200,82000,96.0,16371,2023-04-19T22:15,0,49200
59,3182330,60,88200,98000,0.0,0,2023-04-19T22:15,-4410,83790
60,1336398,61,40200,67000,96.0,19178,2023-04-19T22:15,-6030,34170
61,2377269,62,45000,0,97.0,4200,2023-04-19T22:15,0,45000
62,2851485,63,62000,68900,96.0,520,2023-04-19T22:15,-9300,52700
63,1793989,64,199000,0,97.0,950,2023-04-19T22:15,0,199000
64,1608272,65,39800,65590,96.0,4189,2023-04-19T22:15,0,39800
65,3042516,66,42000,65000,97.0,159,2023-04-19T22:15,0,42000
66,2485748,67,65900,105000,96.0,38,2023-04-19T22:15,-9885,56015
67,3034895,68,101150,119000,98.0,436,2023-04-19T22:15,0,101150
68,2456000,69,54900,82900,95.0,591,2023-04-19T22:15,-5490,49410
69,1557508,70,20700,69000,96.0,15208,2023-04-19T22:15,0,20700
70,854337,71,30490,33900,95.0,17511,2023-04-19T22:15,0,30490
71,996177,72,15900,0,95.0,77930,2023-04-19T22:15,0,15900
72,2314616,73,34900,43000,97.0,8476,2023-04-19T22:15,-5235,29665
73,2305852,74,56715,59700,97.0,1216,2023-04-19T22:15,-2836,53879
74,2065703,75,59000,62000,98.0,5722,2023-04-19T22:15,0,59000
75,1817394,76,59900,150000,93.0,7361,2023-04-19T22:15,0,59900
76,2700023,77,41400,69000,96.0,127,2023-04-19T22:15,0,41400
77,1498103,78,199000,0,96.0,900,2023-04-19T22:15,0,199000
78,1201416,79,119000,0,95.0,786,2023-04-19T22:15,0,119000
79,2708999,80,49800,62500,96.0,692,2023-04-19T22:15,-4980,44820
80,2462040,81,40500,45000,95.0,4002,2023-04-19T22:15,-6075,34425
81,3203720,82,40500,45000,100.0,26,2023-04-19T22:15,-8100,32400
82,2996536,83,39900,59000,96.0,732,2023-04-19T22:15,0,39900
83,3143791,84,45900,68000,98.0,579,2023-04-19T22:15,-9180,36720
84,3118792,85,45600,48000,99.0,200,2023-04-19T22:15,0,45600
85,2612829,86,44900,67900,97.0,1888,2023-04-19T22:15,-4490,40410
86,2445720,87,56715,59700,97.0,806,2023-04-19T22:15,-2836,53879
87,3032250,88,44800,64000,96.0,1030,2023-04-19T22:15,-6720,38080
88,3010415,89,219000,0,98.0,64,2023-04-19T22:15,0,219000
89,2485778,90,65900,105000,97.0,133,2023-04-19T22:15,-9885,56015
90,2723218,1,69900,109000,97.0,2766,2023-04-19T22:15,-10485,59415
91,1558197,2,69590,81900,97.0,32868,2023-04-19T22:15,0,69590
92,3037473,3,69900,85900,96.0,315,2023-04-19T22:15,-10485,59415
93,1778404,4,39000,45000,96.0,68027,2023-04-19T22:15,-5850,33150
94,2020732,5,56900,89000,95.0,922,2023-04-19T22:15,0,56900
95,2329532,6,119200,149000,97.0,4075,2023-04-19T22:15,-11920,107280
96,3037477,7,69900,109000,97.0,285,2023-04-19T22:15,-10485,59415
97,2723216,8,69900,109000,97.0,1195,2023-04-19T22:15,-10485,59415
98,2343198,9,116000,129000,97.0,5208,2023-04-19T22:15,-23200,92800
99,2061715,10,79900,105000,97.0,2816,2023-04-19T22:15,0,79900
100,3012082,11,59900,79000,96.0,1175,2023-04-19T22:15,-5990,53910
101,1856181,12,35910,39900,97.0,8044,2023-04-19T22:15,-5387,30523
102,1571879,13,79900,112900,96.0,7221,2023-04-19T22:15,0,79900
103,3010527,14,237150,279000,97.0,263,2023-04-19T22:15,0,237150
104,1790383,15,54700,86000,95.0,5801,2023-04-19T22:15,-8205,46495
105,2732486,16,99000,179000,98.0,797,2023-04-19T22:15,-9900,89100
106,1283757,17,71290,83900,96.0,26858,2023-04-19T22:15,0,71290
107,1576700,18,89000,129000,97.0,17063,2023-04-19T22:15,-13350,75650
108,3037472,19,69900,85900,97.0,214,2023-04-19T22:15,-10485,59415
109,1776552,20,59000,69000,94.0,6237,2023-04-19T22:15,-8850,50150
110,2471405,21,89000,138000,97.0,2188,2023-04-19T22:15,-8900,80100
111,1778408,22,39000,45000,95.0,11895,2023-04-19T22:15,-5850,33150
112,1530517,23,69900,79000,96.0,2195,2023-04-19T22:15,0,69900
113,1139192,24,66400,94900,97.0,14502,2023-04-19T22:15,-9960,56440
114,1108007,25,67890,79900,95.0,47983,2023-04-19T22:15,0,67890
115,2064545,26,74900,94000,97.0,11365,2023-04-19T22:15,-3745,71155
116,3033224,27,59900,74000,97.0,811,2023-04-19T22:15,-5990,53910
117,1620285,28,299000,0,97.0,181,2023-04-19T22:15,0,299000
118,2381781,29,186750,249000,98.0,870,2023-04-19T22:15,0,186750
119,2663635,30,67890,169900,97.0,691,2023-04-19T22:15,0,67890
120,1576682,31,228050,339000,97.0,8668,2023-04-19T22:15,-34208,193842
121,3100493,32,139000,0,97.0,63,2023-04-19T22:15,0,139000
122,2723219,33,69900,109000,96.0,268,2023-04-19T22:15,-10485,59415
123,3037471,34,69900,85900,97.0,74,2023-04-19T22:15,-10485,59415
124,1558683,35,69590,81900,97.0,6305,2023-04-19T22:15,0,69590
125,2403367,36,138700,146000,97.0,680,2023-04-19T22:15,-27740,110960
126,3037470,37,49900,68500,97.0,62,2023-04-19T22:15,-7485,42415
127,1195307,38,87550,103000,96.0,12756,2023-04-19T22:15,-13133,74417
128,2288704,39,119000,132000,97.0,3531,2023-04-19T22:15,-23800,95200
129,1776365,40,53400,89000,96.0,4669,2023-04-19T22:15,-8010,45390
130,1530516,41,69900,79000,96.0,2450,2023-04-19T22:15,0,69900
131,1618312,42,83900,0,97.0,7251,2023-04-19T22:15,-8390,75510
132,3020263,43,2604000,0,0.0,0,2023-04-19T22:15,-20000,2584000
133,2723217,44,69900,109000,97.0,334,2023-04-19T22:15,-10485,59415
134,2053138,45,135000,159000,97.0,697,2023-04-19T22:15,-27000,108000
135,2683549,46,111750,149000,97.0,2624,2023-04-19T22:15,0,111750
136,3157691,47,188100,209000,100.0,6,2023-04-19T22:15,0,188100
137,2159724,48,29900,32000,95.0,2422,2023-04-19T22:15,0,29900
138,2572705,49,168300,198000,96.0,69,2023-04-19T22:15,-25245,143055
139,3046899,50,79900,105000,97.0,141,2023-04-19T22:15,0,79900
140,1760178,51,139200,174000,96.0,233,2023-04-19T22:15,-20880,118320
141,1291017,52,67900,96000,95.0,13152,2023-04-19T22:15,0,67900
142,3037468,53,49900,68500,97.0,88,2023-04-19T22:15,-7485,42415
143,2343199,54,116000,129000,98.0,1894,2023-04-19T22:15,-23200,92800
144,3033083,55,69900,109000,97.0,65,2023-04-19T22:15,0,69900
145,3055246,56,159000,0,97.0,83,2023-04-19T22:15,0,159000
146,3047197,57,98100,109000,97.0,62,2023-04-19T22:15,-19620,78480
147,2752332,58,84200,105300,95.0,2683,2023-04-19T22:15,-12630,71570
148,3037469,59,49900,68500,97.0,62,2023-04-19T22:15,-7485,42415
149,2712632,60,107000,0,97.0,1392,2023-04-19T22:15,0,107000
150,3054935,61,80890,89900,97.0,81,2023-04-19T22:15,0,80890
151,2375909,62,76390,89900,98.0,1625,2023-04-19T22:15,0,76390
152,3079071,63,64900,87000,93.0,230,2023-04-19T22:15,-6490,58410
153,2718413,64,134100,149000,97.0,1481,2023-04-19T22:15,0,134100
154,2715055,65,159000,189000,97.0,2050,2023-04-19T22:15,0,159000
155,3092776,66,139900,0,0.0,0,2023-04-19T22:15,-20985,118915
156,2123924,67,247000,309000,98.0,922,2023-04-19T22:15,-49400,197600
157,1760177,68,139200,174000,97.0,398,2023-04-19T22:15,-20880,118320
158,2788216,69,143000,159000,98.0,169,2023-04-19T22:15,-28600,114400
159,1567183,70,71175,94900,97.0,7517,2023-04-19T22:15,-10677,60498
160,1737051,71,62300,89000,96.0,5174,2023-04-19T22:15,0,62300
161,3030665,72,139200,174000,95.0,283,2023-04-19T22:15,-20880,118320
162,3043283,73,359000,0,90.0,8,2023-04-19T22:15,0,359000
163,1337094,74,69900,0,95.0,5501,2023-04-19T22:15,0,69900
164,2293391,75,98000,124000,96.0,1893,2023-04-19T22:15,-4900,93100
165,1571878,76,79900,112900,96.0,4791,2023-04-19T22:15,0,79900
166,3096451,77,124200,138000,97.0,74,2023-04-19T22:15,-18630,105570
167,3167989,78,119000,0,96.0,11,2023-04-19T22:15,0,119000
168,3025211,79,44900,69000,97.0,287,2023-04-19T22:15,-2245,42655
169,3125676,80,178200,198000,100.0,6,2023-04-19T22:15,0,178200
170,3209864,81,89000,111500,97.0,9,2023-04-19T22:15,-4450,84550
171,1969617,82,162000,0,96.0,2703,2023-04-19T22:15,0,162000
172,3094151,83,174800,184000,96.0,121,2023-04-19T22:15,-34960,139840
173,709188,84,156700,209000,96.0,4219,2023-04-19T22:15,-23505,133195
174,1776550,85,59000,69000,94.0,4194,2023-04-19T22:15,-8850,50150
175,2287431,86,69600,87000,96.0,2015,2023-04-19T22:15,0,69600
176,2322836,87,139200,174000,97.0,1064,2023-04-19T22:15,-20880,118320
177,1593755,88,89300,111700,97.0,14536,2023-04-19T22:15,-13395,75905
178,2357957,89,111750,149000,97.0,2237,2023-04-19T22:15,0,111750
179,3062868,90,221000,260000,98.0,33,2023-04-19T22:15,-33150,187850
180,1573215,1,111000,148000,98.0,9456,2023-04-19T22:15,-16650,94350
181,1551840,2,35100,39000,97.0,84568,2023-04-19T22:15,0,35100
182,2112059,3,36400,52000,97.0,43886,2023-04-19T22:15,-5460,30940
183,1149329,4,39900,0,96.0,86765,2023-04-19T22:15,0,39900
184,750908,5,34900,54000,96.0,84762,2023-04-19T22:15,0,34900
185,3220911,6,89000,129000,97.0,45,2023-04-19T22:15,0,89000
186,1168906,7,35590,41900,97.0,71692,2023-04-19T22:15,0,35590
187,3037465,8,45500,56900,95.0,331,2023-04-19T22:15,-6825,38675
188,2358429,9,119250,159000,98.0,2689,2023-04-19T22:15,0,119250
189,2060719,10,55200,69000,96.0,5477,2023-04-19T22:15,-5520,49680
190,2060717,11,55200,69000,95.0,4018,2023-04-19T22:15,-5520,49680
191,2092852,12,42000,52800,96.0,11514,2023-04-19T22:15,-4200,37800
192,2107114,13,98500,135000,98.0,2612,2023-04-19T22:15,-14775,83725
193,2107115,14,98500,135000,98.0,11779,2023-04-19T22:15,-14775,83725
194,2112061,15,36400,52000,97.0,15115,2023-04-19T22:15,-5460,30940
195,2060720,16,55200,69000,96.0,2684,2023-04-19T22:15,-5520,49680
196,1370101,17,39000,89000,96.0,23440,2023-04-19T22:15,-1950,37050
197,1149328,18,35890,39900,96.0,94836,2023-04-19T22:15,0,35890
198,1926048,19,32000,0,97.0,15006,2023-04-19T22:15,0,32000
199,2192777,20,104250,139000,97.0,2309,2023-04-19T22:15,-15638,88612
200,1924274,21,49900,66000,95.0,22743,2023-04-19T22:15,0,49900
201,1552753,22,70200,78000,97.0,28349,2023-04-19T22:15,-10530,59670
202,2381406,23,103500,138000,98.0,2326,2023-04-19T22:15,-15525,87975
203,2569078,24,59250,79000,96.0,2504,2023-04-19T22:15,0,59250
204,1551839,25,39000,0,97.0,23972,2023-04-19T22:15,0,39000
205,2028327,26,42390,49900,97.0,9373,2023-04-19T22:15,0,42390
206,858911,27,39000,49000,95.0,67289,2023-04-19T22:15,-5850,33150
207,3155551,28,65400,109000,91.0,7,2023-04-19T22:15,-3270,62130
208,1568057,29,49600,62000,96.0,22709,2023-04-19T22:15,-7440,42160
209,3037464,30,45500,56900,97.0,145,2023-04-19T22:15,-6825,38675
210,3220907,31,99000,149000,98.0,18,2023-04-19T22:15,0,99000
211,1323090,32,64400,92000,96.0,6095,2023-04-19T22:15,-12880,51520
212,1627892,33,43900,0,97.0,11369,2023-04-19T22:15,0,43900
213,2084435,34,98000,109000,97.0,1362,2023-04-19T22:15,-19600,78400
214,2789091,35,79200,99000,97.0,960,2023-04-19T22:15,-11880,67320
215,2261213,36,98550,135000,98.0,4169,2023-04-19T22:15,-14783,83767
216,3044076,37,80100,89000,97.0,68,2023-04-19T22:15,-12015,68085
217,2281982,38,87120,99000,98.0,538,2023-04-19T22:15,-17424,69696
218,3043508,39,71200,89000,97.0,240,2023-04-19T22:15,0,71200
219,2028326,40,49900,0,97.0,6407,2023-04-19T22:15,0,49900
220,1222184,41,37690,41900,97.0,48690,2023-04-19T22:15,0,37690
221,2060759,42,59800,74800,97.0,7402,2023-04-19T22:15,-5980,53820
222,2789111,43,79200,99000,97.0,1003,2023-04-19T22:15,-11880,67320
223,2569079,44,59250,79000,96.0,1160,2023-04-19T22:15,0,59250
224,2952100,45,107250,143000,96.0,378,2023-04-19T22:15,-16088,91162
225,1736085,46,39900,59800,96.0,37294,2023-04-19T22:15,0,39900
226,2833222,47,103500,138000,98.0,504,2023-04-19T22:15,-15525,87975
227,2495075,48,49800,72000,95.0,12173,2023-04-19T22:15,-4980,44820
228,1436504,49,41900,0,95.0,9297,2023-04-19T22:15,0,41900
229,2060743,50,33000,55000,95.0,3694,2023-04-19T22:15,-3300,29700
230,1555407,51,70200,78000,97.0,11757,2023-04-19T22:15,-10530,59670
231,3141395,52,49900,73900,97.0,230,2023-04-19T22:15,-4990,44910
232,890521,53,39800,63000,94.0,11351,2023-04-19T22:15,0,39800
233,2562527,54,29400,42000,97.0,4233,2023-04-19T22:15,-4410,24990
234,1985223,55,39000,89000,96.0,1734,2023-04-19T22:15,-1950,37050
235,1350363,56,53600,68000,97.0,1245,2023-04-19T22:15,0,53600
236,2124896,57,98000,0,98.0,769,2023-04-19T22:15,-14700,83300
237,3070909,58,139000,0,98.0,21,2023-04-19T22:15,-27800,111200
238,1246215,59,49000,65000,96.0,6413,2023-04-19T22:15,-9800,39200
239,1595607,60,57900,89000,97.0,5822,2023-04-19T22:15,-8685,49215
240,1436218,61,39900,68000,95.0,19580,2023-04-19T22:15,-3990,35910
241,3134710,62,79900,0,100.0,3,2023-04-19T22:15,-11985,67915
242,1224095,63,35890,39900,97.0,24638,2023-04-19T22:15,0,35890
243,2351467,64,39800,54000,96.0,6647,2023-04-19T22:15,-5970,33830
244,1477272,65,44200,68000,96.0,18041,2023-04-19T22:15,-2210,41990
245,2725611,66,89600,128000,98.0,2238,2023-04-19T22:15,-13440,76160
246,2049103,67,70200,78000,97.0,7262,2023-04-19T22:15,-10530,59670
247,3051674,68,49900,0,95.0,18,2023-04-19T22:15,0,49900
248,2742472,69,121500,135000,99.0,88,2023-04-19T22:15,-18225,103275
249,2703599,70,95200,119000,97.0,68,2023-04-19T22:15,-19040,76160
250,2503133,71,42000,52800,96.0,3189,2023-04-19T22:15,-4200,37800
251,3134713,72,79900,0,100.0,7,2023-04-19T22:15,-11985,67915
252,1666442,73,44890,49900,97.0,11053,2023-04-19T22:15,0,44890
253,1440874,74,39900,0,95.0,15210,2023-04-19T22:15,0,39900
254,3022892,75,39000,49000,96.0,521,2023-04-19T22:15,-5850,33150
255,2032901,76,35890,39900,97.0,7025,2023-04-19T22:15,0,35890
256,2107112,77,104250,139000,98.0,1242,2023-04-19T22:15,-15638,88612
257,2578996,78,39900,59000,95.0,4776,2023-04-19T22:15,-5985,33915
258,1568032,79,49600,62000,96.0,6319,2023-04-19T22:15,-7440,42160
259,2587375,80,59800,92000,97.0,181,2023-04-19T22:15,0,59800
260,3059709,81,49500,52000,88.0,10,2023-04-19T22:15,0,49500
261,2383324,82,95400,159000,97.0,70,2023-04-19T22:15,-14310,81090
262,1212776,83,27090,31900,96.0,23644,2023-04-19T22:15,0,27090
263,1037219,84,83300,119000,95.0,29486,2023-04-19T22:15,-12495,70805
264,890519,85,39800,63000,95.0,7014,2023-04-19T22:15,0,39800
265,3134712,86,79900,0,100.0,2,2023-04-19T22:15,-11985,67915
266,2184087,87,47200,89000,96.0,4224,2023-04-19T22:15,-2360,44840
267,1885631,88,39000,49000,96.0,23871,2023-04-19T22:15,-5850,33150
268,2392464,89,28790,33900,94.0,3914,2023-04-19T22:15,0,28790
269,2978123,90,56900,0,98.0,17,2023-04-19T22:15,-5690,51210
270,1789507,1,71100,79000,98.0,26196,2023-04-19T22:15,0,71100
271,2702033,2,127200,159000,97.0,448,2023-04-19T22:15,0,127200
272,3034751,3,64800,72000,97.0,588,2023-04-19T22:15,0,64800
273,1969507,4,88000,0,98.0,5533,2023-04-19T22:15,0,88000
274,1034480,5,135000,150000,97.0,18274,2023-04-19T22:15,0,135000
275,2856863,6,1416000,2167000,100.0,1,2023-04-19T22:15,-20000,1396000
276,3050557,7,2027000,3290000,100.0,1,2023-04-19T22:15,-20000,2007000
277,2770508,8,138000,0,97.0,372,2023-04-19T22:15,0,138000
278,2654166,9,82000,108000,94.0,122,2023-04-19T22:15,-12300,69700
279,1835080,10,98000,0,97.0,2906,2023-04-19T22:15,0,98000
280,1264107,11,62000,90000,97.0,6491,2023-04-19T22:15,-9300,52700
281,2914920,12,369000,439000,100.0,6,2023-04-19T22:15,0,369000
282,2340790,13,2597000,3690000,90.0,4,2023-04-19T22:15,-20000,2577000
283,2245952,14,46000,69000,96.0,204,2023-04-19T22:15,0,46000
284,3034745,15,75600,84000,97.0,210,2023-04-19T22:15,0,75600
285,2235274,16,145000,0,98.0,756,2023-04-19T22:15,0,145000
286,3148371,17,2489000,2990000,0.0,0,2023-04-19T22:15,-20000,2469000
287,1744101,18,103500,109000,98.0,3012,2023-04-19T22:15,0,103500
288,1910358,19,89100,99000,98.0,2536,2023-04-19T22:15,-13365,75735
289,3206841,20,142200,158000,0.0,0,2023-04-19T22:15,-21330,120870
290,3029926,21,285000,0,99.0,68,2023-04-19T22:15,0,285000
291,2320927,22,39000,51000,97.0,2323,2023-04-19T22:15,0,39000
292,2271789,23,71100,79000,97.0,2595,2023-04-19T22:15,0,71100
293,2344540,24,96000,0,98.0,9401,2023-04-19T22:15,0,96000
294,1564343,25,92800,119000,98.0,8164,2023-04-19T22:15,-13920,78880
295,1969488,26,88000,0,98.0,1807,2023-04-19T22:15,0,88000
296,3101111,27,161100,179000,96.0,52,2023-04-19T22:15,0,161100
297,3164738,28,2053000,2400000,0.0,0,2023-04-19T22:15,-20000,2033000
298,3045076,29,54600,84000,97.0,116,2023-04-19T22:15,0,54600
299,2066837,30,69000,119000,97.0,6615,2023-04-19T22:15,-10350,58650
300,2343665,31,89000,0,97.0,4717,2023-04-19T22:15,0,89000
301,2558648,32,119000,0,98.0,1335,2023-04-19T22:15,0,119000
302,1581689,33,75600,89000,97.0,4068,2023-04-19T22:15,0,75600
303,3038000,34,74700,83000,96.0,473,2023-04-19T22:15,-11205,63495
304,2979849,35,1852000,2370000,100.0,6,2023-04-19T22:15,0,1852000
305,1842449,36,84000,99000,97.0,5506,2023-04-19T22:15,-16800,67200
306,913402,37,83300,98000,95.0,8100,2023-04-19T22:15,-16660,66640
307,2630526,38,100000,0,96.0,695,2023-04-19T22:15,0,100000
308,1576725,39,127150,197000,97.0,5264,2023-04-19T22:15,-19073,108077
309,1323612,40,238000,0,97.0,3856,2023-04-19T22:15,-11900,226100
310,1528287,41,46500,49000,96.0,4702,2023-04-19T22:15,0,46500
311,2555081,42,1557000,2600000,0.0,0,2023-04-19T22:15,-20000,1537000
312,1745100,43,103500,109000,97.0,1033,2023-04-19T22:15,0,103500
313,2810073,44,1624000,2490000,100.0,3,2023-04-19T22:15,-20000,1604000
314,3158464,45,113050,119000,98.0,19,2023-04-19T22:15,-5653,107397
315,2814188,46,1616000,2350000,100.0,4,2023-04-19T22:15,-20000,1596000
316,2344538,47,119000,0,98.0,6532,2023-04-19T22:15,0,119000
317,342189,48,39500,52000,95.0,15858,2023-04-19T22:15,0,39500
318,1263004,49,159000,0,97.0,5274,2023-04-19T22:15,0,159000
319,2914916,50,369000,439000,95.0,8,2023-04-19T22:15,0,369000
320,3047568,51,109650,129000,96.0,99,2023-04-19T22:15,-10965,98685
321,3174246,52,298000,485000,0.0,0,2023-04-19T22:15,-20000,278000
322,3034749,53,64800,72000,97.0,526,2023-04-19T22:15,0,64800
323,2514819,54,54000,66000,97.0,902,2023-04-19T22:15,0,54000
324,2245910,55,46000,69000,95.0,796,2023-04-19T22:15,0,46000
325,3161264,56,98100,109000,98.0,85,2023-04-19T22:15,-19620,78480
326,2657250,57,125400,149000,98.0,143,2023-04-19T22:15,0,125400
327,693318,58,75000,110000,96.0,13253,2023-04-19T22:15,-11250,63750
328,2998775,59,142200,158000,96.0,544,2023-04-19T22:15,0,142200
329,2408317,60,145800,162000,96.0,415,2023-04-19T22:15,0,145800
330,2777025,61,308000,485000,100.0,58,2023-04-19T22:15,-20000,288000
331,3161263,62,98100,109000,100.0,40,2023-04-19T22:15,-19620,78480
332,1736022,63,169200,188000,96.0,462,2023-04-19T22:15,0,169200
333,2967335,64,1395000,2605000,88.0,7,2023-04-19T22:15,-20000,1375000
334,2635646,65,47000,0,98.0,306,2023-04-19T22:15,0,47000
335,3029905,66,395000,0,99.0,48,2023-04-19T22:15,0,395000
336,1447194,67,59900,230000,96.0,2926,2023-04-19T22:15,0,59900
337,2789785,68,140600,148000,97.0,695,2023-04-19T22:15,0,140600
338,2422175,69,145800,162000,98.0,231,2023-04-19T22:15,-21870,123930
339,2392115,70,78400,98000,96.0,394,2023-04-19T22:15,-11760,66640
340,2930265,71,91000,0,97.0,632,2023-04-19T22:15,0,91000
341,3011494,72,69900,79000,96.0,285,2023-04-19T22:15,-6990,62910
342,3042819,73,141550,149000,98.0,16,2023-04-19T22:15,-7078,134472
343,1090160,74,99000,0,97.0,1341,2023-04-19T22:15,0,99000
344,1758217,75,43900,56000,97.0,13228,2023-04-19T22:15,-2195,41705
345,1247560,76,71100,79000,96.0,4308,2023-04-19T22:15,0,71100
346,2421338,77,78400,98000,97.0,544,2023-04-19T22:15,-11760,66640
347,2757112,78,359000,0,93.0,103,2023-04-19T22:15,-53850,305150
348,1597319,79,89100,99000,97.0,626,2023-04-19T22:15,-4455,84645
349,2888946,80,79000,0,98.0,194,2023-04-19T22:15,0,79000
350,2984187,81,1090000,1560000,0.0,0,2023-04-19T22:15,-20000,1070000
351,2754080,82,88000,0,97.0,521,2023-04-19T22:15,0,88000
352,2229665,83,145350,153000,97.0,388,2023-04-19T22:15,-21803,123547
353,3149665,84,98000,0,96.0,20,2023-04-19T22:15,-14700,83300
354,3034743,85,75600,84000,96.0,244,2023-04-19T22:15,0,75600
355,2979861,86,1042000,1430000,100.0,7,2023-04-19T22:15,0,1042000
356,2040039,87,95200,119000,97.0,465,2023-04-19T22:15,-19040,76160
357,2279619,88,80100,89000,97.0,487,2023-04-19T22:15,0,80100
358,2688927,89,65600,82000,97.0,713,2023-04-19T22:15,-9840,55760
359,3070516,90,138000,0,97.0,40,2023-04-19T22:15,0,138000
360,1762407,1,260000,0,97.0,3452,2023-04-19T22:15,0,260000
361,969541,2,69000,0,97.0,30129,2023-04-19T22:15,0,69000
362,2737457,3,230000,0,98.0,491,2023-04-19T22:15,0,230000
363,1762406,4,260000,0,98.0,3480,2023-04-19T22:15,0,260000
364,2638067,5,99000,139000,97.0,3270,2023-04-19T22:15,0,99000
365,2545799,6,149000,0,98.0,2310,2023-04-19T22:15,0,149000
366,2233180,7,64900,109000,97.0,14389,2023-04-19T22:15,0,64900
367,810034,8,85500,95000,97.0,45420,2023-04-19T22:15,0,85500
368,1622068,9,119000,0,97.0,6830,2023-04-19T22:15,0,119000
369,186610,10,59900,85000,97.0,16712,2023-04-19T22:15,0,59900
370,2293400,11,129000,0,96.0,1074,2023-04-19T22:15,0,129000
371,311052,12,53100,59000,97.0,41433,2023-04-19T22:15,0,53100
372,3026310,13,99000,0,99.0,887,2023-04-19T22:15,0,99000
373,2785168,14,179000,0,98.0,62,2023-04-19T22:15,0,179000
374,2801305,15,369000,700000,99.0,203,2023-04-19T22:15,0,369000
375,2622254,16,109000,0,98.0,972,2023-04-19T22:15,0,109000
376,2565212,17,119000,0,99.0,451,2023-04-19T22:15,0,119000
377,1955217,18,69000,109000,96.0,5272,2023-04-19T22:15,-10350,58650
378,3033248,19,109000,0,97.0,703,2023-04-19T22:15,-10900,98100
379,577636,20,99900,139000,95.0,31316,2023-04-19T22:15,0,99900
380,3172975,21,260000,0,96.0,12,2023-04-19T22:15,0,260000
381,181907,22,79900,119000,97.0,7233,2023-04-19T22:15,0,79900
382,695334,23,78900,99000,96.0,9547,2023-04-19T22:15,0,78900
383,1296778,24,99000,0,98.0,2197,2023-04-19T22:15,0,99000
384,810033,25,89100,99000,97.0,34349,2023-04-19T22:15,0,89100
385,2233178,26,64900,109000,97.0,5044,2023-04-19T22:15,0,64900
386,1900410,27,129000,0,97.0,4960,2023-04-19T22:15,0,129000
387,2440110,28,56900,59900,97.0,1214,2023-04-19T22:15,-8535,48365
388,490136,29,76000,95000,98.0,2628,2023-04-19T22:15,0,76000
389,2741233,30,109000,0,97.0,2817,2023-04-19T22:15,-10900,98100
390,3091287,31,119000,0,98.0,378,2023-04-19T22:15,0,119000
391,2855992,32,159000,0,97.0,631,2023-04-19T22:15,0,159000
392,3200836,33,179000,0,97.0,54,2023-04-19T22:15,0,179000
393,1622069,34,119000,0,98.0,5964,2023-04-19T22:15,0,119000
394,1231944,35,119000,0,97.0,1409,2023-04-19T22:15,0,119000
395,2161992,36,69900,95000,97.0,3492,2023-04-19T22:15,0,69900
396,2469965,37,69900,149000,96.0,1126,2023-04-19T22:15,0,69900
397,816033,38,70900,89000,96.0,13437,2023-04-19T22:15,0,70900
398,2320478,39,129000,0,97.0,572,2023-04-19T22:15,0,129000
399,2909715,40,119000,0,97.0,117,2023-04-19T22:15,0,119000
400,2493214,41,169000,0,98.0,208,2023-04-19T22:15,0,169000
401,2673444,42,49900,149000,95.0,439,2023-04-19T22:15,0,49900
402,2809006,43,728000,1130000,99.0,35,2023-04-19T22:15,0,728000
403,3030422,44,117900,139000,96.0,922,2023-04-19T22:15,0,117900
404,1744960,45,79900,149000,97.0,8273,2023-04-19T22:15,0,79900
405,2981033,46,79900,199000,98.0,25,2023-04-19T22:15,0,79900
406,1900420,47,129000,0,96.0,1520,2023-04-19T22:15,0,129000
407,3079037,48,195000,0,98.0,318,2023-04-19T22:15,0,195000
408,102620,49,69000,0,97.0,18025,2023-04-19T22:15,0,69000
409,2631192,50,98100,109000,98.0,437,2023-04-19T22:15,0,98100
410,3167965,51,119000,0,96.0,6,2023-04-19T22:15,0,119000
411,3157671,52,89000,0,98.0,50,2023-04-19T22:15,-8900,80100
412,1354129,53,69000,99000,95.0,8759,2023-04-19T22:15,-10350,58650
413,2524840,54,139000,0,97.0,897,2023-04-19T22:15,0,139000
414,2778805,55,99000,0,97.0,1074,2023-04-19T22:15,0,99000
415,311050,56,53100,59000,97.0,9123,2023-04-19T22:15,0,53100
416,810032,57,85500,95000,97.0,13814,2023-04-19T22:15,0,85500
417,2312772,58,64900,139800,96.0,1445,2023-04-19T22:15,-9735,55165
418,1130307,59,109000,0,97.0,6091,2023-04-19T22:15,0,109000
419,1473136,60,119900,149000,97.0,10820,2023-04-19T22:15,0,119900
420,1478592,61,75900,95000,97.0,3127,2023-04-19T22:15,0,75900
421,490135,62,75900,95000,98.0,3442,2023-04-19T22:15,0,75900
422,3188621,63,119000,0,100.0,2,2023-04-19T22:15,0,119000
423,1493265,64,85500,95000,98.0,5004,2023-04-19T22:15,0,85500
424,1134374,65,170000,0,95.0,2108,2023-04-19T22:15,0,170000
425,2622252,66,109000,0,97.0,247,2023-04-19T22:15,0,109000
426,2909092,67,89000,0,96.0,397,2023-04-19T22:15,-8900,80100
427,2909716,68,119000,0,96.0,101,2023-04-19T22:15,0,119000
428,3096431,69,139000,0,98.0,71,2023-04-19T22:15,0,139000
429,2786813,70,149000,0,94.0,234,2023-04-19T22:15,0,149000
430,2731878,71,67900,79000,97.0,1899,2023-04-19T22:15,0,67900
431,1376278,72,59200,74000,95.0,1982,2023-04-19T22:15,-8880,50320
432,1522890,73,200000,0,97.0,31,2023-04-19T22:15,0,200000
433,1494180,74,71100,79000,95.0,5305,2023-04-19T22:15,0,71100
434,3122128,75,219000,0,97.0,32,2023-04-19T22:15,-43800,175200
435,1739446,76,109900,129000,97.0,838,2023-04-19T22:15,0,109900
436,1608838,77,85000,0,97.0,12690,2023-04-19T22:15,0,85000
437,3024528,78,132050,139000,96.0,115,2023-04-19T22:15,0,132050
438,716244,79,69900,95000,98.0,1363,2023-04-19T22:15,0,69900
439,3008384,80,59900,75000,98.0,152,2023-04-19T22:15,0,59900
440,1990244,81,129000,0,98.0,1152,2023-04-19T22:15,0,129000
441,2899664,82,69900,159000,96.0,135,2023-04-19T22:15,0,69900
442,2639221,83,99000,0,96.0,82,2023-04-19T22:15,0,99000
443,2819014,84,45900,79000,95.0,196,2023-04-19T22:15,0,45900
444,2861393,85,96900,139000,93.0,310,2023-04-19T22:15,0,96900
445,1594352,86,85000,0,97.0,5616,2023-04-19T22:15,0,85000
446,3122130,87,219000,0,100.0,6,2023-04-19T22:15,-65700,153300
447,1296776,88,99000,0,98.0,2983,2023-04-19T22:15,0,99000
448,3172974,89,260000,0,100.0,12,2023-04-19T22:15,0,260000
449,3023097,90,230000,0,98.0,124,2023-04-19T22:15,0,230000
450,1092992,1,69000,0,97.0,38320,2023-04-19T22:15,0,69000
451,3134606,2,125100,139000,97.0,36,2023-04-19T22:15,-6255,118845
452,3062046,3,78300,87000,97.0,228,2023-04-19T22:15,-3915,74385
453,3061996,4,88200,98000,98.0,160,2023-04-19T22:15,-4410,83790
454,3134621,5,136800,152000,96.0,24,2023-04-19T22:15,-6840,129960
455,3124961,6,62100,69000,97.0,262,2023-04-19T22:15,-3105,58995
456,1810760,7,135000,150000,96.0,179,2023-04-19T22:15,0,135000
457,1720822,8,209000,0,97.0,315,2023-04-19T22:15,0,209000
458,1568047,9,159000,0,95.0,12054,2023-04-19T22:15,-23850,135150
459,2910082,10,265500,295000,98.0,512,2023-04-19T22:15,0,265500
460,595039,11,210000,0,97.0,3553,2023-04-19T22:15,0,210000
461,1720813,12,149000,0,97.0,515,2023-04-19T22:15,0,149000
462,2091749,13,75650,89000,95.0,6348,2023-04-19T22:15,0,75650
463,2383245,14,99000,0,98.0,878,2023-04-19T22:15,0,99000
464,2433538,15,84660,102000,96.0,2473,2023-04-19T22:15,0,84660
465,3062069,16,71100,79000,97.0,88,2023-04-19T22:15,-3555,67545
466,1129750,17,69000,0,97.0,3977,2023-04-19T22:15,0,69000
467,595040,18,210000,0,95.0,8754,2023-04-19T22:15,0,210000
468,3223241,19,119000,0,100.0,7,2023-04-19T22:15,0,119000
469,2432733,20,44900,59000,97.0,2939,2023-04-19T22:15,0,44900
470,3134563,21,88200,98000,94.0,20,2023-04-19T22:15,-4410,83790
471,2101924,22,99900,0,97.0,1417,2023-04-19T22:15,0,99900
472,3161736,23,67900,158000,98.0,280,2023-04-19T22:15,-10185,57715
473,2816812,24,119900,0,93.0,1577,2023-04-19T22:15,0,119900
474,3075621,25,339000,0,98.0,99,2023-04-19T22:15,0,339000
475,1339622,26,42900,59000,97.0,16448,2023-04-19T22:15,0,42900
476,1334438,27,170000,0,96.0,4450,2023-04-19T22:15,0,170000
477,2237841,28,195000,0,98.0,68,2023-04-19T22:15,0,195000
478,1952910,29,265500,295000,98.0,1746,2023-04-19T22:15,0,265500
479,1890398,30,132000,168000,96.0,2772,2023-04-19T22:15,-13200,118800
480,1334440,31,102000,170000,96.0,2063,2023-04-19T22:15,0,102000
481,1439535,32,49000,0,96.0,16381,2023-04-19T22:15,0,49000
482,2902207,33,894000,1663000,0.0,0,2023-04-19T22:15,-20000,874000
483,3242240,34,159000,0,0.0,0,2023-04-19T22:15,0,159000
484,2814379,35,120000,200000,98.0,28,2023-04-19T22:15,0,120000
485,1730340,36,232200,258000,97.0,4267,2023-04-19T22:15,0,232200
486,2997860,37,1298000,1770000,0.0,0,2023-04-19T22:15,-20000,1278000
487,3124959,38,52200,58000,97.0,56,2023-04-19T22:15,-2610,49590
488,1815709,39,132000,168000,96.0,7174,2023-04-19T22:15,-13200,118800
489,451852,40,268000,0,96.0,379,2023-04-19T22:15,0,268000
490,1897197,41,53100,59000,96.0,987,2023-04-19T22:15,0,53100
491,636821,42,152000,169000,93.0,2589,2023-04-19T22:15,0,152000
492,1419869,43,70300,74000,95.0,10587,2023-04-19T22:15,-10545,59755
493,2363570,44,39900,55000,97.0,1136,2023-04-19T22:15,0,39900
494,2243103,45,114500,135000,97.0,57,2023-04-19T22:15,0,114500
495,1891202,46,165000,0,98.0,103,2023-04-19T22:15,0,165000
496,3049313,47,57100,64900,97.0,755,2023-04-19T22:15,0,57100
497,2910086,48,265500,295000,98.0,222,2023-04-19T22:15,0,265500
498,2036670,49,300000,0,97.0,777,2023-04-19T22:15,0,300000
499,1699941,50,67150,79000,97.0,4930,2023-04-19T22:15,-10073,57077
500,2664373,51,65000,0,97.0,1093,2023-04-19T22:15,0,65000
501,2624538,52,40900,59000,97.0,1579,2023-04-19T22:15,0,40900
502,607298,53,44700,59000,93.0,15614,2023-04-19T22:15,-6705,37995
503,665782,54,260000,0,95.0,3649,2023-04-19T22:15,0,260000
504,2378989,55,159000,0,95.0,46,2023-04-19T22:15,0,159000
505,2664372,56,65000,0,97.0,1126,2023-04-19T22:15,0,65000
506,1973858,57,125300,179000,98.0,1212,2023-04-19T22:15,-18795,106505
507,2816816,58,143890,159900,97.0,1893,2023-04-19T22:15,0,143890
508,1562990,59,230000,0,96.0,1289,2023-04-19T22:15,0,230000
509,2355318,60,98890,109900,96.0,666,2023-04-19T22:15,0,98890
510,1140457,61,50000,82000,95.0,911,2023-04-19T22:15,-7500,42500
511,1262092,62,250000,0,96.0,785,2023-04-19T22:15,0,250000
512,2143833,63,89640,108000,96.0,2459,2023-04-19T22:15,0,89640
513,1828166,64,126000,210000,94.0,855,2023-04-19T22:15,0,126000
514,1021359,65,61000,100000,94.0,5395,2023-04-19T22:15,-9150,51850
515,2440524,66,69000,0,97.0,1610,2023-04-19T22:15,0,69000
516,2957149,67,34900,59000,99.0,58,2023-04-19T22:15,0,34900
517,2114461,68,384900,428000,98.0,183,2023-04-19T22:15,0,384900
518,1439527,69,49000,0,95.0,13451,2023-04-19T22:15,0,49000
519,3142574,70,132300,189000,100.0,4,2023-04-19T22:15,0,132300
520,3223186,71,119000,0,100.0,3,2023-04-19T22:15,0,119000
521,2419871,72,44900,59000,97.0,966,2023-04-19T22:15,0,44900
522,3142573,73,132300,189000,100.0,1,2023-04-19T22:15,0,132300
523,685185,74,139000,198000,95.0,12514,2023-04-19T22:15,-20850,118150
524,3142598,75,146300,209000,100.0,2,2023-04-19T22:15,0,146300
525,2518112,76,87150,105000,96.0,997,2023-04-19T22:15,0,87150
526,3130687,77,152100,169000,100.0,1,2023-04-19T22:15,-22815,129285
527,3133873,78,169000,0,0.0,0,2023-04-19T22:15,0,169000
528,3018130,79,189000,210000,98.0,12,2023-04-19T22:15,0,189000
529,2434795,80,39900,59000,97.0,1553,2023-04-19T22:15,0,39900
530,2684749,81,207000,230000,97.0,41,2023-04-19T22:15,0,207000
531,3024585,82,59000,0,97.0,163,2023-04-19T22:15,-8850,50150
532,127121,83,141000,152000,95.0,1881,2023-04-19T22:15,-21150,119850
533,1754219,84,31200,39000,96.0,2304,2023-04-19T22:15,0,31200
534,2614276,85,69000,0,97.0,563,2023-04-19T22:15,0,69000
535,1438359,86,99000,0,97.0,1210,2023-04-19T22:15,0,99000
536,1891201,87,155000,0,98.0,222,2023-04-19T22:15,0,155000
537,2463768,88,49000,0,97.0,368,2023-04-19T22:15,0,49000
538,1928038,89,84600,94000,96.0,1193,2023-04-19T22:15,-12690,71910
539,2686298,90,645000,980000,0.0,0,2023-04-19T22:15,-20000,625000
540,2134140,1,39000,0,97.0,3662,2023-04-19T22:15,-5850,33150
541,2356713,2,39000,0,97.0,1522,2023-04-19T22:15,-5850,33150
542,1920929,3,39000,0,97.0,4061,2023-04-19T22:15,-5850,33150
543,2280117,4,35100,39000,97.0,6478,2023-04-19T22:15,0,35100
544,1822717,5,56050,59000,97.0,4369,2023-04-19T22:15,0,56050
545,1214164,6,36000,0,96.0,25072,2023-04-19T22:15,0,36000
546,2134158,7,39000,0,97.0,2567,2023-04-19T22:15,-5850,33150
547,2356711,8,39000,0,98.0,1529,2023-04-19T22:15,-5850,33150
548,2879419,9,48900,55000,98.0,823,2023-04-19T22:15,-7335,41565
549,1771137,10,27550,29000,97.0,12661,2023-04-19T22:15,0,27550
550,1272626,11,36000,0,96.0,14237,2023-04-19T22:15,0,36000
551,1214174,12,36000,0,97.0,15115,2023-04-19T22:15,0,36000
552,3051146,13,34000,0,91.0,46,2023-04-19T22:15,-3400,30600
553,2287131,14,31450,37000,95.0,1731,2023-04-19T22:15,-4718,26732
554,2356693,15,39000,0,97.0,1564,2023-04-19T22:15,-5850,33150
555,2028240,16,39000,0,98.0,3379,2023-04-19T22:15,-5850,33150
556,1214109,17,36000,0,97.0,8203,2023-04-19T22:15,0,36000
557,2859190,18,33300,37000,96.0,480,2023-04-19T22:15,-4995,28305
558,2286829,19,31450,37000,95.0,5082,2023-04-19T22:15,-4718,26732
559,1214173,20,36000,0,96.0,5625,2023-04-19T22:15,0,36000
560,1022014,21,79000,0,96.0,11485,2023-04-19T22:15,0,79000
561,1771133,22,27550,29000,97.0,5751,2023-04-19T22:15,0,27550
562,3142347,23,49000,0,100.0,7,2023-04-19T22:15,0,49000
563,1022013,24,79000,0,96.0,6299,2023-04-19T22:15,0,79000
564,2123132,25,36900,39000,97.0,6468,2023-04-19T22:15,-3690,33210
565,1214169,26,36000,0,96.0,5385,2023-04-19T22:15,0,36000
566,1771132,27,26100,29000,96.0,5341,2023-04-19T22:15,0,26100
567,1855444,28,39900,42000,97.0,3071,2023-04-19T22:15,-5985,33915
568,1214317,29,36000,0,97.0,11543,2023-04-19T22:15,0,36000
569,2221221,30,35100,39000,96.0,1907,2023-04-19T22:15,0,35100
570,3039055,31,36550,43000,95.0,55,2023-04-19T22:15,-5483,31067
571,2560668,32,48300,69000,97.0,1267,2023-04-19T22:15,0,48300
572,1907733,33,29900,39000,96.0,3905,2023-04-19T22:15,0,29900
573,3012243,34,29900,39900,98.0,79,2023-04-19T22:15,-4485,25415
574,3039061,35,33150,39000,95.0,43,2023-04-19T22:15,-4973,28177
575,2280146,36,35100,39000,97.0,955,2023-04-19T22:15,0,35100
576,2672186,37,20900,30000,96.0,620,2023-04-19T22:15,-2090,18810
577,1920840,38,39000,0,98.0,1396,2023-04-19T22:15,-5850,33150
578,2697593,39,99000,0,97.0,139,2023-04-19T22:15,0,99000
579,1906772,40,39900,42000,97.0,3114,2023-04-19T22:15,-5985,33915
580,2198830,41,14700,21000,95.0,1502,2023-04-19T22:15,0,14700
581,2879425,42,48900,55000,97.0,348,2023-04-19T22:15,-7335,41565
582,1760824,43,49700,59000,97.0,331,2023-04-19T22:15,0,49700
583,3125906,44,80100,89000,98.0,25,2023-04-19T22:15,0,80100
584,3226808,45,240000,0,0.0,0,2023-04-19T22:15,-12000,228000
585,3099126,46,54000,0,100.0,11,2023-04-19T22:15,0,54000
586,1452917,47,69000,0,96.0,2434,2023-04-19T22:15,0,69000
587,2107999,48,36000,0,97.0,2708,2023-04-19T22:15,0,36000
588,2573131,49,39900,42000,98.0,722,2023-04-19T22:15,-5985,33915
589,1214106,50,36000,0,96.0,9781,2023-04-19T22:15,0,36000
590,2381807,51,48300,69000,98.0,1166,2023-04-19T22:15,0,48300
591,2134295,52,39000,0,97.0,423,2023-04-19T22:15,0,39000
592,1524720,53,36000,0,96.0,3424,2023-04-19T22:15,0,36000
593,2879417,54,48900,55000,98.0,226,2023-04-19T22:15,-7335,41565
594,1214171,55,36000,0,97.0,1732,2023-04-19T22:15,0,36000
595,3038180,56,41400,46000,98.0,160,2023-04-19T22:15,-4140,37260
596,2169131,57,35100,39000,97.0,465,2023-04-19T22:15,0,35100
597,3225733,58,49000,0,100.0,7,2023-04-19T22:15,0,49000
598,2922090,59,52000,0,95.0,74,2023-04-19T22:15,0,52000
599,2287158,60,33300,37000,95.0,1254,2023-04-19T22:15,-4995,28305
600,2591291,61,39200,49000,97.0,1047,2023-04-19T22:15,0,39200
601,3172574,62,46000,0,0.0,0,2023-04-19T22:15,-4600,41400
602,1374020,63,24500,35000,96.0,2892,2023-04-19T22:15,-3675,20825
603,2630072,64,30500,45000,96.0,211,2023-04-19T22:15,0,30500
604,2288644,65,35700,42000,96.0,1226,2023-04-19T22:15,-7140,28560
605,2559152,66,368000,565000,100.0,1,2023-04-19T22:15,0,368000
606,2864918,67,49000,0,99.0,151,2023-04-19T22:15,0,49000
607,3119349,68,129000,0,100.0,1,2023-04-19T22:15,0,129000
608,2683883,69,69000,0,97.0,141,2023-04-19T22:15,0,69000
609,1086824,70,29600,37000,95.0,18656,2023-04-19T22:15,0,29600
610,1939301,71,39000,0,97.0,824,2023-04-19T22:15,-5850,33150
611,2089719,72,36000,0,97.0,2454,2023-04-19T22:15,0,36000
612,2507080,73,39000,0,98.0,436,2023-04-19T22:15,-5850,33150
613,3051124,74,30600,34000,93.0,21,2023-04-19T22:15,-3060,27540
614,2286799,75,33300,37000,95.0,821,2023-04-19T22:15,-4995,28305
615,2329375,76,34710,39000,96.0,2127,2023-04-19T22:15,-3471,31239
616,2812150,77,144000,238000,96.0,13,2023-04-19T22:15,-14400,129600
617,2980928,78,308000,490000,91.0,19,2023-04-19T22:15,-20000,288000
618,2364344,79,26600,38000,97.0,1718,2023-04-19T22:15,0,26600
619,1925814,80,35100,39000,96.0,1700,2023-04-19T22:15,0,35100
620,2650965,81,48900,53000,98.0,394,2023-04-19T22:15,-7335,41565
621,2507021,82,42000,0,96.0,414,2023-04-19T22:15,-6300,35700
622,2864774,83,49000,0,98.0,98,2023-04-19T22:15,0,49000
623,1126959,84,29250,39000,91.0,2592,2023-04-19T22:15,0,29250
624,2569069,85,33300,37000,96.0,272,2023-04-19T22:15,-4995,28305
625,2687157,86,45000,0,97.0,1085,2023-04-19T22:15,-6750,38250
626,2707659,87,42000,0,97.0,546,2023-04-19T22:15,0,42000
627,1433907,88,29250,39000,94.0,1518,2023-04-19T22:15,0,29250
628,3095040,89,65000,0,100.0,8,2023-04-19T22:15,0,65000
629,2716310,90,33300,37000,95.0,177,2023-04-19T22:15,-4995,28305
630,3083239,1,159000,0,0.0,0,2023-04-19T22:15,0,159000
631,3050856,2,189000,0,92.0,13,2023-04-19T22:15,-9450,179550
632,3106487,3,133200,148000,99.0,30,2023-04-19T22:15,0,133200
633,3190290,4,249000,0,0.0,0,2023-04-19T22:15,0,249000
634,3206508,5,150100,158000,0.0,0,2023-04-19T22:15,-7505,142595
635,3031171,6,68000,0,98.0,63,2023-04-19T22:15,0,68000
636,2605850,7,94000,0,97.0,171,2023-04-19T22:15,-4700,89300
637,3050173,8,166600,238000,100.0,6,2023-04-19T22:15,0,166600
638,3081772,9,189000,0,93.0,3,2023-04-19T22:15,0,189000
639,2388209,10,94000,0,96.0,158,2023-04-19T22:15,-4700,89300
640,3227586,11,159000,0,0.0,0,2023-04-19T22:15,0,159000
641,3138205,12,139500,155000,0.0,0,2023-04-19T22:15,-6975,132525
642,1103287,13,94000,0,95.0,402,2023-04-19T22:15,0,94000
643,3161942,14,279000,0,0.0,0,2023-04-19T22:15,-13950,265050
644,1579103,15,126400,158000,96.0,100,2023-04-19T22:15,-18960,107440
645,2052060,16,278000,0,100.0,3,2023-04-19T22:15,0,278000
646,3119265,17,111200,139000,0.0,0,2023-04-19T22:15,0,111200
647,3210605,18,264000,0,0.0,0,2023-04-19T22:15,0,264000
648,2556297,19,259000,0,0.0,0,2023-04-19T22:15,0,259000
649,3137022,20,255000,0,0.0,0,2023-04-19T22:15,-25500,229500
650,3105864,21,129000,0,0.0,0,2023-04-19T22:15,-19350,109650
651,3134492,22,75050,79000,96.0,6,2023-04-19T22:15,0,75050
652,3074707,23,119000,0,100.0,4,2023-04-19T22:15,0,119000
653,3222146,24,250200,278000,0.0,0,2023-04-19T22:15,0,250200
654,1341924,25,98800,152000,96.0,89,2023-04-19T22:15,-14820,83980
655,3041479,26,118000,0,100.0,1,2023-04-19T22:15,0,118000
656,3126194,27,63200,79000,86.0,3,2023-04-19T22:15,-9480,53720
657,3203077,28,168000,0,0.0,0,2023-04-19T22:15,-25200,142800
658,3156578,29,228650,269000,0.0,0,2023-04-19T22:15,-34298,194352
659,3196917,30,159000,0,100.0,1,2023-04-19T22:15,0,159000
660,2512635,31,35400,59000,96.0,223,2023-04-19T22:15,0,35400
661,3171883,32,141600,149000,100.0,3,2023-04-19T22:15,0,141600
662,2392489,33,28690,31900,97.0,738,2023-04-19T22:15,0,28690
663,2489894,34,150100,158000,98.0,109,2023-04-19T22:15,0,150100
664,3066925,35,106200,118000,100.0,4,2023-04-19T22:15,0,106200
665,2593633,36,212000,0,100.0,6,2023-04-19T22:15,0,212000
666,3119224,37,199000,0,100.0,3,2023-04-19T22:15,0,199000
667,3213349,38,94050,99000,0.0,0,2023-04-19T22:15,-18810,75240
668,2830893,39,189000,0,100.0,5,2023-04-19T22:15,0,189000
669,3120621,40,197100,219000,100.0,1,2023-04-19T22:15,-35478,161622
670,3053225,41,159000,0,100.0,2,2023-04-19T22:15,0,159000
671,3231297,42,104250,139000,0.0,0,2023-04-19T22:15,0,104250
672,3225126,43,129000,0,100.0,1,2023-04-19T22:15,0,129000
673,1103286,44,94000,0,95.0,784,2023-04-19T22:15,0,94000
674,3041848,45,168000,0,100.0,1,2023-04-19T22:15,0,168000
675,3214157,46,188000,0,0.0,0,2023-04-19T22:15,0,188000
676,3165309,47,98100,109000,0.0,0,2023-04-19T22:15,0,98100
677,3041837,48,168000,0,0.0,0,2023-04-19T22:15,0,168000
678,3055337,49,159000,0,100.0,1,2023-04-19T22:15,0,159000
679,2489892,50,150100,158000,95.0,22,2023-04-19T22:15,0,150100
680,3146756,51,188100,209000,0.0,0,2023-04-19T22:15,-33858,154242
681,3205610,52,175000,219000,0.0,0,2023-04-19T22:15,-8750,166250
682,3158872,53,94900,105000,0.0,0,2023-04-19T22:15,-9490,85410
683,1840913,54,143200,179000,92.0,17,2023-04-19T22:15,0,143200
684,3156832,55,89000,0,95.0,4,2023-04-19T22:15,0,89000
685,3102263,56,165000,0,0.0,0,2023-04-19T22:15,0,165000
686,3053218,57,159000,0,86.0,3,2023-04-19T22:15,0,159000
687,3115352,58,178200,198000,0.0,0,2023-04-19T22:15,0,178200
688,3212434,59,173000,0,0.0,0,2023-04-19T22:15,0,173000
689,2697766,60,165300,174000,100.0,33,2023-04-19T22:15,0,165300
690,3193308,61,168000,0,0.0,0,2023-04-19T22:15,0,168000
691,3153266,62,168000,0,0.0,0,2023-04-19T22:15,-33600,134400
692,3109926,63,69700,82000,92.0,5,2023-04-19T22:15,-10455,59245
693,2961632,64,167300,239000,0.0,0,2023-04-19T22:15,-8365,158935
694,3138204,65,139500,155000,0.0,0,2023-04-19T22:15,-6975,132525
695,3223214,66,129000,0,0.0,0,2023-04-19T22:15,-19350,109650
696,2687340,67,159000,0,0.0,0,2023-04-19T22:15,0,159000
697,1779568,68,57600,64000,95.0,294,2023-04-19T22:15,0,57600
698,1489945,69,148000,0,93.0,13,2023-04-19T22:15,0,148000
699,2328450,70,159000,0,100.0,2,2023-04-19T22:15,0,159000
700,2920324,71,158000,0,0.0,0,2023-04-19T22:15,0,158000
701,1955893,72,65100,93000,91.0,39,2023-04-19T22:15,-9765,55335
702,2848553,73,152000,0,100.0,2,2023-04-19T22:15,0,152000
703,2453664,74,148400,185500,100.0,5,2023-04-19T22:15,0,148400
704,2558236,75,148800,248000,100.0,3,2023-04-19T22:15,0,148800
705,3106998,76,152150,179000,0.0,0,2023-04-19T22:15,-22823,129327
706,3192300,77,129000,0,0.0,0,2023-04-19T22:15,-12900,116100
707,3130642,78,119000,0,0.0,0,2023-04-19T22:15,-5950,113050
708,3206552,79,106400,112000,0.0,0,2023-04-19T22:15,0,106400
709,3150613,80,71100,79000,100.0,1,2023-04-19T22:15,0,71100
710,2580534,81,138000,0,0.0,0,2023-04-19T22:15,0,138000
711,2608654,82,144400,152000,100.0,1,2023-04-19T22:15,0,144400
712,3085850,83,128000,0,0.0,0,2023-04-19T22:15,0,128000
713,2392491,84,28690,31900,96.0,405,2023-04-19T22:15,0,28690
714,3138203,85,139500,155000,0.0,0,2023-04-19T22:15,-6975,132525
715,1455772,86,94000,0,96.0,212,2023-04-19T22:15,-4700,89300
716,3203383,87,129000,0,0.0,0,2023-04-19T22:15,-12900,116100
717,2933268,88,218000,0,0.0,0,2023-04-19T22:15,0,218000
718,3074709,89,119000,0,100.0,3,2023-04-19T22:15,0,119000
719,1506870,90,54600,78000,95.0,26,2023-04-19T22:15,0,54600
720,3051039,1,83300,119000,100.0,40,2023-04-19T22:15,0,83300
721,3144374,2,71100,79000,100.0,7,2023-04-19T22:15,0,71100
722,3159166,3,162000,0,0.0,0,2023-04-19T22:15,-24300,137700
723,3115907,4,138000,0,100.0,4,2023-04-19T22:15,0,138000
724,3070528,5,168000,0,95.0,4,2023-04-19T22:15,0,168000
725,3073258,6,160200,178000,97.0,9,2023-04-19T22:15,-28836,131364
726,2864414,7,69300,99000,95.0,100,2023-04-19T22:15,-10395,58905
727,2978106,8,49900,0,100.0,5,2023-04-19T22:15,-4990,44910
728,2709978,9,358000,0,100.0,2,2023-04-19T22:15,-53700,304300
729,3133082,10,171000,0,90.0,6,2023-04-19T22:15,0,171000
730,1944554,11,36900,0,96.0,557,2023-04-19T22:15,-3690,33210
731,3212802,12,338000,0,0.0,0,2023-04-19T22:15,-50700,287300
732,3171253,13,339000,0,0.0,0,2023-04-19T22:15,-50850,288150
733,2571642,14,149000,0,93.0,15,2023-04-19T22:15,0,149000
734,3133860,15,88000,98000,100.0,4,2023-04-19T22:15,0,88000
735,3144257,16,66000,82000,93.0,3,2023-04-19T22:15,-9900,56100
736,2830808,17,139000,0,97.0,15,2023-04-19T22:15,0,139000
737,3037452,18,149000,0,100.0,3,2023-04-19T22:15,0,149000
738,1324169,19,29900,0,95.0,1355,2023-04-19T22:15,0,29900
739,3122265,20,124200,138000,88.0,5,2023-04-19T22:15,-22356,101844
740,2879963,21,276000,0,100.0,1,2023-04-19T22:15,0,276000
741,3071814,22,73600,92000,100.0,2,2023-04-19T22:15,-11040,62560
742,1645760,23,43900,0,96.0,347,2023-04-19T22:15,0,43900
743,3125457,24,49900,89900,88.0,9,2023-04-19T22:15,0,49900
744,2796166,25,38400,64000,96.0,235,2023-04-19T22:15,0,38400
745,3103909,26,265050,279000,0.0,0,2023-04-19T22:15,-47709,217341
746,3144417,27,71100,79000,100.0,3,2023-04-19T22:15,0,71100
747,1788995,28,58500,65000,94.0,568,2023-04-19T22:15,0,58500
748,2933318,29,138000,0,98.0,12,2023-04-19T22:15,0,138000
749,3083211,30,128000,0,100.0,3,2023-04-19T22:15,0,128000
750,2758426,31,138000,0,84.0,9,2023-04-19T22:15,0,138000
751,2739414,32,118000,0,92.0,13,2023-04-19T22:15,-5900,112100
752,2551401,33,37900,0,94.0,332,2023-04-19T22:15,0,37900
753,3047742,34,71100,79000,95.0,8,2023-04-19T22:15,-14220,56880
754,3077493,35,238000,0,100.0,1,2023-04-19T22:15,-42840,195160
755,3062947,36,110400,138000,100.0,5,2023-04-19T22:15,0,110400
756,3081767,37,169000,0,93.0,9,2023-04-19T22:15,0,169000
757,2377814,38,198000,0,96.0,78,2023-04-19T22:15,-35640,162360
758,3132900,39,170100,189000,0.0,0,2023-04-19T22:15,-25515,144585
759,2610241,40,210000,350000,0.0,0,2023-04-19T22:15,-37800,172200
760,2634726,41,218000,0,0.0,0,2023-04-19T22:15,0,218000
761,2716675,42,39900,59000,96.0,182,2023-04-19T22:15,-5985,33915
762,3115913,43,106200,118000,100.0,1,2023-04-19T22:15,0,106200
763,2377812,44,198000,0,96.0,59,2023-04-19T22:15,-35640,162360
764,3040745,45,88000,110000,94.0,17,2023-04-19T22:15,0,88000
765,3095062,46,224000,0,0.0,0,2023-04-19T22:15,0,224000
766,2666816,47,203000,290000,80.0,3,2023-04-19T22:15,-36540,166460
767,2392478,48,29590,34900,97.0,350,2023-04-19T22:15,0,29590
768,3144894,49,93000,0,0.0,0,2023-04-19T22:15,0,93000
769,3038424,50,97300,139000,95.0,4,2023-04-19T22:15,-14595,82705
770,3124643,51,198000,0,100.0,1,2023-04-19T22:15,-29700,168300
771,1819994,52,36500,43000,92.0,665,2023-04-19T22:15,-3650,32850
772,2300718,53,43900,0,95.0,248,2023-04-19T22:15,0,43900
773,2925522,54,65000,0,96.0,128,2023-04-19T22:15,0,65000
774,2864423,55,69300,99000,94.0,19,2023-04-19T22:15,-10395,58905
775,3188876,56,192000,0,0.0,0,2023-04-19T22:15,0,192000
776,3118107,57,185300,218000,0.0,0,2023-04-19T22:15,0,185300
777,3118014,58,185300,218000,0.0,0,2023-04-19T22:15,0,185300
778,3073252,59,160200,178000,100.0,6,2023-04-19T22:15,-28836,131364
779,3118896,60,64800,72000,100.0,10,2023-04-19T22:15,0,64800
780,2978103,61,47900,0,98.0,11,2023-04-19T22:15,0,47900
781,3105568,62,159000,0,0.0,0,2023-04-19T22:15,0,159000
782,3122281,63,160200,178000,100.0,4,2023-04-19T22:15,-28836,131364
783,3200164,64,125100,139000,100.0,1,2023-04-19T22:15,-22518,102582
784,2590278,65,178200,198000,100.0,1,2023-04-19T22:15,-32076,146124
785,3098635,66,171990,189000,100.0,2,2023-04-19T22:15,-30959,141031
786,3038047,67,107100,119000,100.0,5,2023-04-19T22:15,0,107100
787,3081766,68,169000,0,100.0,2,2023-04-19T22:15,0,169000
788,2403682,69,53100,59000,100.0,6,2023-04-19T22:15,0,53100
789,3073242,70,169200,188000,100.0,4,2023-04-19T22:15,-30456,138744
790,2792603,71,43900,0,100.0,58,2023-04-19T22:15,0,43900
791,3133264,72,143100,159000,0.0,0,2023-04-19T22:15,-21465,121635
792,3100900,73,168000,0,90.0,4,2023-04-19T22:15,-30240,137760
793,1807814,74,65550,69000,97.0,249,2023-04-19T22:15,0,65550
794,3170471,75,139000,0,100.0,1,2023-04-19T22:15,0,139000
795,2381704,76,174300,249000,0.0,0,2023-04-19T22:15,-31374,142926
796,3161020,77,169000,0,0.0,0,2023-04-19T22:15,-30420,138580
797,3119258,78,55900,66000,100.0,7,2023-04-19T22:15,0,55900
798,3034043,79,148000,0,100.0,1,2023-04-19T22:15,0,148000
799,2571681,80,149000,0,86.0,9,2023-04-19T22:15,0,149000
800,3221635,81,84000,0,0.0,0,2023-04-19T22:15,0,84000
801,2448899,82,43900,0,95.0,141,2023-04-19T22:15,0,43900
802,3069542,83,152100,169000,0.0,0,2023-04-19T22:15,-27378,124722
803,3031104,84,48300,69000,98.0,72,2023-04-19T22:15,-7245,41055
804,2643318,85,138000,0,94.0,18,2023-04-19T22:15,-24840,113160
805,3213324,86,84550,89000,0.0,0,2023-04-19T22:15,-16910,67640
806,3159199,87,152000,0,0.0,0,2023-04-19T22:15,-22800,129200
807,3128647,88,89000,0,0.0,0,2023-04-19T22:15,0,89000
808,3105564,89,159000,0,0.0,0,2023-04-19T22:15,0,159000
809,3069708,90,160650,189000,0.0,0,2023-04-19T22:15,0,160650
810,991339,1,17890,19900,97.0,53366,2023-04-19T22:15,0,17890
811,998051,2,15900,24000,97.0,164234,2023-04-19T22:15,0,15900
812,1986031,3,27900,0,97.0,10834,2023-04-19T22:15,0,27900
813,991340,4,17890,19900,97.0,31067,2023-04-19T22:15,0,17890
814,763821,5,16900,22000,96.0,31520,2023-04-19T22:15,0,16900
815,1477845,6,15400,22000,96.0,9821,2023-04-19T22:15,0,15400
816,1094748,7,19900,0,97.0,19287,2023-04-19T22:15,0,19900
817,1094835,8,15900,0,97.0,6289,2023-04-19T22:15,0,15900
818,1996702,9,25090,27900,97.0,1962,2023-04-19T22:15,0,25090
819,1342874,10,16900,33000,97.0,13043,2023-04-19T22:15,0,16900
820,2845854,11,13000,18900,97.0,273,2023-04-19T22:15,-2600,10400
821,746158,12,19390,22900,96.0,20568,2023-04-19T22:15,0,19390
822,792919,13,15190,16900,96.0,17990,2023-04-19T22:15,0,15190
823,1996705,14,23690,27900,98.0,2730,2023-04-19T22:15,0,23690
824,1729576,15,9900,13900,97.0,16291,2023-04-19T22:15,-1485,8415
825,1986029,16,25090,27900,97.0,3998,2023-04-19T22:15,0,25090
826,1443937,17,12900,24000,97.0,8177,2023-04-19T22:15,0,12900
827,734085,18,13900,19800,96.0,65130,2023-04-19T22:15,0,13900
828,991570,19,12900,20000,97.0,19149,2023-04-19T22:15,0,12900
829,3033249,20,15000,0,95.0,265,2023-04-19T22:15,0,15000
830,1986030,21,25090,27900,97.0,1703,2023-04-19T22:15,0,25090
831,991341,22,16890,19900,96.0,10275,2023-04-19T22:15,0,16890
832,2832613,23,11900,33000,97.0,784,2023-04-19T22:15,0,11900
833,1821485,24,30000,0,96.0,1295,2023-04-19T22:15,0,30000
834,479245,25,15400,22000,93.0,5437,2023-04-19T22:15,0,15400
835,2297277,26,19900,22000,96.0,316,2023-04-19T22:15,0,19900
836,792920,27,15190,16900,96.0,9698,2023-04-19T22:15,0,15190
837,1996704,28,22290,27900,97.0,723,2023-04-19T22:15,0,22290
838,1974077,29,37490,46900,97.0,908,2023-04-19T22:15,0,37490
839,746154,30,17900,0,96.0,5216,2023-04-19T22:15,0,17900
840,1346009,31,9900,12000,97.0,6746,2023-04-19T22:15,-1485,8415
841,1094750,32,16890,19900,97.0,3571,2023-04-19T22:15,0,16890
842,1094749,33,19900,0,96.0,4981,2023-04-19T22:15,0,19900
843,2346958,34,18900,24000,97.0,529,2023-04-19T22:15,-2835,16065
844,2509300,35,19900,0,96.0,401,2023-04-19T22:15,0,19900
845,746159,36,19390,22900,95.0,28754,2023-04-19T22:15,0,19390
846,2973872,37,12000,14800,98.0,14,2023-04-19T22:15,0,12000
847,3118094,38,28800,32000,98.0,11,2023-04-19T22:15,0,28800
848,2960555,39,19000,0,93.0,125,2023-04-19T22:15,0,19000
849,3083314,40,38000,0,91.0,9,2023-04-19T22:15,0,38000
850,1477846,41,15400,22000,96.0,2692,2023-04-19T22:15,0,15400
851,2011850,42,21490,23900,98.0,873,2023-04-19T22:15,0,21490
852,2973952,43,28800,48000,95.0,16,2023-04-19T22:15,-5184,23616
853,2295818,44,19900,22000,95.0,190,2023-04-19T22:15,0,19900
854,2347097,45,14900,24000,98.0,1611,2023-04-19T22:15,-2235,12665
855,752821,46,9900,0,94.0,23852,2023-04-19T22:15,0,9900
856,2973894,47,22000,27500,98.0,32,2023-04-19T22:15,-1100,20900
857,1821487,48,30000,0,97.0,683,2023-04-19T22:15,0,30000
858,472686,49,9900,14800,94.0,755,2023-04-19T22:15,0,9900
859,3009680,50,12590,14900,98.0,139,2023-04-19T22:15,0,12590
860,2990345,51,27900,0,98.0,57,2023-04-19T22:15,0,27900
861,1573974,52,37490,46900,97.0,1453,2023-04-19T22:15,0,37490
862,3220488,53,18000,0,90.0,4,2023-04-19T22:15,0,18000
863,2477852,54,16890,19900,98.0,690,2023-04-19T22:15,0,16890
864,1260384,55,19900,0,95.0,1809,2023-04-19T22:15,0,19900
865,2467197,56,30000,0,95.0,148,2023-04-19T22:15,0,30000
866,1647682,57,14900,23600,97.0,967,2023-04-19T22:15,-2235,12665
867,1092994,58,19390,22900,96.0,2668,2023-04-19T22:15,0,19390
868,3065854,59,25000,0,97.0,22,2023-04-19T22:15,0,25000
869,1286366,60,11900,24000,97.0,9842,2023-04-19T22:15,0,11900
870,2959925,61,22000,27500,98.0,130,2023-04-19T22:15,-1100,20900
871,2835702,62,13900,15800,97.0,80,2023-04-19T22:15,0,13900
872,2821589,63,19690,21900,96.0,41,2023-04-19T22:15,0,19690
873,1260385,64,16890,19900,95.0,799,2023-04-19T22:15,0,16890
874,1094836,65,15900,0,97.0,1331,2023-04-19T22:15,0,15900
875,3135820,66,45000,0,0.0,0,2023-04-19T22:15,0,45000
876,927065,67,19390,22900,95.0,1455,2023-04-19T22:15,0,19390
877,2667536,68,31000,0,97.0,14,2023-04-19T22:15,0,31000
878,1475031,69,17900,27000,96.0,1748,2023-04-19T22:15,-2685,15215
879,1475055,70,16900,22000,96.0,1186,2023-04-19T22:15,-2535,14365
880,1360044,71,17890,19900,97.0,1765,2023-04-19T22:15,0,17890
881,1556774,72,15200,16000,97.0,476,2023-04-19T22:15,0,15200
882,2652523,73,9900,12000,98.0,121,2023-04-19T22:15,-1485,8415
883,2929635,74,16800,27000,97.0,560,2023-04-19T22:15,-2520,14280
884,1094834,75,20290,23900,96.0,2467,2023-04-19T22:15,0,20290
885,3113489,76,32000,0,100.0,8,2023-04-19T22:15,0,32000
886,2912120,77,25000,0,96.0,20,2023-04-19T22:15,0,25000
887,1062063,78,9490,15900,96.0,2173,2023-04-19T22:15,0,9490
888,1260383,79,19900,0,95.0,1466,2023-04-19T22:15,0,19900
889,1392773,80,16890,19900,95.0,1477,2023-04-19T22:15,0,16890
890,1480012,81,13900,18000,96.0,413,2023-04-19T22:15,-2085,11815
891,2855921,82,27000,0,98.0,12,2023-04-19T22:15,0,27000
892,1358721,83,14900,22000,96.0,1156,2023-04-19T22:15,-2235,12665
893,2342849,84,15120,18900,91.0,129,2023-04-19T22:15,0,15120
894,2870865,85,15900,19900,95.0,71,2023-04-19T22:15,-3180,12720
895,1387502,86,12690,15900,95.0,519,2023-04-19T22:15,0,12690
896,2821596,87,19890,24900,97.0,108,2023-04-19T22:15,0,19890
897,3113486,88,32000,0,93.0,3,2023-04-19T22:15,0,32000
898,1348077,89,10900,16500,97.0,1885,2023-04-19T22:15,0,10900
899,792921,90,15190,16900,95.0,7816,2023-04-19T22:15,0,15190
