,item_id,rank,price,del_price,rating,rating_count,time,coupon,real_price
0,1848797,1,169000,0,96.0,112,2023-04-26T21:42,0,169000
1,3214283,2,47778,82000,98.0,242,2023-04-26T21:42,-4778,43000
2,3214280,3,47778,82000,98.0,307,2023-04-26T21:42,-4778,43000
3,3214285,4,47778,82000,98.0,457,2023-04-26T21:42,-4778,43000
4,3143791,5,45900,68000,97.0,794,2023-04-26T21:42,-9180,36720
5,2272830,6,35910,39900,97.0,20922,2023-04-26T21:42,-7182,28728
6,1763157,7,49300,52000,95.0,2960,2023-04-26T21:42,0,49300
7,3204179,8,49900,0,100.0,41,2023-04-26T21:42,0,49900
8,3214271,9,47778,82000,98.0,143,2023-04-26T21:42,-4778,43000
9,1848166,10,39000,49000,97.0,41670,2023-04-26T21:42,-3900,35100
10,3201923,11,87200,109000,0.0,0,2023-04-26T21:42,-13080,74120
11,3105468,12,55300,79000,98.0,146,2023-04-26T21:42,0,55300
12,345889,13,29900,47900,95.0,10504,2023-04-26T21:42,0,29900
13,3214275,14,47778,82000,98.0,296,2023-04-26T21:42,-4778,43000
14,3214281,15,47778,82000,98.0,233,2023-04-26T21:42,-4778,43000
15,2442409,16,27300,78000,96.0,9394,2023-04-26T21:42,0,27300
16,3105520,17,97300,139000,99.0,23,2023-04-26T21:42,-14595,82705
17,1944612,18,35800,59700,97.0,3203,2023-04-26T21:42,0,35800
18,1939099,19,31850,49000,97.0,12173,2023-04-26T21:42,-6370,25480
19,1921901,20,36900,70500,96.0,7782,2023-04-26T21:42,0,36900
20,2086653,21,16900,0,97.0,41024,2023-04-26T21:42,0,16900
21,1201421,22,199000,0,95.0,157,2023-04-26T21:42,0,199000
22,1706633,23,199000,0,97.0,2510,2023-04-26T21:42,0,199000
23,3043740,24,49700,59000,98.0,56,2023-04-26T21:42,-2485,47215
24,3086682,25,106200,125000,94.0,39,2023-04-26T21:42,0,106200
25,1882578,26,35910,39900,97.0,10837,2023-04-26T21:42,-7182,28728
26,2479911,27,49400,76000,97.0,4683,2023-04-26T21:42,-2470,46930
27,1884943,28,27900,39000,96.0,19155,2023-04-26T21:42,-4185,23715
28,2285512,29,49300,52000,96.0,1862,2023-04-26T21:42,-2465,46835
29,3143783,30,39900,59000,100.0,4,2023-04-26T21:42,-7980,31920
30,3242956,31,96000,0,0.0,0,2023-04-26T21:42,-4800,91200
31,1899755,32,27900,39000,96.0,5142,2023-04-26T21:42,-4185,23715
32,2646350,33,59800,94000,95.0,5109,2023-04-26T21:42,-5980,53820
33,2034137,34,31800,0,97.0,18389,2023-04-26T21:42,-4770,27030
34,3214284,35,47778,82000,96.0,130,2023-04-26T21:42,-4778,43000
35,3046818,36,39560,46000,98.0,116,2023-04-26T21:42,0,39560
36,3242950,37,96000,0,100.0,8,2023-04-26T21:42,-4800,91200
37,1763123,38,80100,89000,96.0,1709,2023-04-26T21:42,0,80100
38,2454238,39,97200,108000,97.0,1713,2023-04-26T21:42,-14580,82620
39,3187851,40,49900,110000,96.0,436,2023-04-26T21:42,-4990,44910
40,3046771,41,39560,46000,98.0,158,2023-04-26T21:42,0,39560
41,1842348,42,79200,99000,96.0,3062,2023-04-26T21:42,-15840,63360
42,3105527,43,97300,139000,95.0,14,2023-04-26T21:42,-14595,82705
43,3214274,44,47778,82000,97.0,145,2023-04-26T21:42,-4778,43000
44,2453556,45,39900,42000,97.0,6496,2023-04-26T21:42,0,39900
45,2015684,46,39000,0,94.0,6545,2023-04-26T21:42,0,39000
46,2398380,47,27000,45000,96.0,1772,2023-04-26T21:42,-2700,24300
47,2623779,48,88200,98000,99.0,94,2023-04-26T21:42,0,88200
48,2409894,49,27300,78000,97.0,5310,2023-04-26T21:42,0,27300
49,2462040,50,38000,45000,95.0,4080,2023-04-26T21:42,-5700,32300
50,3124809,51,65550,69000,100.0,9,2023-04-26T21:42,0,65550
51,1836749,52,119000,0,95.0,26,2023-04-26T21:42,0,119000
52,3129117,53,45000,0,99.0,60,2023-04-26T21:42,-4500,40500
53,3214276,54,37778,69000,99.0,164,2023-04-26T21:42,-3778,34000
54,1763218,55,80100,89000,96.0,1552,2023-04-26T21:42,0,80100
55,3141117,56,109000,0,100.0,1,2023-04-26T21:42,-16350,92650
56,2377269,57,45000,0,97.0,4330,2023-04-26T21:42,0,45000
57,2376229,58,32400,36000,97.0,3982,2023-04-26T21:42,0,32400
58,3134405,59,44910,49900,99.0,386,2023-04-26T21:42,-8982,35928
59,1005683,60,14000,35000,95.0,11178,2023-04-26T21:42,0,14000
60,2913659,61,47900,64000,96.0,393,2023-04-26T21:42,-9580,38320
61,3227697,62,47778,82000,98.0,16,2023-04-26T21:42,-4778,43000
62,2375962,63,59000,62000,98.0,5957,2023-04-26T21:42,0,59000
63,3179497,64,35910,39900,99.0,170,2023-04-26T21:42,-7182,28728
64,1955452,65,39800,69990,95.0,2787,2023-04-26T21:42,0,39800
65,3180244,66,59900,90000,97.0,42,2023-04-26T21:42,-11980,47920
66,1848806,67,169000,0,97.0,27,2023-04-26T21:42,0,169000
67,1336398,68,33500,67000,96.0,19265,2023-04-26T21:42,-5025,28475
68,1503352,69,39900,42000,97.0,8588,2023-04-26T21:42,0,39900
69,2426596,70,34400,43000,96.0,3065,2023-04-26T21:42,-5160,29240
70,2575342,71,39900,59000,96.0,1009,2023-04-26T21:42,-3990,35910
71,1620270,72,189000,0,96.0,100,2023-04-26T21:42,0,189000
72,2149254,73,37800,0,97.0,34671,2023-04-26T21:42,-5670,32130
73,2392759,74,39900,49600,95.0,4307,2023-04-26T21:42,-5985,33915
74,2376233,75,32400,36000,97.0,2340,2023-04-26T21:42,0,32400
75,3211815,76,24500,35000,98.0,78,2023-04-26T21:42,-4900,19600
76,3125099,77,29900,39000,94.0,26,2023-04-26T21:42,-5980,23920
77,994588,78,39900,53000,94.0,6209,2023-04-26T21:42,-7980,31920
78,2313388,79,68000,85000,96.0,2307,2023-04-26T21:42,0,68000
79,1031260,80,33600,42000,96.0,13294,2023-04-26T21:42,0,33600
80,996177,81,15900,0,95.0,78171,2023-04-26T21:42,0,15900
81,3214277,82,37778,69000,98.0,126,2023-04-26T21:42,-3778,34000
82,3214282,83,47778,82000,98.0,131,2023-04-26T21:42,-4778,43000
83,2305840,84,59700,0,97.0,4163,2023-04-26T21:42,0,59700
84,2406919,85,199000,0,96.0,521,2023-04-26T21:42,0,199000
85,1820701,86,31500,35000,97.0,5648,2023-04-26T21:42,0,31500
86,2032985,87,83300,119000,97.0,1897,2023-04-26T21:42,0,83300
87,3129723,88,31200,39000,97.0,122,2023-04-26T21:42,-4680,26520
88,3143788,89,29900,34000,100.0,29,2023-04-26T21:42,-4485,25415
89,2461377,90,169000,0,96.0,356,2023-04-26T21:42,0,169000
90,1558197,1,69590,81900,97.0,33144,2023-04-26T21:42,0,69590
91,1778404,2,39000,45000,96.0,68549,2023-04-26T21:42,-5850,33150
92,2329532,3,119200,149000,97.0,4146,2023-04-26T21:42,0,119200
93,2723218,4,69900,85900,97.0,3118,2023-04-26T21:42,-10485,59415
94,1856181,5,35910,39900,97.0,8457,2023-04-26T21:42,-7182,28728
95,3012082,6,59900,79000,96.0,1302,2023-04-26T21:42,0,59900
96,1571879,7,79900,112900,96.0,7293,2023-04-26T21:42,0,79900
97,1283757,8,71290,83900,96.0,26978,2023-04-26T21:42,0,71290
98,1776552,9,59000,69000,94.0,6299,2023-04-26T21:42,-8850,50150
99,3054935,10,89900,0,96.0,113,2023-04-26T21:42,0,89900
100,1790383,11,54700,86000,95.0,5944,2023-04-26T21:42,-8205,46495
101,1139192,12,66400,94900,97.0,14563,2023-04-26T21:42,-9960,56440
102,2732486,13,99000,179000,98.0,860,2023-04-26T21:42,0,99000
103,2375909,14,76390,89900,98.0,1680,2023-04-26T21:42,0,76390
104,2184466,15,359000,0,98.0,34,2023-04-26T21:42,0,359000
105,1683384,16,599000,0,99.0,27,2023-04-26T21:42,0,599000
106,1108007,17,67890,79900,95.0,48044,2023-04-26T21:42,0,67890
107,2343198,18,119000,129000,97.0,5350,2023-04-26T21:42,-17850,101150
108,2061715,19,79900,105000,97.0,2873,2023-04-26T21:42,0,79900
109,1737051,20,62300,89000,96.0,5202,2023-04-26T21:42,-12460,49840
110,1778408,21,39000,45000,95.0,11987,2023-04-26T21:42,-5850,33150
111,2444808,22,75490,83900,97.0,733,2023-04-26T21:42,0,75490
112,2788216,23,146000,159000,98.0,210,2023-04-26T21:42,-21900,124100
113,3247941,24,134100,149000,0.0,0,2023-04-26T21:42,-20115,113985
114,2329533,25,119200,149000,97.0,1442,2023-04-26T21:42,0,119200
115,3029811,26,63200,79000,96.0,338,2023-04-26T21:42,-12640,50560
116,3100493,27,139000,0,97.0,97,2023-04-26T21:42,0,139000
117,1530516,28,69900,79000,96.0,2531,2023-04-26T21:42,0,69900
118,3092774,29,139900,0,96.0,16,2023-04-26T21:42,-20985,118915
119,2343199,30,119000,129000,98.0,1953,2023-04-26T21:42,-17850,101150
120,3037468,31,39700,68500,97.0,112,2023-04-26T21:42,0,39700
121,1618312,32,83900,0,97.0,7318,2023-04-26T21:42,-8390,75510
122,2330481,33,210800,248000,97.0,149,2023-04-26T21:42,-31620,179180
123,1576700,34,89000,129000,97.0,17180,2023-04-26T21:42,-13350,75650
124,1530517,35,69900,79000,96.0,2258,2023-04-26T21:42,0,69900
125,2471405,36,89000,138000,97.0,2244,2023-04-26T21:42,0,89000
126,3033224,37,59900,74000,97.0,914,2023-04-26T21:42,0,59900
127,3048144,38,109200,182000,96.0,255,2023-04-26T21:42,-21840,87360
128,946995,39,106250,125000,94.0,2919,2023-04-26T21:42,-15938,90312
129,3055246,40,159000,0,97.0,94,2023-04-26T21:42,0,159000
130,2381781,41,174300,249000,98.0,878,2023-04-26T21:42,0,174300
131,2752332,42,84200,105300,95.0,2741,2023-04-26T21:42,-12630,71570
132,2288426,43,69000,109000,94.0,875,2023-04-26T21:42,-10350,58650
133,2403367,44,146000,0,97.0,705,2023-04-26T21:42,-21900,124100
134,3148717,45,87900,0,100.0,2,2023-04-26T21:42,0,87900
135,1833230,46,95200,136000,97.0,5537,2023-04-26T21:42,-14280,80920
136,3046899,47,79900,105000,97.0,156,2023-04-26T21:42,0,79900
137,1776365,48,53400,89000,96.0,4708,2023-04-26T21:42,-8010,45390
138,3244733,49,268000,0,0.0,0,2023-04-26T21:42,-13400,254600
139,1751722,50,53910,59900,97.0,3562,2023-04-26T21:42,-10782,43128
140,2670700,51,268200,298000,98.0,1257,2023-04-26T21:42,-40230,227970
141,2284220,52,79900,112900,96.0,1762,2023-04-26T21:42,0,79900
142,2723216,53,69900,85900,97.0,1275,2023-04-26T21:42,-10485,59415
143,3253765,54,79000,99000,0.0,0,2023-04-26T21:42,-11850,67150
144,2407203,55,148500,165000,97.0,346,2023-04-26T21:42,0,148500
145,3037477,56,69900,85900,97.0,349,2023-04-26T21:42,-10485,59415
146,3092775,57,139900,0,100.0,6,2023-04-26T21:42,-20985,118915
147,1558683,58,69590,81900,97.0,6375,2023-04-26T21:42,0,69590
148,2683549,59,104300,149000,97.0,2653,2023-04-26T21:42,0,104300
149,2857329,60,790000,0,92.0,101,2023-04-26T21:42,0,790000
150,1272812,61,62300,89000,96.0,2837,2023-04-26T21:42,-12460,49840
151,3209862,62,89000,111500,98.0,10,2023-04-26T21:42,-8900,80100
152,2100438,63,59890,79900,97.0,3825,2023-04-26T21:42,0,59890
153,2572705,64,168300,198000,96.0,75,2023-04-26T21:42,-28611,139689
154,3209863,65,89000,111500,95.0,9,2023-04-26T21:42,-8900,80100
155,2891213,66,56700,189000,96.0,203,2023-04-26T21:42,0,56700
156,3082210,67,359000,0,98.0,14,2023-04-26T21:42,0,359000
157,3092776,68,139900,0,100.0,3,2023-04-26T21:42,-20985,118915
158,3137506,69,54000,72000,97.0,65,2023-04-26T21:42,-2700,51300
159,2668986,70,35910,39900,96.0,3738,2023-04-26T21:42,-7182,28728
160,2159724,71,29900,32000,95.0,2496,2023-04-26T21:42,0,29900
161,2357957,72,104300,149000,97.0,2273,2023-04-26T21:42,0,104300
162,2116235,73,118300,169000,100.0,9,2023-04-26T21:42,0,118300
163,3046674,74,59900,79000,96.0,250,2023-04-26T21:42,-8985,50915
164,3033083,75,69760,109000,97.0,76,2023-04-26T21:42,0,69760
165,2712632,76,107000,0,97.0,1419,2023-04-26T21:42,0,107000
166,3051261,77,53400,89000,97.0,168,2023-04-26T21:42,-10680,42720
167,2053138,78,146000,159000,97.0,722,2023-04-26T21:42,-21900,124100
168,3100486,79,139000,0,97.0,28,2023-04-26T21:42,0,139000
169,1776549,80,59000,69000,94.0,4667,2023-04-26T21:42,-8850,50150
170,3243036,81,278000,0,0.0,0,2023-04-26T21:42,-13900,264100
171,1195307,82,87550,103000,96.0,12816,2023-04-26T21:42,-13133,74417
172,1291017,83,67900,96000,95.0,13212,2023-04-26T21:42,0,67900
173,2702015,84,59400,99000,95.0,755,2023-04-26T21:42,-8910,50490
174,1762727,85,142400,178000,97.0,839,2023-04-26T21:42,0,142400
175,3030665,86,139200,174000,95.0,307,2023-04-26T21:42,-20880,118320
176,1567183,87,71175,94900,97.0,7545,2023-04-26T21:42,-10677,60498
177,3010527,88,181350,279000,97.0,295,2023-04-26T21:42,0,181350
178,3037473,89,69900,85900,95.0,402,2023-04-26T21:42,-10485,59415
179,3179681,90,298000,0,0.0,0,2023-04-26T21:42,0,298000
180,2112059,1,36400,52000,97.0,44450,2023-04-26T21:42,-5460,30940
181,1168906,2,35590,41900,97.0,72117,2023-04-26T21:42,0,35590
182,750908,3,34900,54000,96.0,85139,2023-04-26T21:42,-3490,31410
183,2060719,4,55200,69000,96.0,5672,2023-04-26T21:42,-5520,49680
184,1551840,5,35100,39000,97.0,85235,2023-04-26T21:42,0,35100
185,1149329,6,39900,0,96.0,87160,2023-04-26T21:42,0,39900
186,3138553,7,49900,88000,93.0,62,2023-04-26T21:42,0,49900
187,1573215,8,111000,148000,98.0,9666,2023-04-26T21:42,-16650,94350
188,1926048,9,32000,0,97.0,15231,2023-04-26T21:42,-1600,30400
189,2060717,10,55200,69000,95.0,4155,2023-04-26T21:42,-5520,49680
190,2112061,11,36400,52000,97.0,15410,2023-04-26T21:42,-5460,30940
191,2092852,12,42000,52800,96.0,11722,2023-04-26T21:42,-4200,37800
192,1149328,13,35890,39900,96.0,95013,2023-04-26T21:42,0,35890
193,1924274,14,49900,66000,95.0,22876,2023-04-26T21:42,-4990,44910
194,858911,15,39000,49000,95.0,67512,2023-04-26T21:42,-5850,33150
195,2060720,16,55200,69000,95.0,2756,2023-04-26T21:42,-5520,49680
196,3242780,17,156000,0,0.0,0,2023-04-26T21:42,-7800,148200
197,1370101,18,39000,89000,96.0,23764,2023-04-26T21:42,-1950,37050
198,2569078,19,59250,79000,96.0,2577,2023-04-26T21:42,-8888,50362
199,3086712,20,41900,85000,96.0,61,2023-04-26T21:42,-4190,37710
200,2150457,21,119250,159000,97.0,4169,2023-04-26T21:42,-17888,101362
201,1436504,22,41900,0,96.0,9369,2023-04-26T21:42,0,41900
202,1440874,23,39900,0,95.0,15296,2023-04-26T21:42,0,39900
203,1568057,24,49600,62000,96.0,22930,2023-04-26T21:42,-7440,42160
204,2789091,25,79200,99000,97.0,1062,2023-04-26T21:42,-11880,67320
205,1551839,26,39000,0,97.0,24240,2023-04-26T21:42,0,39000
206,1222184,27,37690,41900,97.0,48897,2023-04-26T21:42,0,37690
207,2358429,28,111300,159000,98.0,2704,2023-04-26T21:42,0,111300
208,3252638,29,59800,86000,100.0,9,2023-04-26T21:42,-5980,53820
209,2723714,30,46400,58000,96.0,1868,2023-04-26T21:42,0,46400
210,2441851,31,35900,41900,96.0,3566,2023-04-26T21:42,-5385,30515
211,2028327,32,42390,49900,96.0,9545,2023-04-26T21:42,0,42390
212,3242782,33,156000,0,0.0,0,2023-04-26T21:42,-7800,148200
213,3101580,34,156000,0,97.0,91,2023-04-26T21:42,0,156000
214,1552753,35,70200,78000,97.0,28455,2023-04-26T21:42,-10530,59670
215,1555407,36,70200,78000,97.0,11844,2023-04-26T21:42,-10530,59670
216,2351467,37,29000,54000,96.0,6817,2023-04-26T21:42,0,29000
217,2789111,38,79200,99000,97.0,1081,2023-04-26T21:42,-11880,67320
218,1323090,39,73600,92000,96.0,6169,2023-04-26T21:42,-14720,58880
219,1885631,40,39000,49000,96.0,23973,2023-04-26T21:42,-5850,33150
220,2028326,41,49900,0,97.0,6544,2023-04-26T21:42,0,49900
221,2184087,42,47200,89000,96.0,4307,2023-04-26T21:42,-2360,44840
222,2060759,43,59800,74800,97.0,7520,2023-04-26T21:42,-5980,53820
223,3044076,44,80100,89000,97.0,71,2023-04-26T21:42,-12015,68085
224,2578996,45,27900,59000,95.0,4854,2023-04-26T21:42,0,27900
225,2495075,46,49800,72000,95.0,12318,2023-04-26T21:42,-4980,44820
226,1627892,47,43900,0,97.0,11606,2023-04-26T21:42,0,43900
227,1926034,48,32000,0,97.0,3250,2023-04-26T21:42,-1600,30400
228,2060743,49,33000,55000,95.0,3789,2023-04-26T21:42,-3300,29700
229,3138551,50,29900,44000,97.0,23,2023-04-26T21:42,-4485,25415
230,3037465,51,45500,56900,95.0,409,2023-04-26T21:42,-6825,38675
231,2569079,52,59250,79000,96.0,1206,2023-04-26T21:42,-8888,50362
232,1826978,53,79000,0,96.0,7093,2023-04-26T21:42,-11850,67150
233,3242776,54,156000,0,0.0,0,2023-04-26T21:42,-7800,148200
234,1985223,55,39000,89000,96.0,1778,2023-04-26T21:42,-1950,37050
235,2107115,56,98500,135000,98.0,11840,2023-04-26T21:42,-14775,83725
236,1168922,57,39490,43900,96.0,18481,2023-04-26T21:42,0,39490
237,1246215,58,49000,65000,96.0,6470,2023-04-26T21:42,-9800,39200
238,2725611,59,89600,128000,98.0,2316,2023-04-26T21:42,-13440,76160
239,2281982,60,84200,99000,98.0,584,2023-04-26T21:42,-16840,67360
240,763134,61,16690,23900,95.0,24377,2023-04-26T21:42,-2504,14186
241,2742472,62,121500,135000,99.0,111,2023-04-26T21:42,-18225,103275
242,573121,63,67900,93700,95.0,13867,2023-04-26T21:42,-10185,57715
243,1666442,64,49900,0,97.0,11131,2023-04-26T21:42,0,49900
244,3101581,65,156000,0,97.0,42,2023-04-26T21:42,0,156000
245,3134710,66,79900,0,98.0,17,2023-04-26T21:42,-11985,67915
246,1436218,67,39900,68000,95.0,19856,2023-04-26T21:42,-3990,35910
247,890521,68,39800,63000,94.0,11451,2023-04-26T21:42,0,39800
248,1736085,69,39900,59800,96.0,37615,2023-04-26T21:42,0,39900
249,3043508,70,71200,89000,97.0,334,2023-04-26T21:42,0,71200
250,2503133,71,42000,52800,96.0,3236,2023-04-26T21:42,-4200,37800
251,3098372,72,89000,139000,97.0,1221,2023-04-26T21:42,0,89000
252,3129951,73,39800,49800,98.0,74,2023-04-26T21:42,-3980,35820
253,2749153,74,66600,74000,97.0,688,2023-04-26T21:42,0,66600
254,3141395,75,49900,73900,97.0,251,2023-04-26T21:42,0,49900
255,3034871,76,88200,126000,97.0,223,2023-04-26T21:42,0,88200
256,1985224,77,39000,89000,96.0,1961,2023-04-26T21:42,-1950,37050
257,3047556,78,64860,69000,98.0,82,2023-04-26T21:42,-6486,58374
258,2562527,79,29400,42000,97.0,4347,2023-04-26T21:42,-4410,24990
259,2053437,80,159000,0,100.0,10,2023-04-26T21:42,0,159000
260,2131950,81,39000,49000,96.0,4246,2023-04-26T21:42,-5850,33150
261,3154699,82,49800,63000,97.0,217,2023-04-26T21:42,0,49800
262,2402843,83,39900,0,96.0,1372,2023-04-26T21:42,0,39900
263,1989228,84,43900,0,97.0,5557,2023-04-26T21:42,0,43900
264,978464,85,63960,78000,94.0,58648,2023-04-26T21:42,-9594,54366
265,2574822,86,19900,27800,96.0,1838,2023-04-26T21:42,0,19900
266,1037219,87,83300,119000,95.0,29503,2023-04-26T21:42,-12495,70805
267,3070909,88,139000,0,98.0,32,2023-04-26T21:42,0,139000
268,2028329,89,42390,49900,96.0,6746,2023-04-26T21:42,0,42390
269,2402805,90,29900,0,97.0,575,2023-04-26T21:42,-4485,25415
270,1034480,1,135000,150000,97.0,18355,2023-04-26T21:42,0,135000
271,1740936,2,39000,0,97.0,1782,2023-04-26T21:42,0,39000
272,1969507,3,88000,0,98.0,5623,2023-04-26T21:42,0,88000
273,1789507,4,71100,79000,98.0,26385,2023-04-26T21:42,0,71100
274,2800608,5,1324350,2671000,100.0,2,2023-04-26T21:42,0,1324350
275,2235274,6,145000,0,98.0,799,2023-04-26T21:42,0,145000
276,2770508,7,138000,0,97.0,378,2023-04-26T21:42,0,138000
277,2992124,8,2403000,3090000,0.0,0,2023-04-26T21:42,0,2403000
278,2702033,9,127200,159000,97.0,465,2023-04-26T21:42,0,127200
279,1835080,10,98000,0,97.0,2952,2023-04-26T21:42,0,98000
280,2902216,11,518000,700000,99.0,27,2023-04-26T21:42,-20000,498000
281,2320927,12,39000,51000,97.0,2431,2023-04-26T21:42,0,39000
282,3101111,13,161100,179000,95.0,63,2023-04-26T21:42,0,161100
283,2344538,14,119000,0,98.0,6618,2023-04-26T21:42,0,119000
284,1264107,15,62000,90000,97.0,6564,2023-04-26T21:42,-9300,52700
285,1564343,16,92800,119000,98.0,8203,2023-04-26T21:42,-13920,78880
286,2066837,17,69000,119000,97.0,6688,2023-04-26T21:42,-10350,58650
287,2657250,18,125400,149000,98.0,159,2023-04-26T21:42,0,125400
288,2654166,19,82000,108000,95.0,165,2023-04-26T21:42,-12300,69700
289,1969488,20,88000,0,98.0,1848,2023-04-26T21:42,0,88000
290,3047568,21,99330,129000,96.0,117,2023-04-26T21:42,0,99330
291,2514819,22,54000,66000,97.0,939,2023-04-26T21:42,0,54000
292,3061872,23,89000,0,95.0,73,2023-04-26T21:42,0,89000
293,1842449,24,84000,99000,97.0,5550,2023-04-26T21:42,-16800,67200
294,2105328,25,55300,79000,97.0,574,2023-04-26T21:42,-8295,47005
295,342189,26,39500,52000,95.0,15927,2023-04-26T21:42,0,39500
296,3034751,27,64800,72000,96.0,698,2023-04-26T21:42,0,64800
297,1456515,28,49500,55000,97.0,8847,2023-04-26T21:42,-7425,42075
298,3174244,29,1580000,2610000,0.0,0,2023-04-26T21:42,0,1580000
299,3038000,30,74700,83000,96.0,554,2023-04-26T21:42,0,74700
300,913402,31,83300,98000,95.0,8138,2023-04-26T21:42,-16660,66640
301,2954961,32,95000,0,96.0,397,2023-04-26T21:42,0,95000
302,2757112,33,359000,0,93.0,113,2023-04-26T21:42,-71800,287200
303,1744101,34,103500,109000,98.0,2961,2023-04-26T21:42,0,103500
304,2558648,35,119000,0,98.0,1372,2023-04-26T21:42,0,119000
305,2911057,36,1839000,3820000,0.0,0,2023-04-26T21:42,0,1839000
306,2577899,37,138000,0,98.0,368,2023-04-26T21:42,0,138000
307,2343665,38,89000,0,97.0,4766,2023-04-26T21:42,0,89000
308,2630526,39,100000,0,96.0,727,2023-04-26T21:42,0,100000
309,2408317,40,145800,162000,96.0,425,2023-04-26T21:42,0,145800
310,2422175,41,145800,162000,98.0,240,2023-04-26T21:42,-21870,123930
311,1910358,42,99000,0,98.0,2575,2023-04-26T21:42,-14850,84150
312,2271789,43,71100,79000,97.0,2638,2023-04-26T21:42,0,71100
313,3034749,44,64800,72000,97.0,577,2023-04-26T21:42,0,64800
314,2584181,45,57600,72000,99.0,1245,2023-04-26T21:42,0,57600
315,2325729,46,87200,109000,97.0,843,2023-04-26T21:42,-13080,74120
316,3149665,47,98000,0,93.0,26,2023-04-26T21:42,-14700,83300
317,3029926,48,285000,0,99.0,77,2023-04-26T21:42,0,285000
318,3034745,49,75600,84000,98.0,241,2023-04-26T21:42,0,75600
319,3070516,50,138000,0,97.0,56,2023-04-26T21:42,0,138000
320,2537631,51,388000,0,100.0,24,2023-04-26T21:42,-77600,310400
321,1581689,52,75600,89000,97.0,4129,2023-04-26T21:42,0,75600
322,693318,53,75000,110000,96.0,13302,2023-04-26T21:42,-11250,63750
323,2344540,54,96000,0,98.0,9518,2023-04-26T21:42,0,96000
324,2888946,55,79000,0,98.0,214,2023-04-26T21:42,0,79000
325,1447194,56,59900,230000,96.0,2982,2023-04-26T21:42,-2995,56905
326,1758217,57,43900,56000,97.0,13266,2023-04-26T21:42,-4390,39510
327,2914920,58,369000,439000,100.0,8,2023-04-26T21:42,0,369000
328,2827289,59,1457000,2890000,100.0,3,2023-04-26T21:42,0,1457000
329,2754080,60,88000,0,97.0,540,2023-04-26T21:42,0,88000
330,3048786,61,1458000,3050000,93.0,3,2023-04-26T21:42,0,1458000
331,2930265,62,91000,0,98.0,672,2023-04-26T21:42,0,91000
332,2668407,63,1416000,2950000,100.0,2,2023-04-26T21:42,0,1416000
333,1597319,64,89100,99000,97.0,652,2023-04-26T21:42,-4455,84645
334,2110431,65,129000,0,95.0,36,2023-04-26T21:42,0,129000
335,3121729,66,98100,109000,0.0,0,2023-04-26T21:42,0,98100
336,1884626,67,36800,46000,97.0,5024,2023-04-26T21:42,0,36800
337,1528287,68,46500,49000,96.0,4770,2023-04-26T21:42,0,46500
338,2918357,69,238000,268000,96.0,20,2023-04-26T21:42,0,238000
339,2245910,70,46000,69000,95.0,833,2023-04-26T21:42,0,46000
340,1453531,71,53000,59000,96.0,3045,2023-04-26T21:42,0,53000
341,2279619,72,80100,89000,97.0,503,2023-04-26T21:42,0,80100
342,1320752,73,67800,135000,97.0,4816,2023-04-26T21:42,0,67800
343,3029905,74,395000,0,99.0,56,2023-04-26T21:42,0,395000
344,2789786,75,150100,158000,97.0,285,2023-04-26T21:42,0,150100
345,1736022,76,169200,188000,96.0,480,2023-04-26T21:42,0,169200
346,3142243,77,220000,0,97.0,21,2023-04-26T21:42,-11000,209000
347,1263004,78,159000,0,97.0,5293,2023-04-26T21:42,0,159000
348,2333662,79,48300,69000,95.0,47,2023-04-26T21:42,-7245,41055
349,3231360,80,109000,0,0.0,0,2023-04-26T21:42,0,109000
350,2305287,81,66310,69800,98.0,1089,2023-04-26T21:42,0,66310
351,3029922,82,295000,0,97.0,118,2023-04-26T21:42,0,295000
352,3045584,83,130500,145000,97.0,3816,2023-04-26T21:42,0,130500
353,2668827,84,95200,119000,98.0,587,2023-04-26T21:42,-14280,80920
354,1534526,85,52200,55000,97.0,2555,2023-04-26T21:42,0,52200
355,2914924,86,369000,439000,97.0,18,2023-04-26T21:42,0,369000
356,1493177,87,198000,0,97.0,1905,2023-04-26T21:42,-29700,168300
357,2131513,88,399000,0,99.0,128,2023-04-26T21:42,0,399000
358,2537628,89,388000,0,98.0,40,2023-04-26T21:42,-77600,310400
359,2944049,90,391000,0,93.0,3,2023-04-26T21:42,-20000,371000
360,1762406,1,260000,0,98.0,3553,2023-04-26T21:42,0,260000
361,2638067,2,99000,139000,97.0,3366,2023-04-26T21:42,0,99000
362,969541,3,69000,0,97.0,30508,2023-04-26T21:42,0,69000
363,1762407,4,260000,0,97.0,3561,2023-04-26T21:42,0,260000
364,2545799,5,149000,0,98.0,2403,2023-04-26T21:42,0,149000
365,810034,6,85500,95000,97.0,45524,2023-04-26T21:42,0,85500
366,490136,7,56900,95000,98.0,2789,2023-04-26T21:42,0,56900
367,2293400,8,129000,0,96.0,1123,2023-04-26T21:42,0,129000
368,311052,9,53100,59000,97.0,41573,2023-04-26T21:42,0,53100
369,3026310,10,99000,0,99.0,1021,2023-04-26T21:42,0,99000
370,1473136,11,79900,149000,97.0,10828,2023-04-26T21:42,0,79900
371,3030422,12,117900,139000,97.0,963,2023-04-26T21:42,0,117900
372,181907,13,79900,119000,97.0,7297,2023-04-26T21:42,0,79900
373,816033,14,57900,89000,96.0,13501,2023-04-26T21:42,0,57900
374,2741233,15,109000,0,97.0,2874,2023-04-26T21:42,-10900,98100
375,810033,16,89100,99000,97.0,34416,2023-04-26T21:42,0,89100
376,2161992,17,55900,95000,97.0,3568,2023-04-26T21:42,0,55900
377,810032,18,85500,95000,97.0,13855,2023-04-26T21:42,0,85500
378,186610,19,75900,85000,97.0,16799,2023-04-26T21:42,0,75900
379,577636,20,97300,139000,95.0,31378,2023-04-26T21:42,0,97300
380,2383963,21,139000,0,96.0,181,2023-04-26T21:42,0,139000
381,2565212,22,119000,0,99.0,471,2023-04-26T21:42,0,119000
382,2899656,23,59900,159000,96.0,140,2023-04-26T21:42,0,59900
383,3033248,24,109000,0,97.0,773,2023-04-26T21:42,-10900,98100
384,2731878,25,44900,79000,97.0,2003,2023-04-26T21:42,0,44900
385,2355071,26,265000,0,98.0,548,2023-04-26T21:42,0,265000
386,3091287,27,119000,0,98.0,420,2023-04-26T21:42,0,119000
387,1622068,28,119000,0,97.0,6931,2023-04-26T21:42,0,119000
388,2577087,29,89900,139000,97.0,441,2023-04-26T21:42,0,89900
389,1883698,30,139000,0,95.0,87,2023-04-26T21:42,0,139000
390,2622254,31,109000,0,98.0,997,2023-04-26T21:42,0,109000
391,2430426,32,169000,0,98.0,790,2023-04-26T21:42,0,169000
392,3096431,33,139000,0,98.0,78,2023-04-26T21:42,0,139000
393,1296778,34,99000,0,98.0,2229,2023-04-26T21:42,0,99000
394,716244,35,59900,95000,98.0,1412,2023-04-26T21:42,0,59900
395,3172975,36,260000,0,98.0,23,2023-04-26T21:42,0,260000
396,2861393,37,96900,139000,93.0,323,2023-04-26T21:42,0,96900
397,695334,38,63900,99000,96.0,9646,2023-04-26T21:42,0,63900
398,2233180,39,75900,109000,97.0,14537,2023-04-26T21:42,0,75900
399,2785168,40,179000,0,99.0,92,2023-04-26T21:42,0,179000
400,102618,41,69000,0,97.0,6163,2023-04-26T21:42,0,69000
401,1493265,42,85500,95000,98.0,5048,2023-04-26T21:42,0,85500
402,1470186,43,49900,75000,97.0,3009,2023-04-26T21:42,0,49900
403,3079037,44,195000,0,98.0,335,2023-04-26T21:42,0,195000
404,1469860,45,51900,75000,97.0,6854,2023-04-26T21:42,0,51900
405,2670201,46,39900,109000,97.0,1102,2023-04-26T21:42,0,39900
406,2733049,47,42900,119000,96.0,616,2023-04-26T21:42,0,42900
407,2899664,48,60420,159000,97.0,148,2023-04-26T21:42,0,60420
408,1608838,49,85000,0,97.0,12722,2023-04-26T21:42,0,85000
409,1863222,50,150000,0,96.0,75,2023-04-26T21:42,0,150000
410,3206999,51,159000,0,99.0,55,2023-04-26T21:42,0,159000
411,2233178,52,75900,109000,97.0,5107,2023-04-26T21:42,0,75900
412,1494180,53,71100,79000,95.0,5326,2023-04-26T21:42,0,71100
413,1900410,54,129000,0,97.0,4995,2023-04-26T21:42,0,129000
414,2493214,55,169000,0,98.0,226,2023-04-26T21:42,0,169000
415,3109771,56,133900,149000,98.0,60,2023-04-26T21:42,0,133900
416,3081253,57,112900,129000,95.0,108,2023-04-26T21:42,0,112900
417,2631192,58,98100,109000,98.0,470,2023-04-26T21:42,0,98100
418,3200836,59,179000,0,97.0,75,2023-04-26T21:42,0,179000
419,2909715,60,119000,0,96.0,132,2023-04-26T21:42,0,119000
420,311050,61,53100,59000,97.0,9157,2023-04-26T21:42,0,53100
421,102620,62,69000,0,97.0,18098,2023-04-26T21:42,0,69000
422,2320478,63,129000,0,97.0,594,2023-04-26T21:42,0,129000
423,1296776,64,99000,0,98.0,3008,2023-04-26T21:42,0,99000
424,2524840,65,139000,0,97.0,921,2023-04-26T21:42,0,139000
425,1231944,66,119000,0,97.0,1444,2023-04-26T21:42,0,119000
426,1493263,67,89100,99000,98.0,4315,2023-04-26T21:42,0,89100
427,1868015,68,129000,0,97.0,1990,2023-04-26T21:42,0,129000
428,2899663,69,69900,159000,94.0,59,2023-04-26T21:42,0,69900
429,1900420,70,129000,0,96.0,1532,2023-04-26T21:42,0,129000
430,2266983,71,85500,95000,98.0,506,2023-04-26T21:42,0,85500
431,2440110,72,56900,59900,97.0,1364,2023-04-26T21:42,-8535,48365
432,2861392,73,96900,139000,97.0,651,2023-04-26T21:42,0,96900
433,2261769,74,42900,119000,95.0,1382,2023-04-26T21:42,0,42900
434,3072685,75,106900,119000,97.0,54,2023-04-26T21:42,0,106900
435,2786813,76,149000,0,94.0,247,2023-04-26T21:42,0,149000
436,490135,77,59900,95000,98.0,3529,2023-04-26T21:42,0,59900
437,2801307,78,424000,700000,98.0,71,2023-04-26T21:42,0,424000
438,3122130,79,219000,0,100.0,31,2023-04-26T21:42,0,219000
439,2815897,80,59950,109000,94.0,119,2023-04-26T21:42,0,59950
440,2622252,81,109000,0,97.0,260,2023-04-26T21:42,0,109000
441,1729744,82,76500,85000,97.0,3416,2023-04-26T21:42,0,76500
442,2297397,83,129000,0,96.0,236,2023-04-26T21:42,0,129000
443,1594352,84,85000,0,97.0,5647,2023-04-26T21:42,0,85000
444,1955217,85,69000,109000,96.0,5352,2023-04-26T21:42,-10350,58650
445,1354129,86,69000,99000,95.0,8788,2023-04-26T21:42,-10350,58650
446,311051,87,58500,65000,97.0,19680,2023-04-26T21:42,0,58500
447,1376278,88,51800,74000,95.0,2000,2023-04-26T21:42,-7770,44030
448,2918213,89,129000,0,96.0,267,2023-04-26T21:42,0,129000
449,2229208,90,109000,0,97.0,1653,2023-04-26T21:42,0,109000
450,3224811,1,138000,0,0.0,0,2023-04-26T21:42,0,138000
451,1092992,2,69000,0,97.0,38572,2023-04-26T21:42,0,69000
452,1720822,3,209000,0,97.0,327,2023-04-26T21:42,-12540,196460
453,3062046,4,78300,87000,97.0,310,2023-04-26T21:42,-3915,74385
454,3124961,5,65550,69000,97.0,409,2023-04-26T21:42,-3278,62272
455,3134621,6,136800,152000,97.0,60,2023-04-26T21:42,-6840,129960
456,2624538,7,34810,59000,97.0,1652,2023-04-26T21:42,0,34810
457,3134606,8,125100,139000,97.0,81,2023-04-26T21:42,-6255,118845
458,2237841,9,195000,0,98.0,73,2023-04-26T21:42,-11700,183300
459,2091749,10,75650,89000,95.0,6411,2023-04-26T21:42,0,75650
460,1568047,11,127200,159000,95.0,12091,2023-04-26T21:42,-19080,108120
461,2101924,12,99900,0,96.0,1430,2023-04-26T21:42,0,99900
462,3061996,13,88200,98000,97.0,230,2023-04-26T21:42,-4410,83790
463,1334438,14,170000,0,96.0,4469,2023-04-26T21:42,0,170000
464,2432733,15,40120,59000,97.0,2992,2023-04-26T21:42,0,40120
465,3223241,16,119000,0,98.0,33,2023-04-26T21:42,0,119000
466,2816812,17,119900,0,93.0,1598,2023-04-26T21:42,0,119900
467,2320704,18,24500,49000,96.0,261,2023-04-26T21:42,0,24500
468,1129750,19,69000,0,97.0,4007,2023-04-26T21:42,0,69000
469,2664372,20,65000,0,97.0,1158,2023-04-26T21:42,0,65000
470,2664373,21,65000,0,97.0,1131,2023-04-26T21:42,0,65000
471,501198,22,132000,139000,95.0,2765,2023-04-26T21:42,-6600,125400
472,1339622,23,42900,59000,97.0,16534,2023-04-26T21:42,0,42900
473,595040,24,210000,0,95.0,8775,2023-04-26T21:42,0,210000
474,1730340,25,232200,258000,97.0,4293,2023-04-26T21:42,0,232200
475,3062069,26,71100,79000,96.0,117,2023-04-26T21:42,-3555,67545
476,595039,27,210000,0,97.0,3568,2023-04-26T21:42,0,210000
477,3134563,28,88200,98000,96.0,45,2023-04-26T21:42,-4410,83790
478,1419869,29,70300,74000,95.0,10604,2023-04-26T21:42,-10545,59755
479,1439535,30,49000,0,96.0,16412,2023-04-26T21:42,0,49000
480,1891201,31,155000,0,98.0,238,2023-04-26T21:42,-9300,145700
481,2093156,32,259000,0,91.0,27,2023-04-26T21:42,0,259000
482,3161736,33,67900,158000,98.0,332,2023-04-26T21:42,-10185,57715
483,2433538,34,84660,102000,96.0,2512,2023-04-26T21:42,0,84660
484,3218310,35,141550,149000,100.0,2,2023-04-26T21:42,-8493,133057
485,1828166,36,126000,210000,94.0,861,2023-04-26T21:42,0,126000
486,1438359,37,99000,0,97.0,1232,2023-04-26T21:42,0,99000
487,1699941,38,67150,79000,97.0,4970,2023-04-26T21:42,-10073,57077
488,2419871,39,40120,59000,97.0,1002,2023-04-26T21:42,0,40120
489,2621831,40,64400,92000,95.0,797,2023-04-26T21:42,-9660,54740
490,2071613,41,89100,99000,92.0,1518,2023-04-26T21:42,-13365,75735
491,3050950,42,78400,98000,98.0,11,2023-04-26T21:42,-3920,74480
492,3113998,43,188100,209000,80.0,1,2023-04-26T21:42,-18810,169290
493,2816816,44,127890,159900,97.0,1911,2023-04-26T21:42,0,127890
494,2736221,45,99000,110000,96.0,317,2023-04-26T21:42,0,99000
495,127121,46,141000,152000,95.0,1886,2023-04-26T21:42,-21150,119850
496,2114454,47,478000,0,97.0,117,2023-04-26T21:42,0,478000
497,2143833,48,89640,108000,96.0,2471,2023-04-26T21:42,0,89640
498,3167199,49,174250,205000,100.0,3,2023-04-26T21:42,0,174250
499,1890398,50,132000,168000,96.0,2797,2023-04-26T21:42,-13200,118800
500,2518112,51,87150,105000,96.0,1022,2023-04-26T21:42,0,87150
501,1813898,52,219000,0,98.0,38,2023-04-26T21:42,0,219000
502,1815709,53,132000,168000,96.0,7198,2023-04-26T21:42,-13200,118800
503,3097625,54,95000,0,98.0,34,2023-04-26T21:42,0,95000
504,3142574,55,132300,189000,100.0,9,2023-04-26T21:42,0,132300
505,1334440,56,102000,170000,96.0,2076,2023-04-26T21:42,0,102000
506,3008041,57,44900,59000,98.0,244,2023-04-26T21:42,0,44900
507,1903234,58,126000,168000,95.0,990,2023-04-26T21:42,-18900,107100
508,2210201,59,268000,299000,94.0,199,2023-04-26T21:42,-13400,254600
509,1928038,60,84600,94000,96.0,1201,2023-04-26T21:42,-12690,71910
510,2919223,61,826000,1470000,0.0,0,2023-04-26T21:42,-20000,806000
511,1562988,62,260000,0,97.0,1490,2023-04-26T21:42,0,260000
512,3217612,63,265500,295000,0.0,0,2023-04-26T21:42,0,265500
513,1021359,64,61000,100000,94.0,5415,2023-04-26T21:42,-9150,51850
514,2440524,65,69000,0,97.0,1672,2023-04-26T21:42,0,69000
515,1439527,66,49000,0,95.0,13468,2023-04-26T21:42,0,49000
516,607298,67,44700,59000,93.0,15627,2023-04-26T21:42,-6705,37995
517,2363570,68,39900,55000,97.0,1184,2023-04-26T21:42,0,39900
518,2741208,69,98890,109900,96.0,194,2023-04-26T21:42,0,98890
519,1562990,70,230000,0,96.0,1292,2023-04-26T21:42,0,230000
520,2972873,71,65000,0,99.0,108,2023-04-26T21:42,0,65000
521,3142573,72,132300,189000,84.0,5,2023-04-26T21:42,0,132300
522,1810760,73,135000,150000,96.0,208,2023-04-26T21:42,0,135000
523,2910082,74,265500,295000,98.0,530,2023-04-26T21:42,0,265500
524,636821,75,160500,169000,93.0,2592,2023-04-26T21:42,-24075,136425
525,3050953,76,78400,98000,100.0,13,2023-04-26T21:42,-3920,74480
526,2383245,77,99000,0,98.0,936,2023-04-26T21:42,0,99000
527,3049313,78,57100,64900,97.0,846,2023-04-26T21:42,0,57100
528,2355318,79,98890,109900,96.0,674,2023-04-26T21:42,0,98890
529,3103382,80,65000,0,97.0,27,2023-04-26T21:42,0,65000
530,2069832,81,298000,332000,95.0,785,2023-04-26T21:42,-14900,283100
531,3124959,82,55100,58000,97.0,82,2023-04-26T21:42,-2755,52345
532,499301,83,200000,0,95.0,641,2023-04-26T21:42,0,200000
533,1888913,84,198550,209000,95.0,36,2023-04-26T21:42,-11913,186637
534,2435822,85,94500,99000,97.0,303,2023-04-26T21:42,0,94500
535,1891202,86,165000,0,98.0,107,2023-04-26T21:42,-9900,155100
536,3167201,87,186150,219000,90.0,4,2023-04-26T21:42,0,186150
537,2972872,88,65000,0,97.0,376,2023-04-26T21:42,0,65000
538,2101923,89,89890,99900,96.0,634,2023-04-26T21:42,0,89890
539,1010925,90,170000,0,96.0,2094,2023-04-26T21:42,0,170000
540,2356713,1,39000,0,97.0,1583,2023-04-26T21:42,-5850,33150
541,1214164,2,36000,0,96.0,25163,2023-04-26T21:42,0,36000
542,2280117,3,35100,39000,97.0,6578,2023-04-26T21:42,0,35100
543,2134140,4,39000,0,97.0,3736,2023-04-26T21:42,-5850,33150
544,1836699,5,79000,0,96.0,272,2023-04-26T21:42,0,79000
545,2356711,6,39000,0,97.0,1608,2023-04-26T21:42,-5850,33150
546,2879419,7,48900,55000,98.0,917,2023-04-26T21:42,-7335,41565
547,2560668,8,41400,69000,97.0,1296,2023-04-26T21:42,0,41400
548,1920929,9,39000,0,97.0,4138,2023-04-26T21:42,-5850,33150
549,2356693,10,39000,0,97.0,1589,2023-04-26T21:42,-5850,33150
550,1822717,11,56050,59000,97.0,4410,2023-04-26T21:42,0,56050
551,1272626,12,36000,0,96.0,14291,2023-04-26T21:42,0,36000
552,1214174,13,36000,0,97.0,15159,2023-04-26T21:42,0,36000
553,2028240,14,39000,0,98.0,3399,2023-04-26T21:42,-5850,33150
554,1771137,15,29000,0,97.0,12731,2023-04-26T21:42,0,29000
555,2287131,16,29600,37000,95.0,1786,2023-04-26T21:42,-4440,25160
556,1214317,17,36000,0,97.0,11583,2023-04-26T21:42,0,36000
557,1022014,18,79000,0,96.0,11512,2023-04-26T21:42,0,79000
558,3012243,19,29900,39900,99.0,95,2023-04-26T21:42,-4485,25415
559,3162825,20,280000,0,0.0,0,2023-04-26T21:42,0,280000
560,1907733,21,29900,39000,96.0,3945,2023-04-26T21:42,0,29900
561,1022013,22,79000,0,96.0,6328,2023-04-26T21:42,0,79000
562,1214173,23,36000,0,96.0,5664,2023-04-26T21:42,0,36000
563,2687157,24,45000,0,97.0,1109,2023-04-26T21:42,-6750,38250
564,1214109,25,36000,0,97.0,8249,2023-04-26T21:42,0,36000
565,2134158,26,39000,0,97.0,2617,2023-04-26T21:42,-5850,33150
566,1855444,27,39900,42000,97.0,3115,2023-04-26T21:42,-5985,33915
567,1771132,28,29000,0,96.0,5399,2023-04-26T21:42,0,29000
568,2123132,29,36900,39000,97.0,6504,2023-04-26T21:42,0,36900
569,3099126,30,54000,0,98.0,20,2023-04-26T21:42,0,54000
570,3232889,31,35010,38900,95.0,8,2023-04-26T21:42,-3501,31509
571,1771133,32,29000,0,97.0,5789,2023-04-26T21:42,0,29000
572,2864918,33,49000,0,99.0,155,2023-04-26T21:42,0,49000
573,2591291,34,39200,49000,97.0,1068,2023-04-26T21:42,0,39200
574,1214169,35,36000,0,96.0,5414,2023-04-26T21:42,0,36000
575,3185986,36,49000,0,100.0,2,2023-04-26T21:42,0,49000
576,3162833,37,190000,0,0.0,0,2023-04-26T21:42,0,190000
577,2879425,38,48900,55000,98.0,376,2023-04-26T21:42,-7335,41565
578,2381807,39,48300,69000,98.0,1185,2023-04-26T21:42,0,48300
579,2089719,40,36000,0,97.0,2475,2023-04-26T21:42,0,36000
580,2512155,41,448000,680000,0.0,0,2023-04-26T21:42,-20000,428000
581,2286829,42,31450,37000,95.0,5127,2023-04-26T21:42,-4718,26732
582,1214193,43,39000,0,97.0,15398,2023-04-26T21:42,0,39000
583,1524720,44,36000,0,96.0,3457,2023-04-26T21:42,0,36000
584,2221221,45,35100,39000,96.0,1926,2023-04-26T21:42,0,35100
585,2107999,46,36000,0,97.0,2734,2023-04-26T21:42,0,36000
586,3039061,47,33150,39000,96.0,65,2023-04-26T21:42,-4973,28177
587,3039055,48,36550,43000,96.0,80,2023-04-26T21:42,-5483,31067
588,2867785,49,9750,39000,97.0,96,2023-04-26T21:42,0,9750
589,2329375,50,34710,39000,96.0,2147,2023-04-26T21:42,0,34710
590,3099784,51,57000,0,95.0,17,2023-04-26T21:42,0,57000
591,1086824,52,29600,37000,95.0,18681,2023-04-26T21:42,0,29600
592,2164773,53,69000,0,97.0,528,2023-04-26T21:42,0,69000
593,3235222,54,35010,38900,0.0,0,2023-04-26T21:42,-3501,31509
594,1906772,55,39900,42000,97.0,3148,2023-04-26T21:42,-5985,33915
595,2234533,56,31200,39000,97.0,526,2023-04-26T21:42,0,31200
596,2859190,57,33300,37000,96.0,516,2023-04-26T21:42,-4995,28305
597,2289281,58,28500,38000,96.0,928,2023-04-26T21:42,0,28500
598,1497550,59,29600,37000,95.0,5770,2023-04-26T21:42,0,29600
599,1920840,60,39000,0,98.0,1411,2023-04-26T21:42,-5850,33150
600,1214171,61,36000,0,97.0,1746,2023-04-26T21:42,0,36000
601,2280146,62,35100,39000,97.0,976,2023-04-26T21:42,0,35100
602,2287105,63,34200,38000,95.0,1513,2023-04-26T21:42,-5130,29070
603,3225733,64,49000,0,100.0,16,2023-04-26T21:42,0,49000
604,1925814,65,35100,39000,96.0,1724,2023-04-26T21:42,0,35100
605,2476999,66,366000,565000,100.0,6,2023-04-26T21:42,-20000,346000
606,2715553,67,68000,0,95.0,284,2023-04-26T21:42,0,68000
607,1022012,68,79000,0,94.0,2804,2023-04-26T21:42,0,79000
608,1335132,69,29000,0,95.0,1141,2023-04-26T21:42,0,29000
609,3012258,70,29900,39900,98.0,52,2023-04-26T21:42,-4485,25415
610,2053753,71,42000,0,98.0,4182,2023-04-26T21:42,-6300,35700
611,1214106,72,36000,0,96.0,9811,2023-04-26T21:42,0,36000
612,2391539,73,49000,0,97.0,470,2023-04-26T21:42,0,49000
613,2149507,74,9860,29000,95.0,437,2023-04-26T21:42,0,9860
614,2531210,75,26300,35000,96.0,699,2023-04-26T21:42,-3945,22355
615,3162826,76,280000,0,0.0,0,2023-04-26T21:42,0,280000
616,2051581,77,31350,33000,96.0,888,2023-04-26T21:42,0,31350
617,2467196,78,69000,0,99.0,82,2023-04-26T21:42,0,69000
618,2432502,79,49000,0,95.0,212,2023-04-26T21:42,0,49000
619,2851288,80,9750,39000,94.0,30,2023-04-26T21:42,0,9750
620,2280141,81,35100,39000,96.0,1147,2023-04-26T21:42,0,35100
621,2416515,82,79000,0,94.0,109,2023-04-26T21:42,0,79000
622,2998516,83,29000,0,96.0,191,2023-04-26T21:42,0,29000
623,3162861,84,170000,0,0.0,0,2023-04-26T21:42,0,170000
624,3162857,85,150000,0,0.0,0,2023-04-26T21:42,0,150000
625,1214316,86,36000,0,97.0,2026,2023-04-26T21:42,0,36000
626,2157077,87,37800,42000,95.0,746,2023-04-26T21:42,-5670,32130
627,1632175,88,36900,39000,97.0,2742,2023-04-26T21:42,0,36900
628,1452917,89,69000,0,96.0,2440,2023-04-26T21:42,0,69000
629,2723354,90,27300,39000,96.0,38,2023-04-26T21:42,-4095,23205
630,2753697,1,696000,1353000,100.0,1,2023-04-26T21:42,0,696000
631,2489894,2,150100,158000,98.0,111,2023-04-26T21:42,0,150100
632,3106487,3,133200,148000,99.0,34,2023-04-26T21:42,0,133200
633,2512635,4,35400,59000,96.0,237,2023-04-26T21:42,0,35400
634,3230036,5,190800,212000,0.0,0,2023-04-26T21:42,-9540,181260
635,2070402,6,195300,279000,0.0,0,2023-04-26T21:42,0,195300
636,3205629,7,175000,219000,0.0,0,2023-04-26T21:42,-8750,166250
637,2070650,8,181300,259000,0.0,0,2023-04-26T21:42,0,181300
638,2911103,9,411600,588000,0.0,0,2023-04-26T21:42,0,411600
639,3226428,10,399000,0,0.0,0,2023-04-26T21:42,0,399000
640,3228629,11,92650,109000,0.0,0,2023-04-26T21:42,0,92650
641,2457511,12,339000,0,100.0,17,2023-04-26T21:42,0,339000
642,2605850,13,94000,0,97.0,180,2023-04-26T21:42,0,94000
643,3230042,14,160200,178000,0.0,0,2023-04-26T21:42,-8010,152190
644,3206504,15,168000,0,0.0,0,2023-04-26T21:42,0,168000
645,3228623,16,92650,109000,0.0,0,2023-04-26T21:42,0,92650
646,2392489,17,31900,0,97.0,740,2023-04-26T21:42,0,31900
647,1875664,18,33190,36900,96.0,573,2023-04-26T21:42,0,33190
648,3134492,19,75050,79000,97.0,7,2023-04-26T21:42,0,75050
649,2377832,20,195000,0,95.0,182,2023-04-26T21:42,0,195000
650,3177832,21,298000,0,0.0,0,2023-04-26T21:42,-14900,283100
651,2856004,22,299000,0,0.0,0,2023-04-26T21:42,-50000,249000
652,3192300,23,129000,0,0.0,0,2023-04-26T21:42,-12900,116100
653,3099416,24,44910,49900,100.0,3,2023-04-26T21:42,-8982,35928
654,3246321,25,249000,0,0.0,0,2023-04-26T21:42,0,249000
655,3050174,26,258000,0,100.0,2,2023-04-26T21:42,-38700,219300
656,3105861,27,129000,0,0.0,0,2023-04-26T21:42,-19350,109650
657,1103286,28,94000,0,94.0,785,2023-04-26T21:42,0,94000
658,3130633,29,149000,0,100.0,7,2023-04-26T21:42,0,149000
659,3084760,30,119000,0,100.0,2,2023-04-26T21:42,0,119000
660,3140510,31,198000,0,100.0,2,2023-04-26T21:42,-39600,158400
661,2612357,32,69000,139000,96.0,19,2023-04-26T21:42,-10350,58650
662,3102263,33,165000,0,100.0,2,2023-04-26T21:42,0,165000
663,2070403,34,181300,259000,0.0,0,2023-04-26T21:42,0,181300
664,2098150,35,189000,0,88.0,30,2023-04-26T21:42,0,189000
665,1875663,36,33190,36900,95.0,837,2023-04-26T21:42,0,33190
666,3081770,37,189000,0,96.0,5,2023-04-26T21:42,0,189000
667,3251832,38,169000,0,0.0,0,2023-04-26T21:42,0,169000
668,3165306,39,98100,109000,90.0,2,2023-04-26T21:42,0,98100
669,3081771,40,189000,0,100.0,7,2023-04-26T21:42,0,189000
670,3205066,41,104300,149000,0.0,0,2023-04-26T21:42,-15645,88655
671,1779568,42,54400,64000,95.0,298,2023-04-26T21:42,-8160,46240
672,2388209,43,94000,0,97.0,160,2023-04-26T21:42,0,94000
673,2392491,44,31900,0,96.0,409,2023-04-26T21:42,0,31900
674,3174225,45,179000,0,100.0,1,2023-04-26T21:42,-35800,143200
675,3100428,46,149000,0,100.0,1,2023-04-26T21:42,0,149000
676,3187364,47,59900,0,0.0,0,2023-04-26T21:42,-11980,47920
677,3119153,48,160600,169000,0.0,0,2023-04-26T21:42,0,160600
678,3107003,49,179550,189000,0.0,0,2023-04-26T21:42,-26933,152617
679,2478652,50,61200,68000,94.0,342,2023-04-26T21:42,-9180,52020
680,3202313,51,75200,94000,100.0,1,2023-04-26T21:42,-11280,63920
681,3189866,52,148000,0,0.0,0,2023-04-26T21:42,0,148000
682,3147129,53,169000,0,100.0,2,2023-04-26T21:42,0,169000
683,3225126,54,129000,0,100.0,2,2023-04-26T21:42,0,129000
684,3228630,55,135150,159000,0.0,0,2023-04-26T21:42,0,135150
685,1810935,56,169200,188000,0.0,0,2023-04-26T21:42,0,169200
686,2731616,57,47400,79000,95.0,81,2023-04-26T21:42,-9480,37920
687,3253900,58,69900,0,0.0,0,2023-04-26T21:42,0,69900
688,3190217,59,165000,0,0.0,0,2023-04-26T21:42,0,165000
689,3152241,60,159000,0,100.0,2,2023-04-26T21:42,0,159000
690,3138202,61,147250,155000,100.0,2,2023-04-26T21:42,0,147250
691,3228631,62,135150,159000,0.0,0,2023-04-26T21:42,0,135150
692,3152271,63,140000,178000,0.0,0,2023-04-26T21:42,0,140000
693,3178111,64,150000,0,0.0,0,2023-04-26T21:42,0,150000
694,3228642,65,135150,159000,0.0,0,2023-04-26T21:42,0,135150
695,3120601,66,134100,149000,100.0,1,2023-04-26T21:42,-26820,107280
696,3135497,67,150100,158000,93.0,3,2023-04-26T21:42,0,150100
697,3223214,68,129000,0,0.0,0,2023-04-26T21:42,-19350,109650
698,1804969,69,149000,0,0.0,0,2023-04-26T21:42,0,149000
699,3228620,70,126650,149000,0.0,0,2023-04-26T21:42,0,126650
700,1579103,71,126400,158000,96.0,101,2023-04-26T21:42,-18960,107440
701,2774374,72,143100,159000,0.0,0,2023-04-26T21:42,0,143100
702,3106752,73,141550,149000,0.0,0,2023-04-26T21:42,-21233,120317
703,1827450,74,141000,0,92.0,8,2023-04-26T21:42,0,141000
704,2585620,75,139000,0,100.0,3,2023-04-26T21:42,0,139000
705,1455772,76,94000,0,96.0,212,2023-04-26T21:42,0,94000
706,3074709,77,119000,0,100.0,3,2023-04-26T21:42,0,119000
707,1973410,78,83300,119000,100.0,3,2023-04-26T21:42,0,83300
708,2007990,79,129350,199000,100.0,4,2023-04-26T21:42,-19403,109947
709,3214194,80,109000,0,0.0,0,2023-04-26T21:42,-10900,98100
710,2714524,81,46230,69000,95.0,412,2023-04-26T21:42,-6935,39295
711,3235369,82,103550,109000,0.0,0,2023-04-26T21:42,0,103550
712,2624346,83,70400,88000,88.0,12,2023-04-26T21:42,0,70400
713,3149931,84,109000,0,100.0,8,2023-04-26T21:42,0,109000
714,3208846,85,49900,0,0.0,0,2023-04-26T21:42,-9980,39920
715,3153259,86,128000,0,0.0,0,2023-04-26T21:42,-25600,102400
716,1103287,87,94000,0,95.0,402,2023-04-26T21:42,0,94000
717,3183656,88,59900,0,100.0,1,2023-04-26T21:42,0,59900
718,3155026,89,54600,78000,100.0,9,2023-04-26T21:42,-8190,46410
719,3105864,90,129000,0,0.0,0,2023-04-26T21:42,-19350,109650
720,2535468,1,236600,338000,94.0,11,2023-04-26T21:42,-42588,194012
721,3228597,2,75650,89000,0.0,0,2023-04-26T21:42,0,75650
722,2716675,3,39900,59000,96.0,207,2023-04-26T21:42,-5985,33915
723,3051039,4,83300,119000,100.0,45,2023-04-26T21:42,0,83300
724,3242648,5,359000,0,0.0,0,2023-04-26T21:42,0,359000
725,3070528,6,168000,0,96.0,6,2023-04-26T21:42,0,168000
726,3123863,7,160200,178000,0.0,0,2023-04-26T21:42,-28836,131364
727,3105866,8,89000,0,97.0,8,2023-04-26T21:42,-13350,75650
728,3040745,9,93500,110000,95.0,22,2023-04-26T21:42,-14025,79475
729,3070525,10,148000,0,92.0,8,2023-04-26T21:42,0,148000
730,3144344,11,66000,82000,100.0,4,2023-04-26T21:42,-9900,56100
731,2830808,12,139000,0,97.0,15,2023-04-26T21:42,0,139000
732,2864414,13,69300,99000,95.0,104,2023-04-26T21:42,-10395,58905
733,3031104,14,48300,69000,98.0,78,2023-04-26T21:42,-7245,41055
734,3233480,15,279000,0,0.0,0,2023-04-26T21:42,-41850,237150
735,2978103,16,40690,47900,98.0,17,2023-04-26T21:42,0,40690
736,3122265,17,124200,138000,90.0,6,2023-04-26T21:42,-22356,101844
737,2573658,18,264000,440000,0.0,0,2023-04-26T21:42,-47520,216480
738,2573497,19,258000,430000,0.0,0,2023-04-26T21:42,-46440,211560
739,3126113,20,55300,79000,89.0,17,2023-04-26T21:42,-8295,47005
740,1645760,21,43900,0,96.0,355,2023-04-26T21:42,0,43900
741,2429118,22,236600,338000,96.0,11,2023-04-26T21:42,-42588,194012
742,2551401,23,37900,0,94.0,349,2023-04-26T21:42,0,37900
743,3077493,24,238000,0,100.0,2,2023-04-26T21:42,-42840,195160
744,3072005,25,67200,112000,85.0,7,2023-04-26T21:42,-10080,57120
745,2551407,26,37900,0,97.0,207,2023-04-26T21:42,0,37900
746,3227713,27,80100,89000,100.0,1,2023-04-26T21:42,-4005,76095
747,3174796,28,223200,248000,0.0,0,2023-04-26T21:42,-40176,183024
748,3210875,29,79200,99000,100.0,1,2023-04-26T21:42,0,79200
749,2551400,30,39900,0,93.0,163,2023-04-26T21:42,0,39900
750,2447751,31,228000,380000,100.0,1,2023-04-26T21:42,-41040,186960
751,3184670,32,243600,348000,0.0,0,2023-04-26T21:42,-43848,199752
752,3115391,33,223200,248000,0.0,0,2023-04-26T21:42,0,223200
753,2352881,34,39950,79900,98.0,334,2023-04-26T21:42,0,39950
754,2541603,35,203000,290000,0.0,0,2023-04-26T21:42,-36540,166460
755,2836289,36,29500,59000,94.0,224,2023-04-26T21:42,-4425,25075
756,3134481,37,188340,219000,0.0,0,2023-04-26T21:42,-33902,154438
757,2381726,38,188300,269000,0.0,0,2023-04-26T21:42,-33894,154406
758,3100234,39,174400,218000,0.0,0,2023-04-26T21:42,-31392,143008
759,2771725,40,166600,238000,94.0,17,2023-04-26T21:42,-29988,136612
760,3210874,41,79200,99000,100.0,1,2023-04-26T21:42,0,79200
761,3051709,42,43900,0,100.0,4,2023-04-26T21:42,0,43900
762,3063419,43,34900,65000,98.0,15,2023-04-26T21:42,0,34900
763,3162345,44,180500,190000,0.0,0,2023-04-26T21:42,-32490,148010
764,2912887,45,178000,0,0.0,0,2023-04-26T21:42,0,178000
765,3125460,46,171000,0,80.0,2,2023-04-26T21:42,-25650,145350
766,3159166,47,162000,0,0.0,0,2023-04-26T21:42,-24300,137700
767,3133119,48,171000,0,0.0,0,2023-04-26T21:42,0,171000
768,2830762,49,139000,0,99.0,49,2023-04-26T21:42,0,139000
769,3234813,50,148500,165000,0.0,0,2023-04-26T21:42,-7425,141075
770,1944553,51,36900,0,96.0,225,2023-04-26T21:42,-3690,33210
771,3100900,52,168000,0,90.0,4,2023-04-26T21:42,-30240,137760
772,2756335,53,125400,132000,96.0,73,2023-04-26T21:42,0,125400
773,3228592,54,75650,89000,0.0,0,2023-04-26T21:42,0,75650
774,3074720,55,89000,0,93.0,3,2023-04-26T21:42,0,89000
775,3185973,56,159000,0,100.0,2,2023-04-26T21:42,-28620,130380
776,2544106,57,161400,269000,0.0,0,2023-04-26T21:42,-29052,132348
777,2378593,58,83300,98000,94.0,71,2023-04-26T21:42,0,83300
778,2117253,59,37290,43900,94.0,276,2023-04-26T21:42,0,37290
779,2914815,60,151200,189000,96.0,5,2023-04-26T21:42,0,151200
780,1618698,61,38400,64000,95.0,628,2023-04-26T21:42,0,38400
781,2571671,62,149000,0,100.0,12,2023-04-26T21:42,0,149000
782,3120375,63,61200,68000,100.0,8,2023-04-26T21:42,0,61200
783,3120201,64,124200,138000,100.0,3,2023-04-26T21:42,-22356,101844
784,2739771,65,83200,128000,100.0,3,2023-04-26T21:42,-12480,70720
785,3073229,66,151200,168000,100.0,1,2023-04-26T21:42,-27216,123984
786,2735244,67,152000,190000,0.0,0,2023-04-26T21:42,-27360,124640
787,2741664,68,134000,0,100.0,4,2023-04-26T21:42,0,134000
788,3093403,69,149000,0,100.0,17,2023-04-26T21:42,0,149000
789,3120257,70,134100,149000,100.0,1,2023-04-26T21:42,0,134100
790,3208260,71,150100,158000,0.0,0,2023-04-26T21:42,-22515,127585
791,3200263,72,144000,0,0.0,0,2023-04-26T21:42,-21600,122400
792,3125457,73,49900,89900,88.0,10,2023-04-26T21:42,0,49900
793,3230703,74,121600,128000,100.0,1,2023-04-26T21:42,0,121600
794,3202638,75,48300,69000,0.0,0,2023-04-26T21:42,-7245,41055
795,2733236,76,78850,83000,94.0,14,2023-04-26T21:42,0,78850
796,3144417,77,71100,79000,100.0,3,2023-04-26T21:42,0,71100
797,2297520,78,143400,239000,0.0,0,2023-04-26T21:42,-25812,117588
798,2589977,79,129500,185000,0.0,0,2023-04-26T21:42,-23310,106190
799,2422720,80,141100,166000,0.0,0,2023-04-26T21:42,-25398,115702
800,2981150,81,67500,75000,92.0,25,2023-04-26T21:42,-10125,57375
801,3197586,82,138000,0,0.0,0,2023-04-26T21:42,0,138000
802,3149783,83,139000,0,0.0,0,2023-04-26T21:42,0,139000
803,3134478,84,75050,79000,100.0,3,2023-04-26T21:42,0,75050
804,3194479,85,119000,0,0.0,0,2023-04-26T21:42,0,119000
805,3060883,86,129000,0,100.0,2,2023-04-26T21:42,-19350,109650
806,2316501,87,38400,64000,94.0,80,2023-04-26T21:42,0,38400
807,3160024,88,125100,139000,0.0,0,2023-04-26T21:42,-18765,106335
808,3052007,89,129000,0,100.0,1,2023-04-26T21:42,-19350,109650
809,3060887,90,129000,0,0.0,0,2023-04-26T21:42,-19350,109650
810,991339,1,17890,19900,97.0,53763,2023-04-26T21:42,0,17890
811,1986031,2,23690,27900,97.0,10954,2023-04-26T21:42,0,23690
812,998051,3,15200,24000,97.0,165068,2023-04-26T21:42,0,15200
813,991340,4,15890,19900,97.0,31155,2023-04-26T21:42,0,15890
814,763821,5,16200,22000,96.0,31617,2023-04-26T21:42,0,16200
815,1477845,6,15400,22000,96.0,9921,2023-04-26T21:42,0,15400
816,1094835,7,15900,0,97.0,6345,2023-04-26T21:42,0,15900
817,1996702,8,25090,27900,97.0,1989,2023-04-26T21:42,0,25090
818,1094748,9,19900,0,97.0,19377,2023-04-26T21:42,0,19900
819,1342874,10,16900,33000,97.0,13196,2023-04-26T21:42,0,16900
820,1996705,11,23690,27900,98.0,2774,2023-04-26T21:42,0,23690
821,2845854,12,13000,18900,97.0,343,2023-04-26T21:42,-2600,10400
822,1986029,13,25090,27900,97.0,4037,2023-04-26T21:42,0,25090
823,792919,14,15190,16900,96.0,18033,2023-04-26T21:42,0,15190
824,2959925,15,22000,27500,98.0,139,2023-04-26T21:42,-1100,20900
825,746158,16,19390,22900,96.0,20598,2023-04-26T21:42,0,19390
826,991341,17,16890,19900,96.0,10323,2023-04-26T21:42,0,16890
827,1443937,18,12900,24000,97.0,8320,2023-04-26T21:42,0,12900
828,991570,19,13300,20000,97.0,19243,2023-04-26T21:42,0,13300
829,1821485,20,30000,0,96.0,1308,2023-04-26T21:42,0,30000
830,2960555,21,15200,19000,94.0,134,2023-04-26T21:42,0,15200
831,1729576,22,9600,13900,97.0,16460,2023-04-26T21:42,-1440,8160
832,746154,23,17900,0,96.0,5238,2023-04-26T21:42,0,17900
833,734085,24,13200,19800,96.0,65345,2023-04-26T21:42,0,13200
834,2821598,25,19390,22900,97.0,174,2023-04-26T21:42,0,19390
835,3033249,26,15000,0,95.0,301,2023-04-26T21:42,0,15000
836,1092994,27,19390,22900,96.0,2679,2023-04-26T21:42,0,19390
837,2297277,28,19900,22000,96.0,339,2023-04-26T21:42,0,19900
838,479245,29,15400,22000,93.0,5466,2023-04-26T21:42,0,15400
839,1346009,30,9500,12000,97.0,6792,2023-04-26T21:42,-1425,8075
840,2870865,31,15900,19900,95.0,77,2023-04-26T21:42,-3180,12720
841,746159,32,19390,22900,95.0,28774,2023-04-26T21:42,0,19390
842,2346958,33,18200,24000,98.0,546,2023-04-26T21:42,-2730,15470
843,1986030,34,25090,27900,97.0,1734,2023-04-26T21:42,0,25090
844,792920,35,15190,16900,96.0,9730,2023-04-26T21:42,0,15190
845,2832613,36,11900,33000,97.0,856,2023-04-26T21:42,0,11900
846,792921,37,15190,16900,95.0,7835,2023-04-26T21:42,0,15190
847,1094837,38,13490,15900,96.0,1788,2023-04-26T21:42,0,13490
848,3009680,39,12590,14900,98.0,165,2023-04-26T21:42,0,12590
849,1996704,40,22290,27900,97.0,733,2023-04-26T21:42,0,22290
850,1094836,41,15900,0,97.0,1337,2023-04-26T21:42,0,15900
851,1260384,42,19900,0,95.0,1814,2023-04-26T21:42,0,19900
852,2477852,43,16890,19900,98.0,699,2023-04-26T21:42,0,16890
853,2821588,44,19690,21900,97.0,62,2023-04-26T21:42,0,19690
854,1062063,45,9490,15900,97.0,2202,2023-04-26T21:42,0,9490
855,2821589,46,19690,21900,96.0,47,2023-04-26T21:42,0,19690
856,1094750,47,16890,19900,97.0,3599,2023-04-26T21:42,0,16890
857,752821,48,9900,0,94.0,23904,2023-04-26T21:42,0,9900
858,2347097,49,14900,24000,98.0,1657,2023-04-26T21:42,-2235,12665
859,2738094,50,17890,19900,96.0,182,2023-04-26T21:42,0,17890
860,2829586,51,13000,18900,98.0,46,2023-04-26T21:42,-2600,10400
861,1286366,52,12500,24000,97.0,9866,2023-04-26T21:42,0,12500
862,2738095,53,17890,19900,95.0,113,2023-04-26T21:42,0,17890
863,2509300,54,19900,0,96.0,404,2023-04-26T21:42,0,19900
864,1348077,55,10900,16500,97.0,1897,2023-04-26T21:42,0,10900
865,2011850,56,21490,23900,98.0,880,2023-04-26T21:42,0,21490
866,1260383,57,19900,0,95.0,1470,2023-04-26T21:42,0,19900
867,2990345,58,27900,0,99.0,70,2023-04-26T21:42,0,27900
868,2973095,59,20000,25000,98.0,34,2023-04-26T21:42,-1000,19000
869,2973894,60,22000,27500,98.0,33,2023-04-26T21:42,-1100,20900
870,1475055,61,16200,22000,96.0,1191,2023-04-26T21:42,-2430,13770
871,1094749,62,19900,0,96.0,5004,2023-04-26T21:42,0,19900
872,1358721,63,14200,22000,96.0,1172,2023-04-26T21:42,-2130,12070
873,3118094,64,28800,32000,98.0,12,2023-04-26T21:42,0,28800
874,3040542,65,20900,22000,98.0,18,2023-04-26T21:42,0,20900
875,746161,66,19390,22900,95.0,7741,2023-04-26T21:42,0,19390
876,2845855,67,13000,18900,97.0,58,2023-04-26T21:42,-2600,10400
877,1974077,68,37490,46900,97.0,914,2023-04-26T21:42,0,37490
878,1477846,69,15400,22000,96.0,2710,2023-04-26T21:42,0,15400
879,2973952,70,28800,48000,96.0,20,2023-04-26T21:42,-5184,23616
880,2467197,71,30000,0,95.0,151,2023-04-26T21:42,0,30000
881,2342849,72,15120,18900,92.0,132,2023-04-26T21:42,0,15120
882,2929635,73,15900,27000,97.0,581,2023-04-26T21:42,0,15900
883,2011852,74,21490,23900,97.0,1333,2023-04-26T21:42,0,21490
884,2293399,75,19900,22000,95.0,646,2023-04-26T21:42,0,19900
885,3181894,76,22000,0,100.0,6,2023-04-26T21:42,0,22000
886,1092996,77,19390,22900,95.0,772,2023-04-26T21:42,0,19390
887,1246150,78,16900,33600,95.0,3629,2023-04-26T21:42,0,16900
888,1547562,79,15400,22000,95.0,1385,2023-04-26T21:42,0,15400
889,2376087,80,17100,18000,96.0,353,2023-04-26T21:42,0,17100
890,1475031,81,16900,27000,96.0,1760,2023-04-26T21:42,-2535,14365
891,472686,82,9500,14800,94.0,783,2023-04-26T21:42,0,9500
892,2584266,83,9500,12000,98.0,427,2023-04-26T21:42,-1425,8075
893,1387502,84,12690,15900,95.0,522,2023-04-26T21:42,0,12690
894,1392772,85,16890,19900,96.0,1161,2023-04-26T21:42,0,16890
895,3111130,86,15400,0,90.0,10,2023-04-26T21:42,0,15400
896,3130683,87,38400,48000,95.0,4,2023-04-26T21:42,-5760,32640
897,2821590,88,19690,21900,98.0,56,2023-04-26T21:42,0,19690
898,2870866,89,15900,19900,94.0,34,2023-04-26T21:42,-3180,12720
899,2846994,90,12500,17900,95.0,20,2023-04-26T21:42,-2500,10000
