,item_id,rank,price,del_price,rating,rating_count,time,coupon,real_price
0,2272830,1,35910,39900,97.0,19279,2023-04-07T20:19,-3591,32319
1,1848166,2,44100,49000,97.0,41057,2023-04-07T20:19,0,44100
2,3143791,3,39900,68000,98.0,60,2023-04-07T20:19,-7980,31920
3,2646350,4,59800,94000,95.0,4180,2023-04-07T20:19,-11960,47840
4,3206068,5,52900,74000,98.0,240,2023-04-07T20:19,0,52900
5,2086653,6,16900,0,97.0,39501,2023-04-07T20:19,0,16900
6,2479911,7,49400,76000,97.0,4226,2023-04-07T20:19,0,49400
7,345889,8,29900,47900,95.0,9814,2023-04-07T20:19,0,29900
8,3105468,9,71100,79000,98.0,48,2023-04-07T20:19,0,71100
9,3187851,10,49900,110000,98.0,86,2023-04-07T20:19,0,49900
10,1763157,11,49400,52000,95.0,2639,2023-04-07T20:19,0,49400
11,1336398,12,40200,67000,96.0,19059,2023-04-07T20:19,-4020,36180
12,2034137,13,31800,0,97.0,17124,2023-04-07T20:19,-4770,27030
13,2377269,14,38250,45000,97.0,3916,2023-04-07T20:19,0,38250
14,1882578,15,35910,39900,97.0,9503,2023-04-07T20:19,0,35910
15,2996536,16,39900,59000,96.0,515,2023-04-07T20:19,-7980,31920
16,2392759,17,39900,49600,95.0,4020,2023-04-07T20:19,-3990,35910
17,2442409,18,39000,78000,96.0,8925,2023-04-07T20:19,-5850,33150
18,1921901,19,36900,70500,96.0,7574,2023-04-07T20:19,0,36900
19,2313388,20,76500,85000,96.0,2128,2023-04-07T20:19,0,76500
20,3134405,21,44910,49900,98.0,16,2023-04-07T20:19,0,44910
21,2149254,22,37800,0,97.0,33299,2023-04-07T20:19,-5670,32130
22,2359137,23,40200,67000,97.0,1327,2023-04-07T20:19,-4020,36180
23,2122566,24,33800,0,97.0,16045,2023-04-07T20:19,-5070,28730
24,1884943,25,29900,39000,96.0,18895,2023-04-07T20:19,0,29900
25,1582356,26,49200,82000,96.0,16150,2023-04-07T20:19,0,49200
26,1828538,27,39900,69900,95.0,2939,2023-04-07T20:19,0,39900
27,2314616,28,39000,43000,97.0,8269,2023-04-07T20:19,0,39000
28,2396645,29,31500,59000,96.0,23470,2023-04-07T20:19,0,31500
29,1706633,30,199000,0,97.0,2390,2023-04-07T20:19,0,199000
30,3034895,31,101150,119000,98.0,368,2023-04-07T20:19,0,101150
31,2409397,32,31500,45000,97.0,2751,2023-04-07T20:19,-3150,28350
32,2716375,33,110600,158000,95.0,16,2023-04-07T20:19,-11060,99540
33,1944612,34,35800,59700,97.0,2868,2023-04-07T20:19,0,35800
34,1817394,35,59900,150000,93.0,7201,2023-04-07T20:19,0,59900
35,1005680,36,17500,35000,95.0,9116,2023-04-07T20:19,0,17500
36,2038497,37,36000,45000,95.0,16309,2023-04-07T20:19,-3600,32400
37,3150516,38,79800,126000,91.0,86,2023-04-07T20:19,-15960,63840
38,1939099,39,34300,49000,97.0,11756,2023-04-07T20:19,0,34300
39,3052036,40,59400,66000,96.0,158,2023-04-07T20:19,-11880,47520
40,1943792,41,34400,43000,96.0,5369,2023-04-07T20:19,0,34400
41,3061266,42,55200,69000,100.0,1,2023-04-07T20:19,-5520,49680
42,2851485,43,66900,68900,96.0,471,2023-04-07T20:19,0,66900
43,2359143,44,40200,67000,96.0,717,2023-04-07T20:19,-4020,36180
44,1420730,45,35000,58000,95.0,35977,2023-04-07T20:19,-7000,28000
45,2453556,46,39900,42000,97.0,6273,2023-04-07T20:19,0,39900
46,1955452,47,39800,69990,95.0,2669,2023-04-07T20:19,0,39800
47,1336290,48,40200,67000,96.0,13712,2023-04-07T20:19,-4020,36180
48,1503352,49,39900,42000,97.0,8419,2023-04-07T20:19,0,39900
49,3043304,50,189000,0,98.0,42,2023-04-07T20:19,0,189000
50,2376233,51,36000,0,97.0,2221,2023-04-07T20:19,0,36000
51,2171559,52,39900,54000,96.0,4192,2023-04-07T20:19,-7980,31920
52,3180166,53,31200,39000,100.0,17,2023-04-07T20:19,0,31200
53,1763123,54,84550,89000,96.0,1667,2023-04-07T20:19,0,84550
54,3154715,55,49500,66000,0.0,0,2023-04-07T20:19,-4950,44550
55,1005683,56,17500,35000,95.0,10783,2023-04-07T20:19,0,17500
56,2326935,57,63200,79000,96.0,12958,2023-04-07T20:19,-6320,56880
57,2285512,58,44200,52000,96.0,1723,2023-04-07T20:19,0,44200
58,2851727,59,49800,62000,96.0,290,2023-04-07T20:19,-2490,47310
59,854337,60,33900,0,95.0,17340,2023-04-07T20:19,0,33900
60,1899755,61,29900,39000,96.0,4947,2023-04-07T20:19,0,29900
61,994588,62,39900,53000,93.0,6026,2023-04-07T20:19,-3990,35910
62,2376229,63,36000,0,97.0,3834,2023-04-07T20:19,0,36000
63,3189660,64,59800,94000,95.0,8,2023-04-07T20:19,-11960,47840
64,2684358,65,109000,0,97.0,3269,2023-04-07T20:19,0,109000
65,1417691,66,13900,0,97.0,18555,2023-04-07T20:19,0,13900
66,2392775,67,39900,49600,96.0,1269,2023-04-07T20:19,-3990,35910
67,3064420,68,58100,69000,96.0,45,2023-04-07T20:19,-2905,55195
68,2065708,69,59000,62000,98.0,6604,2023-04-07T20:19,-8850,50150
69,2035287,70,39800,0,97.0,8736,2023-04-07T20:19,-5970,33830
70,2375962,71,59000,62000,98.0,5417,2023-04-07T20:19,-8850,50150
71,3071087,72,84550,89000,95.0,381,2023-04-07T20:19,0,84550
72,2368712,73,38700,43000,97.0,5587,2023-04-07T20:19,-1935,36765
73,2995119,74,39800,49800,96.0,538,2023-04-07T20:19,0,39800
74,2077010,75,28800,72000,96.0,720,2023-04-07T20:19,0,28800
75,3050518,76,49600,62000,98.0,328,2023-04-07T20:19,-9920,39680
76,3115993,77,39000,0,0.0,0,2023-04-07T20:19,0,39000
77,3154713,78,49500,66000,0.0,0,2023-04-07T20:19,-4950,44550
78,1820701,79,35000,0,96.0,5569,2023-04-07T20:19,0,35000
79,1336297,80,40200,67000,96.0,3675,2023-04-07T20:19,-4020,36180
80,996177,81,15900,0,95.0,77551,2023-04-07T20:19,0,15900
81,1608272,82,39800,65590,96.0,4092,2023-04-07T20:19,0,39800
82,2015684,83,39000,0,94.0,6383,2023-04-07T20:19,0,39000
83,2877493,84,59800,92000,95.0,1438,2023-04-07T20:19,0,59800
84,2364807,85,219000,0,96.0,706,2023-04-07T20:19,0,219000
85,3051797,86,94000,0,88.0,5,2023-04-07T20:19,-9400,84600
86,1574201,87,71100,79000,97.0,4576,2023-04-07T20:19,0,71100
87,1793989,88,199000,0,97.0,929,2023-04-07T20:19,0,199000
88,3163734,89,71100,79000,98.0,41,2023-04-07T20:19,0,71100
89,2037637,90,45900,63000,95.0,3462,2023-04-07T20:19,-9180,36720
90,1558197,1,73690,81900,97.0,32345,2023-04-07T20:19,0,73690
91,1778404,2,42000,45000,96.0,67209,2023-04-07T20:19,0,42000
92,1571879,3,79900,112900,96.0,7057,2023-04-07T20:19,-15980,63920
93,2723218,4,47900,109000,97.0,2250,2023-04-07T20:19,0,47900
94,3132593,5,179100,199000,100.0,2,2023-04-07T20:19,0,179100
95,3012082,6,59900,79000,96.0,972,2023-04-07T20:19,-11980,47920
96,3132559,7,179100,199000,100.0,5,2023-04-07T20:19,0,179100
97,1790383,8,59000,86000,95.0,5479,2023-04-07T20:19,-5900,53100
98,2020732,9,70900,89000,95.0,810,2023-04-07T20:19,0,70900
99,1283757,10,75490,83900,96.0,26646,2023-04-07T20:19,0,75490
100,2061715,11,83900,105000,97.0,2702,2023-04-07T20:19,0,83900
101,1576700,12,89000,129000,97.0,16747,2023-04-07T20:19,0,89000
102,1530516,13,69900,79000,96.0,2324,2023-04-07T20:19,-13980,55920
103,2471405,14,89000,138000,97.0,2072,2023-04-07T20:19,-8900,80100
104,1571878,15,79900,112900,96.0,4677,2023-04-07T20:19,-15980,63920
105,1778408,16,42000,45000,95.0,11696,2023-04-07T20:19,0,42000
106,1856181,17,35910,39900,97.0,7424,2023-04-07T20:19,-3591,32319
107,1833230,18,108800,136000,97.0,5414,2023-04-07T20:19,0,108800
108,2715055,19,159000,189000,97.0,1998,2023-04-07T20:19,0,159000
109,841230,20,154000,172000,96.0,7271,2023-04-07T20:19,0,154000
110,1776552,21,59000,69000,94.0,6121,2023-04-07T20:19,0,59000
111,2064545,22,59800,94000,97.0,11116,2023-04-07T20:19,-2990,56810
112,1108007,23,79900,0,95.0,47889,2023-04-07T20:19,0,79900
113,1530517,24,69900,79000,96.0,2075,2023-04-07T20:19,-13980,55920
114,965917,25,71890,79900,95.0,13070,2023-04-07T20:19,0,71890
115,3010527,26,237150,279000,98.0,214,2023-04-07T20:19,0,237150
116,2329532,27,119200,149000,97.0,3962,2023-04-07T20:19,0,119200
117,3033224,28,59900,74000,97.0,625,2023-04-07T20:19,-11980,47920
118,2732486,29,109000,179000,98.0,687,2023-04-07T20:19,0,109000
119,3058783,30,179000,209000,95.0,38,2023-04-07T20:19,-35800,143200
120,3092698,31,179000,0,98.0,40,2023-04-07T20:19,0,179000
121,2723772,32,84500,169000,94.0,994,2023-04-07T20:19,0,84500
122,2343198,33,119000,129000,97.0,5007,2023-04-07T20:19,0,119000
123,2288426,34,69000,109000,94.0,814,2023-04-07T20:19,0,69000
124,1139192,35,71100,94900,97.0,14403,2023-04-07T20:19,-7110,63990
125,2750456,36,1423000,3190000,0.0,0,2023-04-07T20:19,0,1423000
126,3042246,37,119400,199000,96.0,49,2023-04-07T20:19,0,119400
127,2284220,38,79900,112900,96.0,1682,2023-04-07T20:19,-15980,63920
128,2403367,39,146000,0,97.0,639,2023-04-07T20:19,0,146000
129,2572705,40,168300,198000,96.0,58,2023-04-07T20:19,-25245,143055
130,2159724,41,29900,32000,95.0,2281,2023-04-07T20:19,0,29900
131,2723216,42,69900,109000,97.0,1088,2023-04-07T20:19,0,69900
132,1195307,43,82400,103000,96.0,12609,2023-04-07T20:19,-8240,74160
133,1737051,44,62300,89000,96.0,5094,2023-04-07T20:19,0,62300
134,3078900,45,148000,0,98.0,198,2023-04-07T20:19,-14800,133200
135,1618312,46,83900,0,97.0,7108,2023-04-07T20:19,-8390,75510
136,3025211,47,44900,69000,97.0,172,2023-04-07T20:19,-8980,35920
137,864404,48,108000,135000,95.0,13377,2023-04-07T20:19,0,108000
138,3037473,49,69900,85900,97.0,212,2023-04-07T20:19,0,69900
139,3030665,50,139200,174000,96.0,229,2023-04-07T20:19,0,139200
140,3029811,51,63200,79000,97.0,252,2023-04-07T20:19,0,63200
141,3125671,52,148000,0,97.0,18,2023-04-07T20:19,0,148000
142,1337094,53,69900,0,95.0,5385,2023-04-07T20:19,0,69900
143,1776549,54,59000,69000,94.0,4606,2023-04-07T20:19,0,59000
144,3058726,55,149000,169000,94.0,39,2023-04-07T20:19,-29800,119200
145,3037701,56,215000,239000,97.0,91,2023-04-07T20:19,-43000,172000
146,3055246,57,159000,0,98.0,54,2023-04-07T20:19,0,159000
147,3061176,58,799000,0,96.0,21,2023-04-07T20:19,0,799000
148,2752809,59,129000,159000,97.0,521,2023-04-07T20:19,-25800,103200
149,2074862,60,139900,218000,95.0,330,2023-04-07T20:19,-27980,111920
150,2699189,61,179000,0,99.0,126,2023-04-07T20:19,0,179000
151,2668986,62,35910,39900,96.0,3491,2023-04-07T20:19,-3591,32319
152,1751722,63,53910,59900,97.0,3385,2023-04-07T20:19,-5391,48519
153,2343199,64,119000,129000,98.0,1804,2023-04-07T20:19,0,119000
154,2122596,65,39800,57000,96.0,2666,2023-04-07T20:19,0,39800
155,1567183,66,75900,94900,97.0,7431,2023-04-07T20:19,-7590,68310
156,2288704,67,121000,132000,97.0,3390,2023-04-07T20:19,0,121000
157,3036129,68,59800,94000,95.0,1701,2023-04-07T20:19,-2990,56810
158,2322836,69,139200,174000,97.0,1016,2023-04-07T20:19,0,139200
159,2555380,70,2010000,3950000,0.0,0,2023-04-07T20:19,-30000,1980000
160,1593755,71,89360,111700,97.0,14457,2023-04-07T20:19,-8936,80424
161,1817381,72,47900,69000,96.0,1067,2023-04-07T20:19,0,47900
162,1558688,73,73690,81900,97.0,5733,2023-04-07T20:19,0,73690
163,3037472,74,49900,85900,98.0,122,2023-04-07T20:19,0,49900
164,2753690,75,281300,660000,80.0,1,2023-04-07T20:19,0,281300
165,1969617,76,162000,0,96.0,2638,2023-04-07T20:19,0,162000
166,3030682,77,159200,199000,96.0,333,2023-04-07T20:19,0,159200
167,1633664,78,87200,109000,97.0,4190,2023-04-07T20:19,0,87200
168,2991545,79,1060000,3654000,0.0,0,2023-04-07T20:19,0,1060000
169,1571876,80,79900,112900,96.0,1210,2023-04-07T20:19,-15980,63920
170,2375909,81,80890,89900,98.0,1548,2023-04-07T20:19,0,80890
171,3047185,82,129000,0,93.0,33,2023-04-07T20:19,0,129000
172,1776365,83,71200,89000,96.0,4616,2023-04-07T20:19,-7120,64080
173,2699160,84,179000,0,96.0,88,2023-04-07T20:19,0,179000
174,2710931,85,55300,79000,96.0,404,2023-04-07T20:19,0,55300
175,2288424,86,69000,109000,94.0,624,2023-04-07T20:19,0,69000
176,2184463,87,389000,0,98.0,394,2023-04-07T20:19,0,389000
177,2349864,88,127200,159000,97.0,645,2023-04-07T20:19,-25440,101760
178,1558683,89,81900,0,97.0,6219,2023-04-07T20:19,0,81900
179,3019700,90,178200,198000,100.0,13,2023-04-07T20:19,-17820,160380
180,2112059,1,36400,0,97.0,42931,2023-04-07T20:19,0,36400
181,1149329,2,39900,0,96.0,86019,2023-04-07T20:19,0,39900
182,750908,3,34900,54000,96.0,84045,2023-04-07T20:19,0,34900
183,1551840,4,39000,0,97.0,83655,2023-04-07T20:19,0,39000
184,1168906,5,41900,0,97.0,71065,2023-04-07T20:19,0,41900
185,2310310,6,109650,129000,98.0,927,2023-04-07T20:19,-21930,87720
186,2092852,7,42000,52800,96.0,11115,2023-04-07T20:19,-2100,39900
187,2112061,8,36400,52000,97.0,14667,2023-04-07T20:19,0,36400
188,1149328,9,39900,0,96.0,94498,2023-04-07T20:19,0,39900
189,2351467,10,29000,54000,96.0,6153,2023-04-07T20:19,0,29000
190,2060719,11,55200,69000,96.0,5143,2023-04-07T20:19,-2760,52440
191,1924274,12,49900,66000,95.0,22492,2023-04-07T20:19,-9980,39920
192,2028326,13,49900,0,97.0,6173,2023-04-07T20:19,0,49900
193,2060759,14,59800,74800,97.0,7214,2023-04-07T20:19,-2990,56810
194,2028327,15,49900,0,97.0,9067,2023-04-07T20:19,0,49900
195,1370101,16,39000,89000,96.0,22911,2023-04-07T20:19,-1950,37050
196,1573215,17,133200,148000,98.0,9291,2023-04-07T20:19,0,133200
197,2877984,18,59000,0,97.0,420,2023-04-07T20:19,0,59000
198,1926048,19,32000,0,97.0,14696,2023-04-07T20:19,0,32000
199,1551839,20,39000,0,97.0,23518,2023-04-07T20:19,0,39000
200,2060717,21,55200,69000,95.0,3802,2023-04-07T20:19,-2760,52440
201,1568057,22,49600,62000,96.0,22319,2023-04-07T20:19,0,49600
202,2723714,23,52000,58000,96.0,1540,2023-04-07T20:19,0,52000
203,858911,24,39000,49000,95.0,66914,2023-04-07T20:19,0,39000
204,2060720,25,55200,69000,95.0,2562,2023-04-07T20:19,-2760,52440
205,3057113,26,215100,239000,96.0,5,2023-04-07T20:19,0,215100
206,1552753,27,62400,78000,97.0,28175,2023-04-07T20:19,-6240,56160
207,2789111,28,79200,99000,97.0,833,2023-04-07T20:19,-3960,75240
208,3200524,29,49900,66000,100.0,3,2023-04-07T20:19,-9980,39920
209,2184087,30,49000,89000,96.0,4086,2023-04-07T20:19,-2450,46550
210,2150457,31,119250,159000,97.0,3813,2023-04-07T20:19,0,119250
211,1736085,32,39900,59800,96.0,36728,2023-04-07T20:19,0,39900
212,3141395,33,49900,73900,96.0,172,2023-04-07T20:19,-9980,39920
213,2789091,34,79200,99000,96.0,771,2023-04-07T20:19,-3960,75240
214,883004,35,69900,89000,94.0,9472,2023-04-07T20:19,0,69900
215,1191999,36,44800,64000,95.0,891,2023-04-07T20:19,0,44800
216,1555407,37,62400,78000,97.0,11575,2023-04-07T20:19,-6240,56160
217,3070909,38,139000,0,100.0,5,2023-04-07T20:19,0,139000
218,3188768,39,156000,0,100.0,12,2023-04-07T20:19,0,156000
219,2827702,40,69800,87500,96.0,440,2023-04-07T20:19,-3490,66310
220,3138553,41,49900,88000,89.0,13,2023-04-07T20:19,-9980,39920
221,890521,42,39800,63000,94.0,11115,2023-04-07T20:19,0,39800
222,2702931,43,90000,300000,100.0,7,2023-04-07T20:19,0,90000
223,1222184,44,41900,0,97.0,48372,2023-04-07T20:19,0,41900
224,1192043,45,44800,64000,96.0,990,2023-04-07T20:19,0,44800
225,2706287,46,39800,54000,95.0,3758,2023-04-07T20:19,-3980,35820
226,2092849,47,42000,52800,96.0,9755,2023-04-07T20:19,-2100,39900
227,1595607,48,57900,89000,97.0,5708,2023-04-07T20:19,0,57900
228,2749153,49,66600,74000,97.0,560,2023-04-07T20:19,0,66600
229,1477272,50,44200,68000,96.0,17846,2023-04-07T20:19,0,44200
230,1759490,51,84150,99000,96.0,7312,2023-04-07T20:19,-16830,67320
231,2131950,52,39000,49000,96.0,3881,2023-04-07T20:19,0,39000
232,1929722,53,84150,99000,96.0,4310,2023-04-07T20:19,-16830,67320
233,2107115,54,121500,135000,98.0,11692,2023-04-07T20:19,0,121500
234,2032901,55,31890,39900,97.0,6822,2023-04-07T20:19,0,31890
235,890338,56,39000,49000,95.0,47720,2023-04-07T20:19,0,39000
236,2562527,57,29400,42000,97.0,4004,2023-04-07T20:19,0,29400
237,1568032,58,49600,62000,96.0,6148,2023-04-07T20:19,0,49600
238,2310312,59,96750,129000,98.0,638,2023-04-07T20:19,-19350,77400
239,3043508,60,71200,89000,97.0,98,2023-04-07T20:19,-3560,67640
240,2713337,61,90000,300000,96.0,16,2023-04-07T20:19,0,90000
241,3154688,62,49800,63000,98.0,85,2023-04-07T20:19,-4980,44820
242,1627892,63,43900,0,97.0,10922,2023-04-07T20:19,0,43900
243,1666442,64,49900,0,97.0,10921,2023-04-07T20:19,0,49900
244,1985223,65,39000,89000,96.0,1651,2023-04-07T20:19,-1950,37050
245,2713345,66,172000,430000,96.0,38,2023-04-07T20:19,0,172000
246,1168922,67,35090,43900,96.0,18190,2023-04-07T20:19,0,35090
247,1403480,68,77000,98000,97.0,7738,2023-04-07T20:19,0,77000
248,2060743,69,33000,55000,95.0,3545,2023-04-07T20:19,0,33000
249,2569078,70,79000,0,96.0,2435,2023-04-07T20:19,0,79000
250,1344489,71,149000,0,97.0,1025,2023-04-07T20:19,0,149000
251,1737317,72,44800,64000,96.0,347,2023-04-07T20:19,-2240,42560
252,2493711,73,66400,83000,96.0,801,2023-04-07T20:19,-13280,53120
253,3154700,74,49800,63000,0.0,0,2023-04-07T20:19,-4980,44820
254,3049798,75,96800,121000,96.0,61,2023-04-07T20:19,0,96800
255,3154697,76,49800,63000,0.0,0,2023-04-07T20:19,-4980,44820
256,3098372,77,89000,139000,97.0,840,2023-04-07T20:19,0,89000
257,1885631,78,39000,49000,96.0,23735,2023-04-07T20:19,0,39000
258,3091296,79,129000,0,94.0,59,2023-04-07T20:19,0,129000
259,2578996,80,39900,59000,95.0,4671,2023-04-07T20:19,-3990,35910
260,2268307,81,99200,124000,97.0,875,2023-04-07T20:19,-9920,89280
261,2381406,82,124200,138000,98.0,2293,2023-04-07T20:19,0,124200
262,3154694,83,49800,63000,0.0,0,2023-04-07T20:19,-4980,44820
263,2802101,84,49600,62000,94.0,21,2023-04-07T20:19,-9920,39680
264,3188776,85,156000,0,100.0,11,2023-04-07T20:19,0,156000
265,2028329,86,49900,0,96.0,6524,2023-04-07T20:19,0,49900
266,3154689,87,49800,63000,98.0,103,2023-04-07T20:19,-4980,44820
267,3154647,88,49800,63000,0.0,0,2023-04-07T20:19,-4980,44820
268,2709031,89,42000,52800,96.0,3527,2023-04-07T20:19,-2100,39900
269,1926034,90,32000,0,97.0,3093,2023-04-07T20:19,0,32000
270,1789507,1,69900,79000,98.0,25855,2023-04-07T20:19,-6990,62910
271,1034480,2,135000,150000,97.0,18069,2023-04-07T20:19,0,135000
272,1969507,3,88000,0,98.0,5393,2023-04-07T20:19,0,88000
273,2973748,4,1127000,1670000,0.0,0,2023-04-07T20:19,0,1127000
274,2558648,5,119000,0,98.0,1260,2023-04-07T20:19,0,119000
275,2235274,6,145000,0,98.0,695,2023-04-07T20:19,0,145000
276,2849891,7,2790000,4490000,0.0,0,2023-04-07T20:19,0,2790000
277,2980956,8,2660000,3500000,0.0,0,2023-04-07T20:19,0,2660000
278,2962318,9,2611700,3175000,0.0,0,2023-04-07T20:19,0,2611700
279,3038000,10,74700,83000,96.0,365,2023-04-07T20:19,-14940,59760
280,2637706,11,2660000,0,0.0,0,2023-04-07T20:19,0,2660000
281,1564343,12,92800,119000,98.0,8096,2023-04-07T20:19,-6496,86304
282,2637681,13,2480000,0,0.0,0,2023-04-07T20:19,0,2480000
283,2408317,14,145800,162000,96.0,377,2023-04-07T20:19,-14580,131220
284,2637702,15,2359000,0,90.0,2,2023-04-07T20:19,0,2359000
285,1264107,16,65000,90000,97.0,6360,2023-04-07T20:19,0,65000
286,1835080,17,98000,0,97.0,2795,2023-04-07T20:19,0,98000
287,1842449,18,84000,99000,97.0,5373,2023-04-07T20:19,0,84000
288,2344540,19,96000,0,98.0,9225,2023-04-07T20:19,0,96000
289,2979861,20,1042000,1430000,100.0,6,2023-04-07T20:19,0,1042000
290,3047568,21,119970,129000,96.0,50,2023-04-07T20:19,0,119970
291,342189,22,39500,52000,95.0,15742,2023-04-07T20:19,0,39500
292,1581689,23,75600,89000,97.0,3978,2023-04-07T20:19,-3780,71820
293,2320927,24,39000,51000,97.0,2138,2023-04-07T20:19,-3900,35100
294,1744101,25,103500,109000,98.0,2920,2023-04-07T20:19,0,103500
295,1247560,26,69900,79000,96.0,4264,2023-04-07T20:19,-6990,62910
296,2066837,27,79000,119000,97.0,6493,2023-04-07T20:19,-7900,71100
297,693318,28,79000,110000,96.0,13165,2023-04-07T20:19,0,79000
298,1964770,29,59400,66000,97.0,2492,2023-04-07T20:19,-11880,47520
299,1323612,30,238000,0,97.0,3825,2023-04-07T20:19,-11900,226100
300,2344538,31,119000,0,98.0,6381,2023-04-07T20:19,0,119000
301,2673129,32,96500,129000,96.0,12,2023-04-07T20:19,-19300,77200
302,2584181,33,72000,0,99.0,1075,2023-04-07T20:19,0,72000
303,2770508,34,138000,0,97.0,335,2023-04-07T20:19,0,138000
304,3034751,35,64800,72000,96.0,473,2023-04-07T20:19,0,64800
305,1969488,36,88000,0,98.0,1750,2023-04-07T20:19,0,88000
306,2688604,37,139000,159000,97.0,862,2023-04-07T20:19,-13900,125100
307,3024801,38,138000,0,100.0,17,2023-04-07T20:19,0,138000
308,938746,39,80100,89000,95.0,12522,2023-04-07T20:19,0,80100
309,2271789,40,71100,79000,97.0,2514,2023-04-07T20:19,0,71100
310,1910358,41,89100,99000,98.0,2472,2023-04-07T20:19,0,89100
311,2630526,42,100000,0,96.0,628,2023-04-07T20:19,0,100000
312,1745100,43,103500,109000,97.0,988,2023-04-07T20:19,0,103500
313,2343665,44,89000,0,97.0,4611,2023-04-07T20:19,0,89000
314,2902041,45,357000,599000,98.0,35,2023-04-07T20:19,0,357000
315,693525,46,46800,65000,96.0,3993,2023-04-07T20:19,-3276,43524
316,3070516,47,138000,0,98.0,23,2023-04-07T20:19,0,138000
317,3082387,48,139000,0,98.0,122,2023-04-07T20:19,-13900,125100
318,1320752,49,67800,135000,97.0,4745,2023-04-07T20:19,-3390,64410
319,1090160,50,99000,0,97.0,1310,2023-04-07T20:19,0,99000
320,3161077,51,169200,188000,100.0,1,2023-04-07T20:19,0,169200
321,2690212,52,1075000,1950000,95.0,9,2023-04-07T20:19,0,1075000
322,1790465,53,141000,188000,98.0,613,2023-04-07T20:19,-28200,112800
323,2757112,54,359000,0,93.0,98,2023-04-07T20:19,0,359000
324,3034745,55,75600,84000,97.0,168,2023-04-07T20:19,0,75600
325,2325729,56,87200,109000,97.0,796,2023-04-07T20:19,-17440,69760
326,2828308,57,1010200,1345000,0.0,0,2023-04-07T20:19,0,1010200
327,2668835,58,107100,119000,98.0,878,2023-04-07T20:19,-10710,96390
328,2422175,59,137700,162000,99.0,207,2023-04-07T20:19,0,137700
329,2002697,60,67900,76000,97.0,3468,2023-04-07T20:19,-6790,61110
330,3029926,61,285000,0,99.0,50,2023-04-07T20:19,-28500,256500
331,2112607,62,178000,0,97.0,353,2023-04-07T20:19,0,178000
332,1456515,63,49500,55000,97.0,8725,2023-04-07T20:19,-9900,39600
333,2954959,64,95000,0,95.0,195,2023-04-07T20:19,0,95000
334,1528287,65,49000,0,96.0,4601,2023-04-07T20:19,0,49000
335,1744100,66,103500,109000,98.0,1020,2023-04-07T20:19,0,103500
336,913402,67,83000,98000,95.0,8042,2023-04-07T20:19,0,83000
337,2767263,68,72800,112000,95.0,402,2023-04-07T20:19,0,72800
338,2193458,69,159000,0,97.0,593,2023-04-07T20:19,0,159000
339,2911055,70,832000,1340000,100.0,17,2023-04-07T20:19,0,832000
340,1597319,71,89100,99000,97.0,589,2023-04-07T20:19,-8910,80190
341,2890575,72,118000,0,95.0,139,2023-04-07T20:19,0,118000
342,2131513,73,399000,0,99.0,120,2023-04-07T20:19,0,399000
343,2306062,74,89000,139000,97.0,1186,2023-04-07T20:19,-8900,80100
344,3034743,75,75600,84000,96.0,208,2023-04-07T20:19,0,75600
345,2770504,76,138000,0,96.0,135,2023-04-07T20:19,0,138000
346,2809008,77,806000,1225000,92.0,13,2023-04-07T20:19,0,806000
347,2657250,78,125400,149000,98.0,119,2023-04-07T20:19,0,125400
348,1749492,79,89100,99000,98.0,3870,2023-04-07T20:19,0,89100
349,3038001,80,74700,83000,97.0,83,2023-04-07T20:19,-14940,59760
350,2245910,81,46000,69000,95.0,734,2023-04-07T20:19,-4600,41400
351,3116532,82,362000,0,0.0,0,2023-04-07T20:19,0,362000
352,1263004,83,159000,0,97.0,5253,2023-04-07T20:19,0,159000
353,2852737,84,145800,162000,97.0,66,2023-04-07T20:19,-14580,131220
354,2514819,85,55000,66000,97.0,836,2023-04-07T20:19,-2750,52250
355,2771875,86,349000,0,96.0,104,2023-04-07T20:19,0,349000
356,2975285,87,55250,65000,98.0,311,2023-04-07T20:19,0,55250
357,1216585,88,29800,59000,95.0,13929,2023-04-07T20:19,-2980,26820
358,2679537,89,145800,162000,95.0,98,2023-04-07T20:19,-14580,131220
359,3108820,90,259000,0,100.0,4,2023-04-07T20:19,0,259000
360,3186808,1,135000,0,0.0,0,2023-04-07T20:19,0,135000
361,2545799,2,149000,0,98.0,2105,2023-04-07T20:19,0,149000
362,1762407,3,260000,0,97.0,3251,2023-04-07T20:19,0,260000
363,969541,4,69000,0,97.0,29545,2023-04-07T20:19,0,69000
364,1762406,5,260000,0,98.0,3326,2023-04-07T20:19,0,260000
365,2849855,6,348500,970000,80.0,1,2023-04-07T20:19,0,348500
366,2638067,7,99000,139000,97.0,3074,2023-04-07T20:19,0,99000
367,810034,8,85500,95000,97.0,45213,2023-04-07T20:19,0,85500
368,1622069,9,119000,0,98.0,5782,2023-04-07T20:19,0,119000
369,311052,10,53100,59000,97.0,41172,2023-04-07T20:19,0,53100
370,1622068,11,119000,0,97.0,6636,2023-04-07T20:19,0,119000
371,1990244,12,129000,0,98.0,1077,2023-04-07T20:19,0,129000
372,2293400,13,129000,0,96.0,978,2023-04-07T20:19,0,129000
373,2320478,14,129000,0,97.0,509,2023-04-07T20:19,0,129000
374,2786814,15,149000,0,98.0,184,2023-04-07T20:19,0,149000
375,181907,16,89900,119000,97.0,7124,2023-04-07T20:19,0,89900
376,695334,17,78900,99000,96.0,9383,2023-04-07T20:19,0,78900
377,1493265,18,85500,95000,98.0,4912,2023-04-07T20:19,0,85500
378,2233180,19,75900,109000,97.0,14198,2023-04-07T20:19,0,75900
379,716244,20,54900,95000,98.0,1194,2023-04-07T20:19,0,54900
380,1792640,21,99000,0,98.0,3547,2023-04-07T20:19,0,99000
381,1900420,22,129000,0,96.0,1495,2023-04-07T20:19,0,129000
382,1900410,23,129000,0,97.0,4890,2023-04-07T20:19,0,129000
383,2741233,24,109000,0,97.0,2724,2023-04-07T20:19,0,109000
384,810033,25,89100,99000,97.0,34249,2023-04-07T20:19,0,89100
385,3172975,26,260000,0,0.0,0,2023-04-07T20:19,0,260000
386,3033248,27,109000,0,97.0,644,2023-04-07T20:19,0,109000
387,186610,28,59900,85000,97.0,16537,2023-04-07T20:19,0,59900
388,1296778,29,99000,0,98.0,2107,2023-04-07T20:19,0,99000
389,816033,30,57900,89000,96.0,13299,2023-04-07T20:19,0,57900
390,490091,31,36900,69000,97.0,977,2023-04-07T20:19,0,36900
391,1231944,32,119000,0,97.0,1303,2023-04-07T20:19,0,119000
392,490135,33,75900,95000,97.0,3275,2023-04-07T20:19,0,75900
393,490136,34,76000,95000,98.0,2301,2023-04-07T20:19,0,76000
394,2909715,35,119000,0,97.0,89,2023-04-07T20:19,0,119000
395,2778805,36,99000,0,97.0,994,2023-04-07T20:19,0,99000
396,311050,37,53100,59000,97.0,9043,2023-04-07T20:19,0,53100
397,577636,38,99900,139000,95.0,31181,2023-04-07T20:19,0,99900
398,3079037,39,195000,0,97.0,249,2023-04-07T20:19,0,195000
399,1494180,40,71100,79000,95.0,5246,2023-04-07T20:19,0,71100
400,2207771,41,44900,89000,95.0,456,2023-04-07T20:19,0,44900
401,3145338,42,105000,0,0.0,0,2023-04-07T20:19,0,105000
402,810032,43,85500,95000,97.0,13751,2023-04-07T20:19,0,85500
403,2239046,44,306000,0,98.0,253,2023-04-07T20:19,-45900,260100
404,2440110,45,59900,0,97.0,1045,2023-04-07T20:19,0,59900
405,3030422,46,139000,0,96.0,844,2023-04-07T20:19,0,139000
406,1798273,47,63070,119000,96.0,1179,2023-04-07T20:19,0,63070
407,1130307,48,109000,0,97.0,6056,2023-04-07T20:19,0,109000
408,2229208,49,109000,0,97.0,1610,2023-04-07T20:19,0,109000
409,2139107,50,44900,89000,95.0,388,2023-04-07T20:19,0,44900
410,102620,51,69000,0,97.0,17873,2023-04-07T20:19,0,69000
411,2233178,52,75900,109000,97.0,4943,2023-04-07T20:19,0,75900
412,1955217,53,69000,109000,96.0,5189,2023-04-07T20:19,-13800,55200
413,2469965,54,94900,149000,96.0,1086,2023-04-07T20:19,0,94900
414,2631192,55,98100,109000,98.0,381,2023-04-07T20:19,0,98100
415,1493263,56,89100,99000,98.0,4230,2023-04-07T20:19,0,89100
416,2524840,57,139000,0,97.0,855,2023-04-07T20:19,0,139000
417,1478592,58,75900,95000,97.0,3017,2023-04-07T20:19,0,75900
418,2030626,59,103500,115000,97.0,8053,2023-04-07T20:19,0,103500
419,3091287,60,119000,0,98.0,298,2023-04-07T20:19,0,119000
420,3096431,61,139000,0,99.0,43,2023-04-07T20:19,0,139000
421,2899664,62,78900,159000,96.0,119,2023-04-07T20:19,0,78900
422,1853613,63,130000,0,96.0,101,2023-04-07T20:19,0,130000
423,2355071,64,265000,0,98.0,505,2023-04-07T20:19,0,265000
424,2861392,65,124900,139000,97.0,580,2023-04-07T20:19,0,124900
425,1729744,66,76500,85000,97.0,3357,2023-04-07T20:19,0,76500
426,311051,67,58500,65000,97.0,19564,2023-04-07T20:19,0,58500
427,1296776,68,99000,0,98.0,2938,2023-04-07T20:19,0,99000
428,1354129,69,67000,99000,95.0,8708,2023-04-07T20:19,-13400,53600
429,2268512,70,109000,0,97.0,444,2023-04-07T20:19,0,109000
430,3149760,71,89100,99000,97.0,14,2023-04-07T20:19,0,89100
431,3034434,72,115000,0,90.0,4,2023-04-07T20:19,0,115000
432,2825931,73,54900,79000,97.0,1936,2023-04-07T20:19,0,54900
433,1473136,74,119900,149000,97.0,10784,2023-04-07T20:19,0,119900
434,810031,75,89100,99000,97.0,7867,2023-04-07T20:19,0,89100
435,1256468,76,109000,0,97.0,3558,2023-04-07T20:19,0,109000
436,2970200,77,79000,0,98.0,518,2023-04-07T20:19,0,79000
437,2855992,78,159000,0,97.0,564,2023-04-07T20:19,0,159000
438,1955210,79,69000,109000,95.0,1515,2023-04-07T20:19,-13800,55200
439,2818756,80,1030000,0,90.0,2,2023-04-07T20:19,0,1030000
440,2731878,81,67900,79000,97.0,1663,2023-04-07T20:19,0,67900
441,1635193,82,69900,0,96.0,3687,2023-04-07T20:19,0,69900
442,3172970,83,148000,0,99.0,22,2023-04-07T20:19,0,148000
443,2297397,84,129000,0,96.0,215,2023-04-07T20:19,0,129000
444,2312772,85,69900,139800,96.0,1379,2023-04-07T20:19,0,69900
445,2019709,86,69000,0,97.0,290,2023-04-07T20:19,-6900,62100
446,2777033,87,477000,815000,93.0,19,2023-04-07T20:19,0,477000
447,2756002,88,133200,148000,95.0,107,2023-04-07T20:19,-6660,126540
448,2819014,89,49900,79000,95.0,164,2023-04-07T20:19,0,49900
449,104240,90,69000,0,96.0,3865,2023-04-07T20:19,0,69000
450,1092992,1,69000,0,97.0,37842,2023-04-07T20:19,0,69000
451,1720813,2,149000,0,97.0,427,2023-04-07T20:19,0,149000
452,3124961,3,62100,69000,98.0,85,2023-04-07T20:19,-3105,58995
453,3061996,4,88200,98000,97.0,79,2023-04-07T20:19,-4410,83790
454,3062046,5,78300,87000,96.0,107,2023-04-07T20:19,-3915,74385
455,3134621,6,136800,152000,0.0,0,2023-04-07T20:19,-6840,129960
456,1720822,7,209000,0,97.0,296,2023-04-07T20:19,0,209000
457,3134606,8,125100,139000,0.0,0,2023-04-07T20:19,-6255,118845
458,3062069,9,71100,79000,98.0,30,2023-04-07T20:19,-3555,67545
459,2736221,10,104500,110000,96.0,256,2023-04-07T20:19,0,104500
460,3161736,11,67900,158000,0.0,0,2023-04-07T20:19,0,67900
461,2433538,12,86700,102000,96.0,2392,2023-04-07T20:19,-6069,80631
462,1339622,13,42900,59000,97.0,16294,2023-04-07T20:19,0,42900
463,2816812,14,119900,0,92.0,1527,2023-04-07T20:19,0,119900
464,3075621,15,339000,0,98.0,63,2023-04-07T20:19,0,339000
465,2736110,16,154000,220000,98.0,117,2023-04-07T20:19,0,154000
466,2091749,17,80100,89000,95.0,6229,2023-04-07T20:19,0,80100
467,2852654,18,649500,1450000,0.0,0,2023-04-07T20:19,-30000,619500
468,595040,19,210000,0,95.0,8742,2023-04-07T20:19,0,210000
469,1952910,20,265500,295000,98.0,1728,2023-04-07T20:19,0,265500
470,2816816,21,143890,159900,97.0,1865,2023-04-07T20:19,0,143890
471,595039,22,210000,0,97.0,3515,2023-04-07T20:19,0,210000
472,1897197,23,53100,59000,96.0,951,2023-04-07T20:19,0,53100
473,2432733,24,44900,59000,97.0,2802,2023-04-07T20:19,0,44900
474,2880951,25,513000,980000,0.0,0,2023-04-07T20:19,0,513000
475,1334438,26,170000,0,96.0,4396,2023-04-07T20:19,0,170000
476,1129750,27,69000,0,97.0,3925,2023-04-07T20:19,0,69000
477,2101924,28,99900,0,96.0,1368,2023-04-07T20:19,0,99900
478,1762562,29,92500,109000,95.0,293,2023-04-07T20:19,0,92500
479,2621831,30,59800,85000,95.0,716,2023-04-07T20:19,-5980,53820
480,3156683,31,299000,0,100.0,6,2023-04-07T20:19,0,299000
481,2624538,32,40900,59000,97.0,1462,2023-04-07T20:19,0,40900
482,2664373,33,65000,0,97.0,1010,2023-04-07T20:19,0,65000
483,2237841,34,195000,0,98.0,60,2023-04-07T20:19,0,195000
484,3124959,35,52200,58000,96.0,38,2023-04-07T20:19,-2610,49590
485,1890398,36,138000,168000,96.0,2727,2023-04-07T20:19,-9660,128340
486,3093902,37,169000,0,97.0,17,2023-04-07T20:19,0,169000
487,3134563,38,88200,98000,0.0,0,2023-04-07T20:19,-4410,83790
488,665782,39,260000,0,95.0,3637,2023-04-07T20:19,0,260000
489,2650879,40,169000,0,100.0,20,2023-04-07T20:19,0,169000
490,2414019,41,319000,980000,100.0,8,2023-04-07T20:19,0,319000
491,2440524,42,69000,0,97.0,1539,2023-04-07T20:19,-6900,62100
492,3097631,43,95000,0,100.0,1,2023-04-07T20:19,0,95000
493,501198,44,129000,139000,95.0,2741,2023-04-07T20:19,0,129000
494,3132471,45,79000,0,100.0,3,2023-04-07T20:19,-7900,71100
495,2518112,46,89250,105000,96.0,967,2023-04-07T20:19,-6248,83002
496,2435822,47,94500,99000,97.0,243,2023-04-07T20:19,0,94500
497,1262089,48,300000,0,97.0,1590,2023-04-07T20:19,0,300000
498,1891201,49,155000,0,98.0,192,2023-04-07T20:19,0,155000
499,2664372,50,65000,0,97.0,1063,2023-04-07T20:19,0,65000
500,1419869,51,70300,74000,95.0,10568,2023-04-07T20:19,0,70300
501,3049313,52,57100,64900,97.0,557,2023-04-07T20:19,0,57100
502,1438359,53,98000,0,97.0,1179,2023-04-07T20:19,0,98000
503,1891202,54,165000,0,98.0,91,2023-04-07T20:19,0,165000
504,2395327,55,149000,0,97.0,543,2023-04-07T20:19,0,149000
505,2791587,56,150000,300000,93.0,19,2023-04-07T20:19,0,150000
506,1262092,57,250000,0,96.0,772,2023-04-07T20:19,0,250000
507,2210207,58,299000,0,92.0,116,2023-04-07T20:19,0,299000
508,2355318,59,109900,0,96.0,643,2023-04-07T20:19,0,109900
509,1926895,60,49900,108000,93.0,4166,2023-04-07T20:19,0,49900
510,3052437,61,139500,155000,97.0,45,2023-04-07T20:19,-27900,111600
511,1754219,62,31200,39000,96.0,2252,2023-04-07T20:19,0,31200
512,2363570,63,39900,55000,97.0,1005,2023-04-07T20:19,0,39900
513,2690519,64,73800,82000,96.0,178,2023-04-07T20:19,-3690,70110
514,3132539,65,69000,0,100.0,2,2023-04-07T20:19,-6900,62100
515,2919224,66,670000,1000000,0.0,0,2023-04-07T20:19,0,670000
516,1730341,67,180600,258000,96.0,423,2023-04-07T20:19,0,180600
517,685185,68,148000,198000,95.0,12490,2023-04-07T20:19,-10360,137640
518,1439535,69,49000,0,96.0,16316,2023-04-07T20:19,0,49000
519,1568047,70,159000,0,95.0,12010,2023-04-07T20:19,0,159000
520,1699941,71,67150,79000,97.0,4853,2023-04-07T20:19,-3358,63792
521,2378986,72,159000,0,93.0,20,2023-04-07T20:19,0,159000
522,451851,73,268000,0,97.0,1951,2023-04-07T20:19,0,268000
523,2430426,74,169000,0,98.0,734,2023-04-07T20:19,0,169000
524,3134565,75,94500,105000,0.0,0,2023-04-07T20:19,-4725,89775
525,1215246,76,54300,110000,95.0,364,2023-04-07T20:19,0,54300
526,1815709,77,138000,168000,96.0,7130,2023-04-07T20:19,-9660,128340
527,3172972,78,138000,0,100.0,6,2023-04-07T20:19,0,138000
528,3156658,79,299000,0,100.0,3,2023-04-07T20:19,0,299000
529,1730340,80,258000,0,97.0,4188,2023-04-07T20:19,0,258000
530,2071613,81,99000,0,92.0,1502,2023-04-07T20:19,0,99000
531,3097632,82,95000,0,100.0,3,2023-04-07T20:19,0,95000
532,2340324,83,179100,199000,97.0,182,2023-04-07T20:19,0,179100
533,2143833,84,91800,108000,96.0,2418,2023-04-07T20:19,-6426,85374
534,1815692,85,137000,167000,95.0,992,2023-04-07T20:19,-9590,127410
535,2383245,86,99000,0,98.0,824,2023-04-07T20:19,0,99000
536,2910082,87,265500,295000,98.0,472,2023-04-07T20:19,0,265500
537,1010925,88,170000,0,96.0,2088,2023-04-07T20:19,0,170000
538,2503158,89,79800,84000,92.0,366,2023-04-07T20:19,0,79800
539,3153724,90,249000,0,0.0,0,2023-04-07T20:19,0,249000
540,1822717,1,56050,59000,97.0,4310,2023-04-07T20:19,-2803,53247
541,2280117,2,35100,39000,97.0,6256,2023-04-07T20:19,0,35100
542,1214164,3,36000,0,96.0,24909,2023-04-07T20:19,0,36000
543,2879419,4,46900,55000,98.0,702,2023-04-07T20:19,0,46900
544,1771137,5,26100,29000,97.0,12501,2023-04-07T20:19,0,26100
545,2134140,6,39000,0,97.0,3510,2023-04-07T20:19,0,39000
546,1214109,7,36000,0,97.0,8118,2023-04-07T20:19,0,36000
547,1022014,8,79000,0,96.0,11435,2023-04-07T20:19,0,79000
548,1214174,9,36000,0,97.0,15025,2023-04-07T20:19,0,36000
549,2286829,10,37000,0,95.0,4944,2023-04-07T20:19,0,37000
550,1272626,11,36000,0,96.0,14128,2023-04-07T20:19,0,36000
551,1214173,12,36000,0,96.0,5559,2023-04-07T20:19,0,36000
552,1022013,13,79000,0,96.0,6260,2023-04-07T20:19,0,79000
553,2879425,14,46900,55000,98.0,285,2023-04-07T20:19,0,46900
554,2028240,15,39000,0,98.0,3342,2023-04-07T20:19,0,39000
555,1771132,16,26100,29000,96.0,5242,2023-04-07T20:19,0,26100
556,1920929,17,39000,0,97.0,3966,2023-04-07T20:19,0,39000
557,3039055,18,43000,0,94.0,37,2023-04-07T20:19,0,43000
558,2123132,19,39000,0,97.0,6384,2023-04-07T20:19,-3900,35100
559,2356693,20,39000,0,97.0,1520,2023-04-07T20:19,0,39000
560,1925814,21,35100,39000,96.0,1648,2023-04-07T20:19,0,35100
561,2356713,22,39000,0,97.0,1455,2023-04-07T20:19,0,39000
562,2134158,23,39000,0,97.0,2496,2023-04-07T20:19,0,39000
563,2464070,24,44000,55000,96.0,352,2023-04-07T20:19,-2200,41800
564,2864918,25,49000,0,99.0,125,2023-04-07T20:19,0,49000
565,2107999,26,36000,0,97.0,2664,2023-04-07T20:19,0,36000
566,3012243,27,29900,39900,98.0,64,2023-04-07T20:19,-2093,27807
567,1855444,28,39900,42000,97.0,3012,2023-04-07T20:19,0,39900
568,1214317,29,36000,0,97.0,11480,2023-04-07T20:19,0,36000
569,1214169,30,36000,0,97.0,5321,2023-04-07T20:19,0,36000
570,3142351,31,49000,0,100.0,16,2023-04-07T20:19,-4900,44100
571,1907733,32,29900,39000,96.0,3830,2023-04-07T20:19,0,29900
572,1214171,33,36000,0,97.0,1705,2023-04-07T20:19,0,36000
573,1497550,34,29600,37000,95.0,5677,2023-04-07T20:19,0,29600
574,1602670,35,56050,59000,97.0,741,2023-04-07T20:19,0,56050
575,2356711,36,39000,0,98.0,1487,2023-04-07T20:19,0,39000
576,1771133,37,26100,29000,97.0,5695,2023-04-07T20:19,0,26100
577,1906772,38,39900,42000,97.0,3062,2023-04-07T20:19,0,39900
578,3125906,39,80100,89000,100.0,7,2023-04-07T20:19,0,80100
579,1214106,40,36000,0,96.0,9734,2023-04-07T20:19,0,36000
580,2715553,41,68000,0,95.0,255,2023-04-07T20:19,0,68000
581,2559153,42,353750,475000,0.0,0,2023-04-07T20:19,0,353750
582,2221221,43,35100,39000,96.0,1860,2023-04-07T20:19,0,35100
583,3142349,44,49000,0,100.0,7,2023-04-07T20:19,-4900,44100
584,2287131,45,27750,37000,95.0,1629,2023-04-07T20:19,0,27750
585,1214316,46,36000,0,97.0,1985,2023-04-07T20:19,0,36000
586,2089719,47,36000,0,97.0,2408,2023-04-07T20:19,0,36000
587,2953795,48,207450,461000,0.0,0,2023-04-07T20:19,0,207450
588,2280146,49,35100,39000,97.0,926,2023-04-07T20:19,0,35100
589,2690211,50,371000,600000,100.0,2,2023-04-07T20:19,0,371000
590,2329375,51,34710,39000,96.0,2087,2023-04-07T20:19,0,34710
591,2687157,52,45000,0,97.0,1036,2023-04-07T20:19,0,45000
592,3092582,53,29400,42000,99.0,30,2023-04-07T20:19,0,29400
593,2683883,54,69000,0,97.0,123,2023-04-07T20:19,0,69000
594,2560668,55,58650,69000,97.0,1246,2023-04-07T20:19,0,58650
595,3153584,56,45000,0,99.0,36,2023-04-07T20:19,-2250,42750
596,2134287,57,39000,0,98.0,705,2023-04-07T20:19,0,39000
597,2384630,58,42000,0,98.0,757,2023-04-07T20:19,0,42000
598,3115995,59,59000,0,0.0,0,2023-04-07T20:19,0,59000
599,1771121,60,26100,29000,96.0,2272,2023-04-07T20:19,0,26100
600,2169131,61,35100,39000,96.0,438,2023-04-07T20:19,0,35100
601,1535402,62,39000,0,97.0,1197,2023-04-07T20:19,0,39000
602,1214193,63,39000,0,97.0,15347,2023-04-07T20:19,0,39000
603,1632175,64,39000,0,97.0,2705,2023-04-07T20:19,-3900,35100
604,2672186,65,20900,30000,96.0,577,2023-04-07T20:19,-2090,18810
605,1086824,66,29600,37000,95.0,18622,2023-04-07T20:19,0,29600
606,1524720,67,36000,0,96.0,3376,2023-04-07T20:19,0,36000
607,2089720,68,36000,0,96.0,292,2023-04-07T20:19,0,36000
608,2329376,69,34710,39000,96.0,593,2023-04-07T20:19,0,34710
609,1931716,70,56050,59000,97.0,246,2023-04-07T20:19,0,56050
610,3057129,71,37800,42000,94.0,7,2023-04-07T20:19,-3780,34020
611,1335132,72,29000,0,95.0,1103,2023-04-07T20:19,0,29000
612,2152223,73,36000,0,98.0,785,2023-04-07T20:19,0,36000
613,2650964,74,46900,53000,98.0,187,2023-04-07T20:19,0,46900
614,2707659,75,37800,42000,97.0,512,2023-04-07T20:19,0,37800
615,2391539,76,49000,0,97.0,449,2023-04-07T20:19,0,49000
616,2289281,77,29640,38000,96.0,880,2023-04-07T20:19,0,29640
617,1761934,78,41650,49000,95.0,546,2023-04-07T20:19,0,41650
618,3088347,79,35100,39000,98.0,30,2023-04-07T20:19,-1755,33345
619,2879417,80,46900,55000,98.0,194,2023-04-07T20:19,0,46900
620,1927036,81,31200,39000,95.0,673,2023-04-07T20:19,0,31200
621,3099127,82,54000,0,100.0,8,2023-04-07T20:19,0,54000
622,2134295,83,39000,0,97.0,401,2023-04-07T20:19,0,39000
623,2381807,84,58650,69000,98.0,1150,2023-04-07T20:19,0,58650
624,2998516,85,29000,0,96.0,149,2023-04-07T20:19,0,29000
625,3142347,86,49000,0,100.0,4,2023-04-07T20:19,-4900,44100
626,1126959,87,29250,39000,91.0,2556,2023-04-07T20:19,0,29250
627,1836697,88,79000,0,97.0,455,2023-04-07T20:19,0,79000
628,2864774,89,49000,0,98.0,90,2023-04-07T20:19,0,49000
629,2650965,90,46900,53000,98.0,369,2023-04-07T20:19,0,46900
630,2781049,1,642500,1285000,100.0,3,2023-04-07T20:19,-30000,612500
631,2568529,2,220000,0,100.0,10,2023-04-07T20:19,0,220000
632,1455772,3,94000,0,96.0,209,2023-04-07T20:19,0,94000
633,3206552,4,106400,112000,0.0,0,2023-04-07T20:19,0,106400
634,3190601,5,334000,478000,0.0,0,2023-04-07T20:19,-33400,300600
635,3106487,6,148000,0,99.0,26,2023-04-07T20:19,0,148000
636,3138204,7,139500,155000,0.0,0,2023-04-07T20:19,-6975,132525
637,3153593,8,151200,168000,0.0,0,2023-04-07T20:19,-22680,128520
638,1871030,9,133600,167000,95.0,100,2023-04-07T20:19,0,133600
639,3085842,10,290000,0,0.0,0,2023-04-07T20:19,-52200,237800
640,3104986,11,290000,0,0.0,0,2023-04-07T20:19,-52200,237800
641,3130645,12,119000,0,0.0,0,2023-04-07T20:19,0,119000
642,2605850,13,94000,0,97.0,167,2023-04-07T20:19,0,94000
643,3145625,14,249000,0,0.0,0,2023-04-07T20:19,-12450,236550
644,2556295,15,259000,0,80.0,1,2023-04-07T20:19,0,259000
645,2727829,16,251300,359000,0.0,0,2023-04-07T20:19,-12565,238735
646,1103286,17,94000,0,94.0,781,2023-04-07T20:19,0,94000
647,3155026,18,50700,78000,100.0,8,2023-04-07T20:19,-10140,40560
648,2377832,19,195000,0,95.0,174,2023-04-07T20:19,0,195000
649,2801900,20,59900,79900,95.0,8,2023-04-07T20:19,0,59900
650,3149931,21,109000,0,100.0,1,2023-04-07T20:19,0,109000
651,3102534,22,220000,0,0.0,0,2023-04-07T20:19,0,220000
652,3207542,23,198000,0,0.0,0,2023-04-07T20:19,0,198000
653,3140510,24,198000,0,0.0,0,2023-04-07T20:19,0,198000
654,3053225,25,159000,0,100.0,2,2023-04-07T20:19,0,159000
655,3041848,26,168000,0,0.0,0,2023-04-07T20:19,0,168000
656,3059119,27,179000,0,91.0,19,2023-04-07T20:19,-32220,146780
657,3050173,28,166600,238000,100.0,1,2023-04-07T20:19,0,166600
658,3081772,29,189000,0,0.0,0,2023-04-07T20:19,0,189000
659,2492543,30,169000,0,95.0,13,2023-04-07T20:19,-30420,138580
660,3081771,31,189000,0,100.0,5,2023-04-07T20:19,0,189000
661,2612820,32,198000,0,0.0,0,2023-04-07T20:19,0,198000
662,3050856,33,189000,0,93.0,12,2023-04-07T20:19,0,189000
663,2870967,34,189000,0,100.0,1,2023-04-07T20:19,0,189000
664,2970900,35,189000,0,100.0,6,2023-04-07T20:19,0,189000
665,3098220,36,189000,0,0.0,0,2023-04-07T20:19,0,189000
666,3148902,37,179100,199000,0.0,0,2023-04-07T20:19,0,179100
667,3132939,38,158000,0,0.0,0,2023-04-07T20:19,0,158000
668,2617653,39,183000,0,100.0,1,2023-04-07T20:19,0,183000
669,3146771,40,179100,199000,0.0,0,2023-04-07T20:19,-26865,152235
670,3173656,41,160200,178000,0.0,0,2023-04-07T20:19,0,160200
671,3138201,42,139500,155000,0.0,0,2023-04-07T20:19,-6975,132525
672,3174225,43,161100,179000,0.0,0,2023-04-07T20:19,-24165,136935
673,2631858,44,174000,290000,0.0,0,2023-04-07T20:19,0,174000
674,3083240,45,168000,0,0.0,0,2023-04-07T20:19,0,168000
675,2569941,46,139000,0,96.0,18,2023-04-07T20:19,0,139000
676,2791520,47,168000,0,0.0,0,2023-04-07T20:19,0,168000
677,2558167,48,151240,199000,97.0,9,2023-04-07T20:19,0,151240
678,3170245,49,143000,159000,0.0,0,2023-04-07T20:19,0,143000
679,2966694,50,156000,0,100.0,1,2023-04-07T20:19,0,156000
680,3194281,51,158000,0,0.0,0,2023-04-07T20:19,0,158000
681,3037449,52,139300,199000,80.0,3,2023-04-07T20:19,0,139300
682,2392491,53,31900,0,96.0,397,2023-04-07T20:19,0,31900
683,3135904,54,92000,0,100.0,5,2023-04-07T20:19,0,92000
684,2415480,55,148000,0,97.0,9,2023-04-07T20:19,0,148000
685,3166877,56,129000,0,0.0,0,2023-04-07T20:19,0,129000
686,3138202,57,139500,155000,0.0,0,2023-04-07T20:19,-6975,132525
687,3135234,58,80100,89000,100.0,3,2023-04-07T20:19,-12015,68085
688,3132901,59,143100,159000,0.0,0,2023-04-07T20:19,0,143100
689,3104786,60,139000,0,0.0,0,2023-04-07T20:19,0,139000
690,3206551,61,106400,112000,0.0,0,2023-04-07T20:19,0,106400
691,2388209,62,94000,0,96.0,156,2023-04-07T20:19,0,94000
692,3074707,63,119000,0,100.0,4,2023-04-07T20:19,0,119000
693,2589503,64,134100,149000,100.0,3,2023-04-07T20:19,0,134100
694,3120610,65,134100,149000,0.0,0,2023-04-07T20:19,-20115,113985
695,3137343,66,139000,0,0.0,0,2023-04-07T20:19,0,139000
696,3159326,67,128000,0,0.0,0,2023-04-07T20:19,0,128000
697,3162911,68,71100,79000,0.0,0,2023-04-07T20:19,0,71100
698,3065781,69,125300,179000,90.0,2,2023-04-07T20:19,0,125300
699,2612357,70,69000,139000,96.0,15,2023-04-07T20:19,0,69000
700,3050857,71,129000,0,93.0,9,2023-04-07T20:19,0,129000
701,3059068,72,129000,0,88.0,5,2023-04-07T20:19,-23220,105780
702,3079285,73,128000,0,0.0,0,2023-04-07T20:19,-23040,104960
703,2594075,74,129000,0,0.0,0,2023-04-07T20:19,0,129000
704,3155023,75,50700,78000,0.0,0,2023-04-07T20:19,-10140,40560
705,2154457,76,129000,0,0.0,0,2023-04-07T20:19,0,129000
706,2854238,77,87500,125000,0.0,0,2023-04-07T20:19,0,87500
707,1156787,78,116000,145000,94.0,85,2023-04-07T20:19,0,116000
708,2754028,79,125300,179000,95.0,4,2023-04-07T20:19,0,125300
709,987352,80,41300,59000,93.0,589,2023-04-07T20:19,0,41300
710,2512635,81,35400,59000,96.0,206,2023-04-07T20:19,0,35400
711,3121891,82,109000,119000,0.0,0,2023-04-07T20:19,0,109000
712,2393504,83,94000,0,99.0,49,2023-04-07T20:19,0,94000
713,3144159,84,115000,0,0.0,0,2023-04-07T20:19,0,115000
714,3080581,85,113050,119000,100.0,1,2023-04-07T20:19,-5653,107397
715,2589736,86,116100,129000,100.0,1,2023-04-07T20:19,0,116100
716,3149929,87,109000,0,0.0,0,2023-04-07T20:19,0,109000
717,3144157,88,109000,0,0.0,0,2023-04-07T20:19,0,109000
718,2934516,89,114100,163000,100.0,2,2023-04-07T20:19,0,114100
719,3053501,90,106200,118000,80.0,5,2023-04-07T20:19,0,106200
720,2378594,1,88200,98000,95.0,126,2023-04-07T20:19,0,88200
721,3099774,2,238000,0,100.0,5,2023-04-07T20:19,0,238000
722,2551401,3,37900,0,94.0,305,2023-04-07T20:19,0,37900
723,3147255,4,378000,0,0.0,0,2023-04-07T20:19,-45360,332640
724,3070530,5,168000,0,0.0,0,2023-04-07T20:19,0,168000
725,2830808,6,139000,0,97.0,16,2023-04-07T20:19,0,139000
726,3118978,7,318000,0,80.0,1,2023-04-07T20:19,-38160,279840
727,3133745,8,315000,0,0.0,0,2023-04-07T20:19,-31500,283500
728,3038057,9,107100,119000,91.0,9,2023-04-07T20:19,0,107100
729,2830788,10,139000,0,96.0,26,2023-04-07T20:19,0,139000
730,3112821,11,304000,320000,0.0,0,2023-04-07T20:19,-45600,258400
731,3149629,12,125100,139000,0.0,0,2023-04-07T20:19,-18765,106335
732,3190572,13,264000,378000,0.0,0,2023-04-07T20:19,-26400,237600
733,2788546,14,279000,0,100.0,3,2023-04-07T20:19,0,279000
734,2864414,15,69300,99000,94.0,86,2023-04-07T20:19,0,69300
735,2377814,16,188100,198000,97.0,74,2023-04-07T20:19,-22572,165528
736,2713339,17,141000,470000,100.0,1,2023-04-07T20:19,0,141000
737,3051039,18,95200,119000,100.0,18,2023-04-07T20:19,0,95200
738,2850491,19,250600,358000,100.0,5,2023-04-07T20:19,-25060,225540
739,3142895,20,89100,99000,0.0,0,2023-04-07T20:19,0,89100
740,3206525,21,84550,89000,0.0,0,2023-04-07T20:19,0,84550
741,3190561,22,264000,378000,0.0,0,2023-04-07T20:19,-26400,237600
742,3051036,23,95200,119000,100.0,7,2023-04-07T20:19,0,95200
743,1931894,24,37900,0,95.0,510,2023-04-07T20:19,0,37900
744,3120201,25,110400,138000,100.0,1,2023-04-07T20:19,-13248,97152
745,2441895,26,89000,0,94.0,20,2023-04-07T20:19,0,89000
746,3116912,27,238000,0,0.0,0,2023-04-07T20:19,0,238000
747,3040758,28,94400,111000,98.0,11,2023-04-07T20:19,0,94400
748,2889256,29,362000,1680000,0.0,0,2023-04-07T20:19,0,362000
749,1324169,30,29900,0,95.0,1331,2023-04-07T20:19,0,29900
750,3179291,31,218000,0,0.0,0,2023-04-07T20:19,-39240,178760
751,3132470,32,93000,0,0.0,0,2023-04-07T20:19,0,93000
752,2942764,33,189000,0,98.0,12,2023-04-07T20:19,0,189000
753,3056317,34,79900,0,100.0,1,2023-04-07T20:19,0,79900
754,2377804,35,188100,198000,93.0,37,2023-04-07T20:19,-22572,165528
755,3070525,36,148000,0,92.0,5,2023-04-07T20:19,0,148000
756,2849028,37,77500,0,0.0,0,2023-04-07T20:19,0,77500
757,3098351,38,161100,179000,100.0,1,2023-04-07T20:19,-24165,136935
758,3098868,39,195000,0,0.0,0,2023-04-07T20:19,0,195000
759,3206527,40,112100,118000,0.0,0,2023-04-07T20:19,0,112100
760,3073252,41,160200,178000,100.0,4,2023-04-07T20:19,-24030,136170
761,3154851,42,36400,56000,100.0,3,2023-04-07T20:19,-7280,29120
762,3133860,43,93000,98000,100.0,3,2023-04-07T20:19,-18600,74400
763,3202037,44,124000,0,100.0,2,2023-04-07T20:19,0,124000
764,2716675,45,39900,59000,96.0,174,2023-04-07T20:19,0,39900
765,2664573,46,178000,0,92.0,5,2023-04-07T20:19,0,178000
766,3123863,47,160200,178000,0.0,0,2023-04-07T20:19,-24030,136170
767,3073251,48,169200,188000,100.0,4,2023-04-07T20:19,-25380,143820
768,3133082,49,171000,0,80.0,3,2023-04-07T20:19,0,171000
769,2571671,50,149000,0,100.0,7,2023-04-07T20:19,0,149000
770,3072779,51,179000,0,0.0,0,2023-04-07T20:19,0,179000
771,3093753,52,94050,99000,0.0,0,2023-04-07T20:19,0,94050
772,2756335,53,125400,132000,97.0,60,2023-04-07T20:19,0,125400
773,3193136,54,141550,149000,0.0,0,2023-04-07T20:19,-7078,134472
774,3058718,55,96000,0,98.0,12,2023-04-07T20:19,-17280,78720
775,2117249,56,32900,0,94.0,454,2023-04-07T20:19,-3290,29610
776,3133119,57,171000,0,0.0,0,2023-04-07T20:19,0,171000
777,1819994,58,36500,43000,92.0,658,2023-04-07T20:19,0,36500
778,3194479,59,113050,119000,0.0,0,2023-04-07T20:19,-5653,107397
779,2771725,60,166600,238000,95.0,14,2023-04-07T20:19,-16660,149940
780,2836351,61,35280,72000,96.0,451,2023-04-07T20:19,0,35280
781,2537451,62,159000,0,100.0,2,2023-04-07T20:19,0,159000
782,3098355,63,161100,179000,0.0,0,2023-04-07T20:19,-24165,136935
783,3122281,64,160200,178000,100.0,1,2023-04-07T20:19,-24030,136170
784,3193246,65,141550,149000,0.0,0,2023-04-07T20:19,-7078,134472
785,1645760,66,43900,0,96.0,341,2023-04-07T20:19,0,43900
786,2942722,67,149000,0,100.0,2,2023-04-07T20:19,0,149000
787,3039835,68,158000,0,100.0,2,2023-04-07T20:19,0,158000
788,2544014,69,161000,230000,0.0,0,2023-04-07T20:19,0,161000
789,2836289,70,39530,59000,95.0,204,2023-04-07T20:19,-7906,31624
790,3115900,71,158000,0,0.0,0,2023-04-07T20:19,0,158000
791,2571642,72,149000,0,96.0,11,2023-04-07T20:19,0,149000
792,3135039,73,79000,0,0.0,0,2023-04-07T20:19,0,79000
793,3031104,74,55200,69000,98.0,59,2023-04-07T20:19,0,55200
794,3098755,75,153000,0,0.0,0,2023-04-07T20:19,-27540,125460
795,3000422,76,59000,0,97.0,27,2023-04-07T20:19,0,59000
796,3093403,77,149000,0,100.0,10,2023-04-07T20:19,0,149000
797,2643318,78,124000,138000,95.0,17,2023-04-07T20:19,-18600,105400
798,3093412,79,149000,0,100.0,2,2023-04-07T20:19,0,149000
799,2117253,80,43900,0,94.0,261,2023-04-07T20:19,0,43900
800,3040747,81,41400,46000,90.0,8,2023-04-07T20:19,0,41400
801,3122270,82,124200,138000,95.0,4,2023-04-07T20:19,-18630,105570
802,3104279,83,79900,0,0.0,0,2023-04-07T20:19,0,79900
803,3062185,84,128700,143000,100.0,5,2023-04-07T20:19,0,128700
804,2774431,85,139500,155000,100.0,1,2023-04-07T20:19,0,139500
805,2448902,86,37290,43900,94.0,99,2023-04-07T20:19,0,37290
806,3149785,87,139000,0,0.0,0,2023-04-07T20:19,0,139000
807,3121771,88,129000,0,100.0,1,2023-04-07T20:19,-23220,105780
808,3143011,89,139000,0,0.0,0,2023-04-07T20:19,0,139000
809,3037452,90,126650,149000,100.0,3,2023-04-07T20:19,0,126650
810,991339,1,17890,19900,97.0,52701,2023-04-07T20:19,0,17890
811,1986031,2,24990,27900,97.0,10558,2023-04-07T20:19,0,24990
812,998051,3,12900,24000,97.0,162640,2023-04-07T20:19,0,12900
813,1094748,4,19900,0,97.0,19114,2023-04-07T20:19,0,19900
814,991340,5,17890,19900,97.0,30831,2023-04-07T20:19,0,17890
815,763821,6,13900,22000,96.0,31354,2023-04-07T20:19,0,13900
816,1477845,7,15400,22000,96.0,9645,2023-04-07T20:19,0,15400
817,1094835,8,14290,15900,97.0,6204,2023-04-07T20:19,0,14290
818,2959925,9,22000,27500,99.0,100,2023-04-07T20:19,-2200,19800
819,1996705,10,23690,27900,98.0,2683,2023-04-07T20:19,0,23690
820,792919,11,15190,16900,96.0,17915,2023-04-07T20:19,0,15190
821,991570,12,12900,20000,97.0,19052,2023-04-07T20:19,0,12900
822,734085,13,10900,19800,96.0,64750,2023-04-07T20:19,0,10900
823,1443937,14,24000,0,97.0,7928,2023-04-07T20:19,0,24000
824,3118094,15,28800,32000,95.0,4,2023-04-07T20:19,0,28800
825,2845854,16,13200,18900,97.0,211,2023-04-07T20:19,0,13200
826,1986029,17,27900,0,97.0,3931,2023-04-07T20:19,0,27900
827,991341,18,16890,19900,96.0,10206,2023-04-07T20:19,0,16890
828,2297277,19,19900,22000,95.0,285,2023-04-07T20:19,0,19900
829,1821485,20,30000,0,96.0,1253,2023-04-07T20:19,0,30000
830,1729576,21,9500,13900,97.0,16063,2023-04-07T20:19,0,9500
831,1094749,22,19900,0,96.0,4954,2023-04-07T20:19,0,19900
832,1986030,23,23690,27900,97.0,1670,2023-04-07T20:19,0,23690
833,2832613,24,11200,33000,97.0,664,2023-04-07T20:19,0,11200
834,746158,25,18290,22900,96.0,20515,2023-04-07T20:19,0,18290
835,1974077,26,42090,46900,97.0,896,2023-04-07T20:19,0,42090
836,1094834,27,21490,23900,96.0,2457,2023-04-07T20:19,0,21490
837,3145349,28,19000,0,0.0,0,2023-04-07T20:19,0,19000
838,746159,29,18290,22900,95.0,28722,2023-04-07T20:19,0,18290
839,1094750,30,16890,19900,97.0,3557,2023-04-07T20:19,0,16890
840,746154,31,17900,0,96.0,5163,2023-04-07T20:19,0,17900
841,792921,32,15190,16900,95.0,7808,2023-04-07T20:19,0,15190
842,1996702,33,23690,27900,97.0,1928,2023-04-07T20:19,0,23690
843,1346009,34,9900,12000,97.0,6693,2023-04-07T20:19,0,9900
844,792920,35,15190,16900,96.0,9668,2023-04-07T20:19,0,15190
845,479245,36,15400,22000,93.0,5394,2023-04-07T20:19,0,15400
846,3009680,37,12590,14900,97.0,109,2023-04-07T20:19,0,12590
847,2821598,38,19390,22900,97.0,145,2023-04-07T20:19,0,19390
848,2973952,39,28800,48000,94.0,11,2023-04-07T20:19,-3456,25344
849,2477852,40,17890,19900,98.0,682,2023-04-07T20:19,0,17890
850,2011852,41,21490,23900,97.0,1302,2023-04-07T20:19,0,21490
851,472686,42,9500,14800,94.0,718,2023-04-07T20:19,0,9500
852,1996704,43,22290,27900,98.0,701,2023-04-07T20:19,0,22290
853,1260383,44,19900,0,95.0,1452,2023-04-07T20:19,0,19900
854,2929635,45,15900,27000,97.0,514,2023-04-07T20:19,0,15900
855,1346070,46,9900,12000,97.0,1873,2023-04-07T20:19,0,9900
856,3129048,47,19000,0,100.0,6,2023-04-07T20:19,-1900,17100
857,1260384,48,19900,0,95.0,1801,2023-04-07T20:19,0,19900
858,2649999,49,12800,16000,94.0,80,2023-04-07T20:19,0,12800
859,2346958,50,18200,24000,98.0,515,2023-04-07T20:19,0,18200
860,2509300,51,19900,0,96.0,393,2023-04-07T20:19,0,19900
861,2990345,52,27900,0,98.0,48,2023-04-07T20:19,0,27900
862,2342849,53,15120,18900,92.0,118,2023-04-07T20:19,0,15120
863,2960555,54,19000,0,94.0,98,2023-04-07T20:19,0,19000
864,752821,55,9900,0,94.0,23761,2023-04-07T20:19,0,9900
865,1573974,56,39790,46900,97.0,1451,2023-04-07T20:19,0,39790
866,3135826,57,45000,0,0.0,0,2023-04-07T20:19,0,45000
867,2835702,58,13900,15800,97.0,64,2023-04-07T20:19,-1390,12510
868,1475055,59,16200,22000,96.0,1174,2023-04-07T20:19,0,16200
869,1260388,60,20900,0,95.0,676,2023-04-07T20:19,0,20900
870,3065854,61,21250,25000,95.0,18,2023-04-07T20:19,0,21250
871,1777081,62,8000,12800,96.0,1175,2023-04-07T20:19,0,8000
872,391476,63,14900,23900,95.0,15770,2023-04-07T20:19,0,14900
873,2711708,64,26100,29000,98.0,68,2023-04-07T20:19,-5220,20880
874,1358721,65,14200,22000,96.0,1121,2023-04-07T20:19,0,14200
875,1392772,66,16890,19900,96.0,1137,2023-04-07T20:19,0,16890
876,2821588,67,19690,21900,97.0,53,2023-04-07T20:19,0,19690
877,1062063,68,9490,15900,96.0,2144,2023-04-07T20:19,0,9490
878,1360044,69,19900,0,97.0,1755,2023-04-07T20:19,0,19900
879,2821599,70,22900,0,97.0,119,2023-04-07T20:19,0,22900
880,2711712,71,26100,29000,0.0,0,2023-04-07T20:19,-5220,20880
881,2990344,72,27900,0,94.0,10,2023-04-07T20:19,0,27900
882,3197175,73,75050,79000,0.0,0,2023-04-07T20:19,-3753,71297
883,1724176,74,15900,22800,98.0,330,2023-04-07T20:19,0,15900
884,2798430,75,24000,29000,97.0,42,2023-04-07T20:19,-3600,20400
885,2545279,76,25130,35900,94.0,35,2023-04-07T20:19,0,25130
886,2773510,77,24700,27500,100.0,40,2023-04-07T20:19,0,24700
887,1477846,78,15400,22000,96.0,2673,2023-04-07T20:19,0,15400
888,1094836,79,14290,15900,97.0,1312,2023-04-07T20:19,0,14290
889,2973894,80,22000,27500,98.0,23,2023-04-07T20:19,-2200,19800
890,1121544,81,15190,16900,96.0,863,2023-04-07T20:19,0,15190
891,3113489,82,32000,0,100.0,1,2023-04-07T20:19,0,32000
892,1286366,83,11900,24000,97.0,9795,2023-04-07T20:19,0,11900
893,2122868,84,9500,13900,97.0,3846,2023-04-07T20:19,0,9500
894,2667555,85,23000,27000,100.0,13,2023-04-07T20:19,-3450,19550
895,746161,86,18290,22900,95.0,7734,2023-04-07T20:19,0,18290
896,1102048,87,22900,0,96.0,1137,2023-04-07T20:19,0,22900
897,1341061,88,13300,26500,97.0,2620,2023-04-07T20:19,0,13300
898,1092994,89,22900,0,96.0,2651,2023-04-07T20:19,0,22900
899,3040535,90,20900,22000,90.0,8,2023-04-07T20:19,0,20900
