,item_id,rank,price,del_price,rating,rating_count,time,coupon,real_price
0,1848166,1,44100,49000,97.0,40931,2023-04-04T22:24,0,44100
1,2272830,2,35910,39900,97.0,19069,2023-04-04T22:24,-3591,32319
2,3154713,3,49500,66000,0.0,0,2023-04-04T22:24,-4950,44550
3,345889,4,29900,47900,95.0,9714,2023-04-04T22:24,0,29900
4,2479911,5,49400,76000,97.0,4127,2023-04-04T22:24,0,49400
5,2442409,6,39000,78000,96.0,8823,2023-04-04T22:24,-3900,35100
6,2646350,7,59800,94000,95.0,4052,2023-04-04T22:24,-5980,53820
7,2086653,8,16900,0,97.0,39273,2023-04-04T22:24,0,16900
8,3154715,9,49500,66000,0.0,0,2023-04-04T22:24,-4950,44550
9,3187851,10,49900,110000,100.0,11,2023-04-04T22:24,0,49900
10,3180166,11,31200,39000,0.0,0,2023-04-04T22:24,0,31200
11,2149254,12,37800,0,97.0,32992,2023-04-04T22:24,-5670,32130
12,2377269,13,38250,45000,97.0,3835,2023-04-04T22:24,0,38250
13,2034137,14,31800,0,97.0,16944,2023-04-04T22:24,-4770,27030
14,1921901,15,36900,70500,96.0,7537,2023-04-04T22:24,0,36900
15,3154714,16,49500,66000,0.0,0,2023-04-04T22:24,-4950,44550
16,2996252,17,64000,117000,100.0,3,2023-04-04T22:24,0,64000
17,1706633,18,199000,0,97.0,2384,2023-04-04T22:24,0,199000
18,3154716,19,49500,66000,0.0,0,2023-04-04T22:24,-4950,44550
19,1763157,20,49400,52000,95.0,2621,2023-04-04T22:24,0,49400
20,1939099,21,34300,49000,97.0,11698,2023-04-04T22:24,0,34300
21,1005680,22,17500,35000,95.0,9034,2023-04-04T22:24,0,17500
22,1943792,23,34400,43000,96.0,5307,2023-04-04T22:24,0,34400
23,2457846,24,54900,82900,95.0,1438,2023-04-04T22:24,0,54900
24,2456003,25,54900,82900,95.0,2207,2023-04-04T22:24,0,54900
25,2409397,26,31500,45000,97.0,2720,2023-04-04T22:24,-3150,28350
26,996177,27,15900,0,95.0,77460,2023-04-04T22:24,0,15900
27,2122566,28,33800,0,97.0,15790,2023-04-04T22:24,-6760,27040
28,2996536,29,39900,59000,96.0,474,2023-04-04T22:24,-3990,35910
29,3180165,30,31200,39000,0.0,0,2023-04-04T22:24,0,31200
30,994588,31,39900,53000,93.0,5997,2023-04-04T22:24,-3990,35910
31,1944612,32,35800,59700,97.0,2845,2023-04-04T22:24,0,35800
32,854337,33,33900,0,95.0,17286,2023-04-04T22:24,0,33900
33,1884943,34,29900,39000,96.0,18848,2023-04-04T22:24,0,29900
34,1828538,35,39900,69900,95.0,2914,2023-04-04T22:24,0,39900
35,2364807,36,219000,0,96.0,695,2023-04-04T22:24,0,219000
36,2314616,37,39000,43000,97.0,8226,2023-04-04T22:24,0,39000
37,3154712,38,49500,66000,0.0,0,2023-04-04T22:24,-4950,44550
38,2376229,39,36000,0,97.0,3818,2023-04-04T22:24,0,36000
39,2038497,40,36000,45000,95.0,16255,2023-04-04T22:24,-3600,32400
40,1706634,41,199000,0,97.0,1531,2023-04-04T22:24,0,199000
41,1005683,42,17500,35000,95.0,10735,2023-04-04T22:24,0,17500
42,1817394,43,59900,150000,93.0,7155,2023-04-04T22:24,0,59900
43,2471760,44,35100,39000,97.0,6481,2023-04-04T22:24,-3510,31590
44,2396645,45,39900,59000,96.0,23393,2023-04-04T22:24,0,39900
45,3154711,46,49500,66000,0.0,0,2023-04-04T22:24,-4950,44550
46,1417691,47,13900,0,97.0,18466,2023-04-04T22:24,0,13900
47,2456000,48,54900,82900,95.0,552,2023-04-04T22:24,0,54900
48,3034895,49,101150,119000,98.0,353,2023-04-04T22:24,0,101150
49,2851485,50,68900,0,96.0,453,2023-04-04T22:24,0,68900
50,3043304,51,189000,0,97.0,43,2023-04-04T22:24,0,189000
51,2368712,52,38700,43000,97.0,5562,2023-04-04T22:24,-1935,36765
52,3180162,53,31200,39000,0.0,0,2023-04-04T22:24,0,31200
53,2409894,54,39000,78000,97.0,5118,2023-04-04T22:24,-3900,35100
54,3180160,55,31200,39000,0.0,0,2023-04-04T22:24,0,31200
55,2403601,56,32500,50000,96.0,2193,2023-04-04T22:24,0,32500
56,3051599,57,49000,0,97.0,110,2023-04-04T22:24,0,49000
57,2313388,58,76500,85000,96.0,2108,2023-04-04T22:24,0,76500
58,1763123,59,84550,89000,96.0,1662,2023-04-04T22:24,-4228,80322
59,2065708,60,59000,62000,98.0,6540,2023-04-04T22:24,-8850,50150
60,2392759,61,39900,49600,95.0,3975,2023-04-04T22:24,-3990,35910
61,2375962,62,59000,62000,98.0,5356,2023-04-04T22:24,-8850,50150
62,3129723,63,39000,0,98.0,19,2023-04-04T22:24,0,39000
63,1911516,64,48900,81900,95.0,6159,2023-04-04T22:24,0,48900
64,2376233,65,36000,0,97.0,2204,2023-04-04T22:24,0,36000
65,1336398,66,40200,67000,96.0,19041,2023-04-04T22:24,0,40200
66,2708999,67,49800,62500,96.0,625,2023-04-04T22:24,-4980,44820
67,1498105,68,189000,0,97.0,1982,2023-04-04T22:24,0,189000
68,1763164,69,49400,52000,96.0,2371,2023-04-04T22:24,0,49400
69,1498103,70,199000,0,96.0,857,2023-04-04T22:24,0,199000
70,2453556,71,39900,42000,97.0,6249,2023-04-04T22:24,0,39900
71,1582356,72,49200,82000,96.0,16093,2023-04-04T22:24,0,49200
72,2035287,73,39800,0,97.0,8666,2023-04-04T22:24,-5970,33830
73,1820701,74,35000,0,96.0,5551,2023-04-04T22:24,0,35000
74,3064420,75,58100,69000,97.0,31,2023-04-04T22:24,-2905,55195
75,2684358,76,89380,109000,97.0,3241,2023-04-04T22:24,0,89380
76,2359137,77,40200,67000,97.0,1312,2023-04-04T22:24,0,40200
77,2052957,78,69000,0,97.0,1554,2023-04-04T22:24,0,69000
78,1899755,79,29900,39000,96.0,4921,2023-04-04T22:24,0,29900
79,3028847,80,64000,117000,100.0,3,2023-04-04T22:24,0,64000
80,3052036,81,59400,66000,96.0,142,2023-04-04T22:24,-11880,47520
81,1955452,82,39800,69990,95.0,2639,2023-04-04T22:24,0,39800
82,2913656,83,47900,64000,96.0,288,2023-04-04T22:24,-4790,43110
83,2186292,84,16900,20000,96.0,14391,2023-04-04T22:24,0,16900
84,3043301,85,189000,0,96.0,17,2023-04-04T22:24,0,189000
85,3002774,86,62100,69000,97.0,267,2023-04-04T22:24,0,62100
86,3032250,87,64000,0,96.0,822,2023-04-04T22:24,0,64000
87,2015684,88,39000,0,94.0,6358,2023-04-04T22:24,0,39000
88,2518417,89,27500,55000,93.0,444,2023-04-04T22:24,0,27500
89,2398381,90,31500,45000,96.0,3563,2023-04-04T22:24,-3150,28350
90,1558197,1,73690,81900,97.0,32248,2023-04-04T22:24,0,73690
91,1778404,2,42000,45000,96.0,67019,2023-04-04T22:24,0,42000
92,2723218,3,69900,109000,97.0,2145,2023-04-04T22:24,0,69900
93,1790383,4,59000,86000,95.0,5391,2023-04-04T22:24,0,59000
94,2061715,5,83900,105000,97.0,2681,2023-04-04T22:24,0,83900
95,1571879,6,79900,112900,96.0,7014,2023-04-04T22:24,0,79900
96,3074540,7,53000,97000,100.0,2,2023-04-04T22:24,0,53000
97,1283757,8,75490,83900,96.0,26581,2023-04-04T22:24,0,75490
98,1856181,9,35910,39900,97.0,7301,2023-04-04T22:24,-3591,32319
99,2020732,10,70900,89000,95.0,790,2023-04-04T22:24,0,70900
100,2471405,11,89000,138000,97.0,2027,2023-04-04T22:24,0,89000
101,2715055,12,159000,189000,97.0,1971,2023-04-04T22:24,0,159000
102,1776552,13,59000,69000,94.0,6101,2023-04-04T22:24,0,59000
103,2732486,14,109000,179000,98.0,651,2023-04-04T22:24,0,109000
104,841230,15,154000,172000,96.0,7246,2023-04-04T22:24,0,154000
105,3012082,16,59900,79000,96.0,912,2023-04-04T22:24,0,59900
106,1108007,17,79900,0,95.0,47855,2023-04-04T22:24,0,79900
107,3033224,18,59900,74000,97.0,592,2023-04-04T22:24,0,59900
108,1833230,19,108800,136000,97.0,5391,2023-04-04T22:24,0,108800
109,3044143,20,69900,99000,100.0,38,2023-04-04T22:24,0,69900
110,1571878,21,79900,112900,96.0,4646,2023-04-04T22:24,0,79900
111,1530516,22,69900,79000,96.0,2288,2023-04-04T22:24,0,69900
112,2403367,23,146000,0,97.0,612,2023-04-04T22:24,0,146000
113,3098417,24,159000,199000,97.0,525,2023-04-04T22:24,0,159000
114,1530517,25,69900,79000,96.0,2057,2023-04-04T22:24,0,69900
115,1618312,26,83900,0,97.0,7073,2023-04-04T22:24,0,83900
116,2343198,27,119000,129000,97.0,4988,2023-04-04T22:24,0,119000
117,2297046,28,179100,199000,97.0,1682,2023-04-04T22:24,0,179100
118,1778408,29,42000,45000,95.0,11642,2023-04-04T22:24,0,42000
119,1337094,30,69900,0,95.0,5354,2023-04-04T22:24,0,69900
120,3037701,31,215000,239000,98.0,82,2023-04-04T22:24,-43000,172000
121,2159724,32,29900,32000,95.0,2244,2023-04-04T22:24,0,29900
122,3083811,33,69900,139000,100.0,10,2023-04-04T22:24,0,69900
123,1195307,34,82400,103000,96.0,12581,2023-04-04T22:24,-8240,74160
124,2064545,35,59800,94000,97.0,11053,2023-04-04T22:24,-2990,56810
125,2329532,36,119200,149000,97.0,3934,2023-04-04T22:24,0,119200
126,2343199,37,119000,129000,98.0,1795,2023-04-04T22:24,0,119000
127,3019670,38,188100,209000,100.0,61,2023-04-04T22:24,0,188100
128,1139192,39,71100,94900,97.0,14363,2023-04-04T22:24,-7110,63990
129,1558683,40,81900,0,97.0,6196,2023-04-04T22:24,0,81900
130,3033082,41,89900,105000,97.0,63,2023-04-04T22:24,0,89900
131,3074541,42,53000,97000,92.0,5,2023-04-04T22:24,0,53000
132,1751722,43,53910,59900,97.0,3360,2023-04-04T22:24,-5391,48519
133,3010527,44,237150,279000,98.0,202,2023-04-04T22:24,0,237150
134,2375909,45,80890,89900,98.0,1524,2023-04-04T22:24,0,80890
135,1737051,46,62300,89000,96.0,5078,2023-04-04T22:24,0,62300
136,3010524,47,237150,279000,98.0,39,2023-04-04T22:24,0,237150
137,2288704,48,121000,132000,97.0,3334,2023-04-04T22:24,0,121000
138,2344615,49,157900,0,93.0,45,2023-04-04T22:24,0,157900
139,1337096,50,69900,0,97.0,2935,2023-04-04T22:24,0,69900
140,2718413,51,126650,149000,97.0,1405,2023-04-04T22:24,0,126650
141,3055246,52,159000,0,98.0,46,2023-04-04T22:24,0,159000
142,2759592,53,59000,79000,96.0,292,2023-04-04T22:24,-5900,53100
143,3081572,54,109000,0,97.0,29,2023-04-04T22:24,-10900,98100
144,2788216,55,146000,159000,98.0,88,2023-04-04T22:24,0,146000
145,2288426,56,69000,109000,94.0,794,2023-04-04T22:24,0,69000
146,2712632,57,107000,0,97.0,1321,2023-04-04T22:24,0,107000
147,2668986,58,35910,39900,96.0,3449,2023-04-04T22:24,-3591,32319
148,3046899,59,95900,105000,96.0,97,2023-04-04T22:24,0,95900
149,2752332,60,94700,105300,95.0,2520,2023-04-04T22:24,0,94700
150,864404,61,108000,135000,95.0,13371,2023-04-04T22:24,0,108000
151,3010431,62,135150,159000,97.0,124,2023-04-04T22:24,0,135150
152,1567183,63,75900,94900,97.0,7405,2023-04-04T22:24,-7590,68310
153,3037703,64,215000,239000,99.0,66,2023-04-04T22:24,-43000,172000
154,3100493,65,139000,0,98.0,32,2023-04-04T22:24,0,139000
155,2122596,66,39800,57000,96.0,2642,2023-04-04T22:24,0,39800
156,1139338,67,71100,94900,97.0,17094,2023-04-04T22:24,-7110,63990
157,2056274,68,142200,158000,97.0,375,2023-04-04T22:24,0,142200
158,3042936,69,90900,105000,96.0,315,2023-04-04T22:24,0,90900
159,965917,70,71890,79900,95.0,13067,2023-04-04T22:24,0,71890
160,2675781,71,179000,199000,98.0,621,2023-04-04T22:24,0,179000
161,3029811,72,63200,79000,97.0,236,2023-04-04T22:24,0,63200
162,2572705,73,168300,198000,96.0,58,2023-04-04T22:24,-25245,143055
163,2100438,74,63890,79900,97.0,3717,2023-04-04T22:24,0,63890
164,3058780,75,185000,209000,96.0,91,2023-04-04T22:24,0,185000
165,2444808,76,83900,0,97.0,680,2023-04-04T22:24,0,83900
166,1776550,77,59000,69000,94.0,4137,2023-04-04T22:24,0,59000
167,3037477,78,69900,109000,97.0,211,2023-04-04T22:24,0,69900
168,1757367,79,129000,159000,95.0,277,2023-04-04T22:24,-12900,116100
169,3083810,80,69900,139000,0.0,0,2023-04-04T22:24,0,69900
170,3078900,81,148000,0,98.0,187,2023-04-04T22:24,-14800,133200
171,2697873,82,107000,0,97.0,826,2023-04-04T22:24,0,107000
172,1571876,83,79900,112900,96.0,1198,2023-04-04T22:24,0,79900
173,2315115,84,127200,159000,97.0,790,2023-04-04T22:24,-25440,101760
174,1576700,85,89000,129000,97.0,16681,2023-04-04T22:24,0,89000
175,3039158,86,259000,0,99.0,24,2023-04-04T22:24,0,259000
176,3091295,87,169000,0,92.0,20,2023-04-04T22:24,0,169000
177,2284220,88,79900,112900,96.0,1674,2023-04-04T22:24,0,79900
178,2670700,89,268200,298000,98.0,1179,2023-04-04T22:24,-26820,241380
179,3094153,90,169000,184000,97.0,87,2023-04-04T22:24,0,169000
180,2112059,1,36400,0,97.0,42697,2023-04-04T22:24,0,36400
181,750908,2,34900,54000,96.0,83882,2023-04-04T22:24,0,34900
182,1149329,3,39900,0,96.0,85846,2023-04-04T22:24,0,39900
183,1551840,4,39000,0,97.0,83450,2023-04-04T22:24,0,39000
184,3154689,5,49800,63000,96.0,31,2023-04-04T22:24,-4980,44820
185,1168906,6,41900,0,97.0,70894,2023-04-04T22:24,0,41900
186,3154699,7,49800,63000,0.0,0,2023-04-04T22:24,-4980,44820
187,3154688,8,49800,63000,100.0,16,2023-04-04T22:24,-4980,44820
188,3154647,9,49800,63000,0.0,0,2023-04-04T22:24,-4980,44820
189,1149328,10,39900,0,96.0,94419,2023-04-04T22:24,0,39900
190,1370101,11,39000,89000,96.0,22798,2023-04-04T22:24,-1950,37050
191,2060719,12,55200,69000,96.0,5056,2023-04-04T22:24,-2760,52440
192,1568057,13,49600,62000,96.0,22201,2023-04-04T22:24,0,49600
193,2028327,14,49900,0,97.0,9011,2023-04-04T22:24,0,49900
194,3154694,15,49800,63000,0.0,0,2023-04-04T22:24,-4980,44820
195,2092852,16,42000,52800,96.0,11032,2023-04-04T22:24,-2100,39900
196,1926048,17,32000,0,97.0,14625,2023-04-04T22:24,0,32000
197,1924274,18,49900,66000,95.0,22459,2023-04-04T22:24,0,49900
198,3154697,19,49800,63000,0.0,0,2023-04-04T22:24,-4980,44820
199,2112061,20,36400,52000,97.0,14542,2023-04-04T22:24,0,36400
200,1573215,21,133200,148000,98.0,9257,2023-04-04T22:24,0,133200
201,858911,22,39000,49000,95.0,66799,2023-04-04T22:24,0,39000
202,2060759,23,59800,74800,97.0,7150,2023-04-04T22:24,-2990,56810
203,883004,24,69900,89000,94.0,9457,2023-04-04T22:24,0,69900
204,2351467,25,29000,54000,96.0,6054,2023-04-04T22:24,0,29000
205,1552753,26,62400,78000,97.0,28124,2023-04-04T22:24,-6240,56160
206,1555407,27,62400,78000,97.0,11495,2023-04-04T22:24,-6240,56160
207,1551839,28,39000,0,97.0,23413,2023-04-04T22:24,0,39000
208,2060717,29,55200,69000,95.0,3736,2023-04-04T22:24,-2760,52440
209,3154691,30,49800,63000,0.0,0,2023-04-04T22:24,-4980,44820
210,3154648,31,49800,63000,0.0,0,2023-04-04T22:24,-4980,44820
211,2184087,32,49000,89000,96.0,4064,2023-04-04T22:24,-2450,46550
212,1222184,33,41900,0,97.0,48297,2023-04-04T22:24,0,41900
213,2723714,34,52000,58000,96.0,1497,2023-04-04T22:24,0,52000
214,2060720,35,55200,69000,95.0,2535,2023-04-04T22:24,-2760,52440
215,2028326,36,49900,0,97.0,6107,2023-04-04T22:24,0,49900
216,3154652,37,49800,63000,0.0,0,2023-04-04T22:24,-4980,44820
217,3154696,38,49800,63000,0.0,0,2023-04-04T22:24,-4980,44820
218,3154649,39,49800,63000,0.0,0,2023-04-04T22:24,-4980,44820
219,2789091,40,79200,99000,96.0,737,2023-04-04T22:24,-3960,75240
220,3091296,41,129000,0,93.0,43,2023-04-04T22:24,0,129000
221,2877984,42,59000,0,97.0,404,2023-04-04T22:24,0,59000
222,1440874,43,39900,0,95.0,15117,2023-04-04T22:24,0,39900
223,1736085,44,39900,59800,96.0,36587,2023-04-04T22:24,0,39900
224,1477272,45,44200,68000,96.0,17795,2023-04-04T22:24,0,44200
225,1568032,46,49600,62000,96.0,6096,2023-04-04T22:24,0,49600
226,3154690,47,49800,63000,0.0,0,2023-04-04T22:24,-4980,44820
227,2827702,48,69800,87500,96.0,429,2023-04-04T22:24,-3490,66310
228,2929838,49,69550,107000,96.0,354,2023-04-04T22:24,0,69550
229,3154692,50,49800,63000,0.0,0,2023-04-04T22:24,-4980,44820
230,1985223,51,39000,89000,96.0,1619,2023-04-04T22:24,-1950,37050
231,2737165,52,69000,79000,96.0,2597,2023-04-04T22:24,-3450,65550
232,2060743,53,33000,55000,95.0,3517,2023-04-04T22:24,0,33000
233,1595607,54,57900,89000,97.0,5684,2023-04-04T22:24,0,57900
234,2032901,55,39900,0,97.0,6776,2023-04-04T22:24,0,39900
235,2503133,56,42000,52800,96.0,3078,2023-04-04T22:24,-2100,39900
236,890521,57,39800,63000,94.0,11061,2023-04-04T22:24,0,39800
237,1867371,58,39900,49000,96.0,2044,2023-04-04T22:24,0,39900
238,890338,59,39000,49000,95.0,47651,2023-04-04T22:24,0,39000
239,1224095,60,35890,39900,97.0,24359,2023-04-04T22:24,0,35890
240,3141395,61,49900,73900,96.0,149,2023-04-04T22:24,0,49900
241,1736562,62,39000,0,97.0,5994,2023-04-04T22:24,0,39000
242,2742472,63,121500,135000,98.0,79,2023-04-04T22:24,0,121500
243,1666442,64,49900,0,97.0,10885,2023-04-04T22:24,0,49900
244,2027068,65,66900,95000,96.0,1818,2023-04-04T22:24,0,66900
245,2706287,66,39800,54000,95.0,3704,2023-04-04T22:24,0,39800
246,2569078,67,79000,0,96.0,2410,2023-04-04T22:24,0,79000
247,2749153,68,66600,74000,97.0,542,2023-04-04T22:24,0,66600
248,2150457,69,119250,159000,97.0,3781,2023-04-04T22:24,0,119250
249,1985224,70,39000,89000,96.0,1802,2023-04-04T22:24,-1950,37050
250,2261213,71,121500,135000,98.0,4083,2023-04-04T22:24,0,121500
251,999426,72,37900,56800,94.0,45573,2023-04-04T22:24,0,37900
252,2562527,73,29400,42000,97.0,3956,2023-04-04T22:24,0,29400
253,1960424,74,49500,59000,95.0,1147,2023-04-04T22:24,0,49500
254,1323090,75,73600,92000,96.0,5968,2023-04-04T22:24,0,73600
255,3049798,76,96800,121000,95.0,53,2023-04-04T22:24,0,96800
256,2107115,77,121500,135000,98.0,11677,2023-04-04T22:24,0,121500
257,3188768,78,156000,0,100.0,5,2023-04-04T22:24,0,156000
258,2310310,79,116100,129000,98.0,918,2023-04-04T22:24,-11610,104490
259,2789111,80,79200,99000,97.0,797,2023-04-04T22:24,-3960,75240
260,2028329,81,49900,0,96.0,6486,2023-04-04T22:24,0,49900
261,1159065,82,59000,83000,95.0,21739,2023-04-04T22:24,0,59000
262,2297033,83,134100,149000,97.0,1840,2023-04-04T22:24,0,134100
263,1926034,84,32000,0,97.0,3073,2023-04-04T22:24,0,32000
264,3047556,85,64860,69000,96.0,21,2023-04-04T22:24,0,64860
265,1989228,86,43900,0,97.0,5458,2023-04-04T22:24,0,43900
266,1212776,87,28690,31900,96.0,23303,2023-04-04T22:24,0,28690
267,1168922,88,43900,0,96.0,18148,2023-04-04T22:24,0,43900
268,3098372,89,89000,139000,97.0,817,2023-04-04T22:24,0,89000
269,1403480,90,77000,98000,97.0,7722,2023-04-04T22:24,0,77000
270,3020963,1,341100,379000,100.0,6,2023-04-04T22:24,-17055,324045
271,2771875,2,314100,349000,96.0,100,2023-04-04T22:24,-15705,298395
272,1789507,3,69900,79000,98.0,25785,2023-04-04T22:24,-6990,62910
273,2745310,4,269100,299000,96.0,23,2023-04-04T22:24,-13455,255645
274,2874755,5,260100,289000,97.0,57,2023-04-04T22:24,-13005,247095
275,1034480,6,135000,150000,97.0,18018,2023-04-04T22:24,0,135000
276,3138495,7,260100,289000,0.0,0,2023-04-04T22:24,-13005,247095
277,3038000,8,74700,83000,96.0,327,2023-04-04T22:24,-14940,59760
278,3020970,9,296100,329000,100.0,10,2023-04-04T22:24,-14805,281295
279,1969507,10,88000,0,98.0,5359,2023-04-04T22:24,0,88000
280,2771965,11,287100,319000,89.0,24,2023-04-04T22:24,-14355,272745
281,2811137,12,341100,379000,100.0,9,2023-04-04T22:24,-17055,324045
282,3138498,13,260100,289000,100.0,1,2023-04-04T22:24,-13005,247095
283,2235274,14,145000,0,97.0,685,2023-04-04T22:24,0,145000
284,2066837,15,79000,119000,97.0,6460,2023-04-04T22:24,-7900,71100
285,2835150,16,260100,289000,100.0,37,2023-04-04T22:24,-13005,247095
286,1842449,17,84000,99000,97.0,5357,2023-04-04T22:24,0,84000
287,1529316,18,296650,349000,97.0,149,2023-04-04T22:24,-14833,281817
288,2558648,19,119000,0,98.0,1250,2023-04-04T22:24,0,119000
289,2344540,20,96000,0,98.0,9190,2023-04-04T22:24,0,96000
290,1264107,21,65000,90000,97.0,6327,2023-04-04T22:24,0,65000
291,3034751,22,64800,72000,97.0,428,2023-04-04T22:24,0,64800
292,342189,23,39500,52000,95.0,15710,2023-04-04T22:24,0,39500
293,2584181,24,57600,72000,99.0,983,2023-04-04T22:24,0,57600
294,2811157,25,287100,319000,0.0,0,2023-04-04T22:24,-14355,272745
295,2997613,26,314100,349000,0.0,0,2023-04-04T22:24,-15705,298395
296,1910358,27,89100,99000,98.0,2459,2023-04-04T22:24,0,89100
297,3047568,28,109650,129000,95.0,41,2023-04-04T22:24,0,109650
298,2344538,29,119000,0,98.0,6338,2023-04-04T22:24,0,119000
299,2320927,30,39000,51000,97.0,2105,2023-04-04T22:24,-3900,35100
300,2997612,31,269100,299000,100.0,1,2023-04-04T22:24,-13455,255645
301,2702033,32,127200,159000,97.0,392,2023-04-04T22:24,0,127200
302,1964770,33,59400,66000,97.0,2480,2023-04-04T22:24,-11880,47520
303,2325729,34,87200,109000,97.0,783,2023-04-04T22:24,-17440,69760
304,1969488,35,88000,0,98.0,1727,2023-04-04T22:24,0,88000
305,3045584,36,130500,145000,97.0,3770,2023-04-04T22:24,0,130500
306,2422175,37,137700,162000,98.0,196,2023-04-04T22:24,0,137700
307,2771873,38,314100,349000,88.0,7,2023-04-04T22:24,-15705,298395
308,1581689,39,75600,89000,97.0,3952,2023-04-04T22:24,-3780,71820
309,1529288,40,296650,349000,99.0,22,2023-04-04T22:24,-14833,281817
310,3000157,41,158000,0,96.0,131,2023-04-04T22:24,0,158000
311,1456515,42,49500,55000,97.0,8707,2023-04-04T22:24,-9900,39600
312,2408317,43,145800,162000,96.0,367,2023-04-04T22:24,-14580,131220
313,3034749,44,64800,72000,97.0,410,2023-04-04T22:24,0,64800
314,2514819,45,55000,66000,97.0,811,2023-04-04T22:24,-2750,52250
315,3082387,46,139000,0,98.0,122,2023-04-04T22:24,-13900,125100
316,2811158,47,287100,319000,100.0,12,2023-04-04T22:24,-14355,272745
317,1564343,48,92800,119000,98.0,8082,2023-04-04T22:24,-6496,86304
318,2002697,49,67900,76000,97.0,3453,2023-04-04T22:24,-6790,61110
319,1744101,50,103500,109000,98.0,2893,2023-04-04T22:24,0,103500
320,2271789,51,71100,79000,97.0,2495,2023-04-04T22:24,0,71100
321,2859227,52,1610000,2330000,100.0,1,2023-04-04T22:24,0,1610000
322,2343665,53,89000,0,97.0,4561,2023-04-04T22:24,0,89000
323,3020945,54,296100,329000,100.0,2,2023-04-04T22:24,-14805,281295
324,1528287,55,49000,0,96.0,4582,2023-04-04T22:24,0,49000
325,2869084,56,369000,0,97.0,30,2023-04-04T22:24,0,369000
326,1758217,57,43900,56000,97.0,13113,2023-04-04T22:24,-2195,41705
327,1247560,58,69900,79000,96.0,4253,2023-04-04T22:24,-6990,62910
328,1969479,59,88000,0,98.0,1106,2023-04-04T22:24,0,88000
329,1745100,60,103500,109000,97.0,983,2023-04-04T22:24,0,103500
330,913402,61,83000,98000,95.0,8034,2023-04-04T22:24,0,83000
331,3130030,62,74700,83000,0.0,0,2023-04-04T22:24,-14940,59760
332,2902211,63,390000,600000,100.0,12,2023-04-04T22:24,0,390000
333,2235273,64,145000,0,98.0,179,2023-04-04T22:24,0,145000
334,2771877,65,269100,299000,85.0,4,2023-04-04T22:24,-13455,255645
335,2757112,66,359000,0,93.0,95,2023-04-04T22:24,0,359000
336,2975285,67,55250,65000,98.0,302,2023-04-04T22:24,0,55250
337,2655968,68,1125000,1850000,0.0,0,2023-04-04T22:24,0,1125000
338,2979846,69,1458000,2820000,0.0,0,2023-04-04T22:24,0,1458000
339,2245910,70,46000,69000,95.0,719,2023-04-04T22:24,-4600,41400
340,2930265,71,91000,0,98.0,542,2023-04-04T22:24,0,91000
341,2657250,72,125400,149000,98.0,116,2023-04-04T22:24,0,125400
342,2630526,73,100000,0,96.0,621,2023-04-04T22:24,0,100000
343,1736022,74,169200,188000,95.0,428,2023-04-04T22:24,-16920,152280
344,2305287,75,62820,69800,98.0,1035,2023-04-04T22:24,0,62820
345,1749492,76,89100,99000,98.0,3857,2023-04-04T22:24,0,89100
346,3034745,77,84000,0,97.0,163,2023-04-04T22:24,0,84000
347,1534526,78,55000,0,97.0,2433,2023-04-04T22:24,0,55000
348,2679537,79,145800,162000,96.0,96,2023-04-04T22:24,-14580,131220
349,3029922,80,295000,0,96.0,85,2023-04-04T22:24,0,295000
350,1090160,81,99000,0,97.0,1295,2023-04-04T22:24,0,99000
351,2668835,82,107100,119000,98.0,870,2023-04-04T22:24,-10710,96390
352,2329567,83,99000,115000,96.0,316,2023-04-04T22:24,0,99000
353,3072371,84,125100,139000,96.0,110,2023-04-04T22:24,-12510,112590
354,1216585,85,29800,59000,95.0,13911,2023-04-04T22:24,-2980,26820
355,1453531,86,53000,59000,96.0,2981,2023-04-04T22:24,-5300,47700
356,1802030,87,119000,0,98.0,726,2023-04-04T22:24,0,119000
357,2888946,88,79000,0,98.0,148,2023-04-04T22:24,-7900,71100
358,2229665,89,137700,153000,97.0,340,2023-04-04T22:24,-6885,130815
359,3116527,90,449000,0,0.0,0,2023-04-04T22:24,0,449000
360,1622069,1,119000,0,98.0,5696,2023-04-04T22:24,0,119000
361,2545799,2,149000,0,98.0,2062,2023-04-04T22:24,0,149000
362,969541,3,69000,0,97.0,29423,2023-04-04T22:24,0,69000
363,1762407,4,260000,0,97.0,3197,2023-04-04T22:24,0,260000
364,1762406,5,260000,0,98.0,3295,2023-04-04T22:24,0,260000
365,2638067,6,99000,139000,97.0,3022,2023-04-04T22:24,0,99000
366,1622068,7,119000,0,97.0,6591,2023-04-04T22:24,0,119000
367,2293400,8,129000,0,96.0,947,2023-04-04T22:24,0,129000
368,1231944,9,119000,0,97.0,1297,2023-04-04T22:24,0,119000
369,810034,10,85500,95000,97.0,45163,2023-04-04T22:24,0,85500
370,311052,11,53100,59000,97.0,41116,2023-04-04T22:24,0,53100
371,695334,12,78900,99000,96.0,9326,2023-04-04T22:24,0,78900
372,1900410,13,129000,0,97.0,4870,2023-04-04T22:24,0,129000
373,181907,14,89900,119000,97.0,7098,2023-04-04T22:24,0,89900
374,1990244,15,129000,0,98.0,1062,2023-04-04T22:24,0,129000
375,2320478,16,129000,0,97.0,492,2023-04-04T22:24,0,129000
376,1296778,17,99000,0,98.0,2088,2023-04-04T22:24,0,99000
377,716244,18,54900,95000,98.0,1157,2023-04-04T22:24,0,54900
378,3091287,19,119000,0,98.0,278,2023-04-04T22:24,0,119000
379,3079037,20,195000,0,97.0,226,2023-04-04T22:24,0,195000
380,186610,21,75900,85000,97.0,16514,2023-04-04T22:24,0,75900
381,102620,22,69000,0,97.0,17834,2023-04-04T22:24,0,69000
382,490136,23,76000,95000,98.0,2214,2023-04-04T22:24,0,76000
383,490091,24,36900,69000,97.0,932,2023-04-04T22:24,0,36900
384,3033248,25,109000,0,97.0,628,2023-04-04T22:24,0,109000
385,1792640,26,99000,0,98.0,3501,2023-04-04T22:24,0,99000
386,1739446,27,109900,129000,97.0,820,2023-04-04T22:24,0,109900
387,2741233,28,109000,0,97.0,2693,2023-04-04T22:24,0,109000
388,2778805,29,99000,0,97.0,975,2023-04-04T22:24,0,99000
389,1900420,30,129000,0,96.0,1493,2023-04-04T22:24,0,129000
390,2161992,31,69900,95000,97.0,3269,2023-04-04T22:24,0,69900
391,1478592,32,75900,95000,97.0,2977,2023-04-04T22:24,0,75900
392,810033,33,89100,99000,97.0,34222,2023-04-04T22:24,0,89100
393,1955217,34,69000,109000,96.0,5166,2023-04-04T22:24,-13800,55200
394,3030422,35,139000,0,96.0,823,2023-04-04T22:24,0,139000
395,2524840,36,139000,0,97.0,840,2023-04-04T22:24,0,139000
396,490135,37,75900,95000,97.0,3248,2023-04-04T22:24,0,75900
397,816033,38,70900,89000,96.0,13262,2023-04-04T22:24,0,70900
398,2684216,39,158000,0,98.0,34,2023-04-04T22:24,-23700,134300
399,2469965,40,94900,149000,96.0,1086,2023-04-04T22:24,0,94900
400,577636,41,99900,139000,95.0,31156,2023-04-04T22:24,0,99900
401,2737458,42,230000,0,98.0,659,2023-04-04T22:24,0,230000
402,810032,43,85500,95000,97.0,13727,2023-04-04T22:24,0,85500
403,311050,44,53100,59000,97.0,9015,2023-04-04T22:24,0,53100
404,1868015,45,129000,0,97.0,1932,2023-04-04T22:24,0,129000
405,1473136,46,119900,149000,97.0,10774,2023-04-04T22:24,0,119900
406,1494180,47,71100,79000,95.0,5237,2023-04-04T22:24,0,71100
407,165988,48,69000,0,96.0,4788,2023-04-04T22:24,0,69000
408,2731878,49,67900,79000,97.0,1627,2023-04-04T22:24,0,67900
409,2268512,50,109000,0,97.0,429,2023-04-04T22:24,0,109000
410,1608838,51,85000,0,97.0,12601,2023-04-04T22:24,0,85000
411,2233180,52,75900,109000,97.0,14159,2023-04-04T22:24,0,75900
412,3172970,53,148000,0,98.0,17,2023-04-04T22:24,0,148000
413,102618,54,69000,0,97.0,6048,2023-04-04T22:24,0,69000
414,2855992,55,159000,0,97.0,562,2023-04-04T22:24,0,159000
415,2502722,56,898000,1270000,100.0,8,2023-04-04T22:24,0,898000
416,3023097,57,230000,0,98.0,89,2023-04-04T22:24,0,230000
417,2070761,58,329000,0,98.0,361,2023-04-04T22:24,0,329000
418,2786814,59,149000,0,98.0,181,2023-04-04T22:24,0,149000
419,311051,60,58500,65000,97.0,19553,2023-04-04T22:24,0,58500
420,1798273,61,63070,119000,96.0,1170,2023-04-04T22:24,0,63070
421,1493265,62,85500,95000,98.0,4885,2023-04-04T22:24,0,85500
422,2851292,63,49900,89000,96.0,257,2023-04-04T22:24,0,49900
423,2440110,64,59900,0,97.0,992,2023-04-04T22:24,0,59900
424,1686571,65,76900,129000,97.0,5436,2023-04-04T22:24,0,76900
425,2239046,66,306000,0,98.0,253,2023-04-04T22:24,-45900,260100
426,2756002,67,125800,148000,95.0,100,2023-04-04T22:24,-6290,119510
427,1493263,68,89100,99000,98.0,4209,2023-04-04T22:24,0,89100
428,3005191,69,169000,0,96.0,175,2023-04-04T22:24,0,169000
429,3136289,70,89100,99000,99.0,33,2023-04-04T22:24,0,89100
430,2400818,71,79900,199000,99.0,49,2023-04-04T22:24,0,79900
431,1354129,72,67000,99000,95.0,8687,2023-04-04T22:24,-13400,53600
432,2139107,73,44900,89000,95.0,365,2023-04-04T22:24,0,44900
433,104240,74,69000,0,96.0,3856,2023-04-04T22:24,0,69000
434,1469860,75,75000,0,97.0,6738,2023-04-04T22:24,0,75000
435,2239044,76,306000,0,97.0,90,2023-04-04T22:24,-45900,260100
436,2970200,77,79000,0,98.0,467,2023-04-04T22:24,0,79000
437,2777005,78,497000,815000,95.0,32,2023-04-04T22:24,0,497000
438,957758,79,89000,0,97.0,4433,2023-04-04T22:24,0,89000
439,2622254,80,109000,0,98.0,894,2023-04-04T22:24,0,109000
440,2970197,81,79000,0,98.0,216,2023-04-04T22:24,0,79000
441,810031,82,89100,99000,97.0,7863,2023-04-04T22:24,0,89100
442,3079039,83,230000,0,94.0,10,2023-04-04T22:24,0,230000
443,1635193,84,69900,0,96.0,3674,2023-04-04T22:24,0,69900
444,2819014,85,49900,79000,95.0,163,2023-04-04T22:24,0,49900
445,2909715,86,119000,0,96.0,84,2023-04-04T22:24,0,119000
446,1256468,87,109000,0,97.0,3553,2023-04-04T22:24,0,109000
447,2861392,88,124900,139000,97.0,568,2023-04-04T22:24,0,124900
448,3008384,89,75000,0,98.0,111,2023-04-04T22:24,0,75000
449,490134,90,75900,95000,97.0,1986,2023-04-04T22:24,0,75900
450,1092992,1,69000,0,97.0,37773,2023-04-04T22:24,0,69000
451,2091749,2,75650,89000,95.0,6210,2023-04-04T22:24,0,75650
452,2433538,3,86700,102000,96.0,2374,2023-04-04T22:24,0,86700
453,3161736,4,67900,158000,0.0,0,2023-04-04T22:24,0,67900
454,1720827,5,169000,0,98.0,571,2023-04-04T22:24,0,169000
455,595040,6,210000,0,95.0,8731,2023-04-04T22:24,0,210000
456,1810760,7,90000,150000,96.0,158,2023-04-04T22:24,0,90000
457,1339622,8,42900,59000,97.0,16249,2023-04-04T22:24,0,42900
458,2432733,9,44900,59000,97.0,2770,2023-04-04T22:24,0,44900
459,1129750,10,69000,0,97.0,3911,2023-04-04T22:24,0,69000
460,1720822,11,209000,0,97.0,294,2023-04-04T22:24,0,209000
461,595039,12,210000,0,97.0,3497,2023-04-04T22:24,0,210000
462,2816812,13,119900,0,92.0,1516,2023-04-04T22:24,0,119900
463,2101924,14,99900,0,96.0,1360,2023-04-04T22:24,0,99900
464,2735953,15,207000,230000,98.0,402,2023-04-04T22:24,0,207000
465,1890398,16,138000,168000,96.0,2715,2023-04-04T22:24,0,138000
466,1439535,17,49000,0,96.0,16302,2023-04-04T22:24,0,49000
467,1952910,18,265500,295000,98.0,1727,2023-04-04T22:24,0,265500
468,3062046,19,78300,87000,96.0,88,2023-04-04T22:24,0,78300
469,2816816,20,159900,0,97.0,1851,2023-04-04T22:24,0,159900
470,3024585,21,59000,0,97.0,103,2023-04-04T22:24,0,59000
471,2430426,22,169000,0,98.0,727,2023-04-04T22:24,0,169000
472,1828166,23,126000,210000,94.0,843,2023-04-04T22:24,0,126000
473,2814379,24,120000,200000,97.0,18,2023-04-04T22:24,0,120000
474,2440524,25,69000,0,97.0,1521,2023-04-04T22:24,-6900,62100
475,1262089,26,300000,0,97.0,1589,2023-04-04T22:24,0,300000
476,2621831,27,59800,85000,95.0,709,2023-04-04T22:24,-5980,53820
477,2624538,28,40900,59000,97.0,1428,2023-04-04T22:24,0,40900
478,3124961,29,62100,69000,97.0,53,2023-04-04T22:24,0,62100
479,501198,30,129000,139000,95.0,2739,2023-04-04T22:24,0,129000
480,2363570,31,39900,55000,97.0,972,2023-04-04T22:24,0,39900
481,2910082,32,265500,295000,98.0,464,2023-04-04T22:24,0,265500
482,1720813,33,149000,0,97.0,409,2023-04-04T22:24,0,149000
483,3049313,34,57100,64900,97.0,528,2023-04-04T22:24,0,57100
484,2305529,35,138000,168000,98.0,85,2023-04-04T22:24,0,138000
485,1568047,36,159000,0,95.0,12004,2023-04-04T22:24,0,159000
486,2395327,37,149000,0,97.0,543,2023-04-04T22:24,0,149000
487,3132539,38,69000,0,100.0,2,2023-04-04T22:24,-6900,62100
488,1021359,39,76000,100000,94.0,5375,2023-04-04T22:24,0,76000
489,1419869,40,70300,74000,95.0,10553,2023-04-04T22:24,0,70300
490,3052437,41,139500,155000,97.0,39,2023-04-04T22:24,-27900,111600
491,1973858,42,143200,179000,98.0,1186,2023-04-04T22:24,0,143200
492,2143833,43,91800,108000,96.0,2409,2023-04-04T22:24,0,91800
493,3056860,44,498000,0,100.0,1,2023-04-04T22:24,0,498000
494,2379000,45,151500,159000,97.0,110,2023-04-04T22:24,0,151500
495,2071613,46,99000,0,92.0,1497,2023-04-04T22:24,0,99000
496,2910086,47,265500,295000,98.0,188,2023-04-04T22:24,0,265500
497,1724193,48,251900,280000,98.0,1470,2023-04-04T22:24,0,251900
498,2736221,49,99000,110000,96.0,238,2023-04-04T22:24,0,99000
499,3132541,50,69000,0,100.0,9,2023-04-04T22:24,-6900,62100
500,1720817,51,175000,0,98.0,187,2023-04-04T22:24,0,175000
501,626636,52,260000,0,96.0,1110,2023-04-04T22:24,0,260000
502,3061996,53,88200,98000,97.0,61,2023-04-04T22:24,0,88200
503,1897197,54,53100,59000,96.0,936,2023-04-04T22:24,0,53100
504,2419871,55,44900,59000,97.0,897,2023-04-04T22:24,0,44900
505,1815709,56,138000,168000,96.0,7125,2023-04-04T22:24,0,138000
506,2434795,57,39900,59000,97.0,1465,2023-04-04T22:24,0,39900
507,2664373,58,65000,0,97.0,994,2023-04-04T22:24,0,65000
508,3075621,59,339000,0,98.0,63,2023-04-04T22:24,0,339000
509,1754219,60,31200,39000,96.0,2243,2023-04-04T22:24,0,31200
510,1730340,61,258000,0,97.0,4169,2023-04-04T22:24,0,258000
511,1128656,62,86800,99000,95.0,21605,2023-04-04T22:24,0,86800
512,2664372,63,65000,0,97.0,1028,2023-04-04T22:24,0,65000
513,595038,64,210000,0,96.0,1323,2023-04-04T22:24,0,210000
514,2518112,65,89250,105000,96.0,957,2023-04-04T22:24,0,89250
515,2032683,66,210000,0,96.0,170,2023-04-04T22:24,0,210000
516,2725922,67,690000,1110000,0.0,0,2023-04-04T22:24,0,690000
517,1699941,68,67150,79000,97.0,4827,2023-04-04T22:24,0,67150
518,549841,69,190000,0,93.0,2474,2023-04-04T22:24,0,190000
519,451851,70,268000,0,97.0,1946,2023-04-04T22:24,0,268000
520,2956589,71,628000,840000,100.0,1,2023-04-04T22:24,0,628000
521,3093902,72,169000,0,98.0,16,2023-04-04T22:24,0,169000
522,2972872,73,65000,0,97.0,310,2023-04-04T22:24,0,65000
523,2306631,74,24900,0,96.0,2068,2023-04-04T22:24,0,24900
524,2690519,75,73800,82000,96.0,163,2023-04-04T22:24,0,73800
525,636821,76,152100,169000,93.0,2578,2023-04-04T22:24,0,152100
526,3130686,77,169000,0,0.0,0,2023-04-04T22:24,0,169000
527,2330196,78,59000,0,97.0,626,2023-04-04T22:24,0,59000
528,1215246,79,54300,110000,95.0,356,2023-04-04T22:24,0,54300
529,2557909,80,114000,190000,95.0,93,2023-04-04T22:24,0,114000
530,2599641,81,67830,119000,96.0,1998,2023-04-04T22:24,-3392,64438
531,3156683,82,259000,299000,100.0,5,2023-04-04T22:24,-12950,246050
532,2589483,83,65000,0,97.0,1293,2023-04-04T22:24,0,65000
533,1439527,84,49000,0,95.0,13427,2023-04-04T22:24,0,49000
534,1562988,85,260000,0,97.0,1478,2023-04-04T22:24,0,260000
535,1010925,86,170000,0,96.0,2088,2023-04-04T22:24,0,170000
536,2091779,87,75600,89000,97.0,989,2023-04-04T22:24,0,75600
537,2816817,88,179900,0,94.0,311,2023-04-04T22:24,0,179900
538,1755977,89,31500,45000,95.0,4159,2023-04-04T22:24,0,31500
539,626637,90,260000,0,96.0,386,2023-04-04T22:24,0,260000
540,1214164,1,36000,0,96.0,24874,2023-04-04T22:24,0,36000
541,2280117,2,35100,39000,97.0,6199,2023-04-04T22:24,0,35100
542,1771137,3,29000,0,97.0,12458,2023-04-04T22:24,0,29000
543,2134140,4,39000,0,97.0,3484,2023-04-04T22:24,0,39000
544,1022013,5,79000,0,96.0,6255,2023-04-04T22:24,0,79000
545,1771132,6,29000,0,96.0,5225,2023-04-04T22:24,0,29000
546,1822717,7,56050,59000,97.0,4279,2023-04-04T22:24,-2803,53247
547,1272626,8,36000,0,96.0,14102,2023-04-04T22:24,0,36000
548,2356713,9,39000,0,97.0,1444,2023-04-04T22:24,0,39000
549,1214109,10,36000,0,97.0,8088,2023-04-04T22:24,0,36000
550,1214173,11,36000,0,96.0,5548,2023-04-04T22:24,0,36000
551,2879419,12,46900,55000,98.0,672,2023-04-04T22:24,0,46900
552,1022014,13,79000,0,96.0,11424,2023-04-04T22:24,0,79000
553,1214174,14,36000,0,97.0,14998,2023-04-04T22:24,0,36000
554,2286829,15,37000,0,95.0,4905,2023-04-04T22:24,0,37000
555,2123132,16,39000,0,97.0,6377,2023-04-04T22:24,-3900,35100
556,3125906,17,80100,89000,100.0,3,2023-04-04T22:24,0,80100
557,2356711,18,39000,0,98.0,1477,2023-04-04T22:24,0,39000
558,1214317,19,36000,0,97.0,11462,2023-04-04T22:24,0,36000
559,2134158,20,39000,0,97.0,2486,2023-04-04T22:24,0,39000
560,1920929,21,39000,0,97.0,3960,2023-04-04T22:24,0,39000
561,1907733,22,29900,39000,96.0,3813,2023-04-04T22:24,0,29900
562,2464070,23,44000,55000,96.0,333,2023-04-04T22:24,-2200,41800
563,1214169,24,36000,0,97.0,5312,2023-04-04T22:24,0,36000
564,2672186,25,20900,30000,96.0,560,2023-04-04T22:24,-2090,18810
565,2356693,26,39000,0,97.0,1516,2023-04-04T22:24,0,39000
566,2329375,27,34710,39000,96.0,2075,2023-04-04T22:24,0,34710
567,1855444,28,39900,42000,97.0,2999,2023-04-04T22:24,0,39900
568,2879425,29,46900,55000,98.0,262,2023-04-04T22:24,0,46900
569,3039055,30,34400,43000,92.0,31,2023-04-04T22:24,0,34400
570,3153584,31,45000,0,99.0,21,2023-04-04T22:24,-2250,42750
571,1925814,32,35100,39000,96.0,1642,2023-04-04T22:24,0,35100
572,2134287,33,39000,0,98.0,698,2023-04-04T22:24,0,39000
573,1771133,34,29000,0,97.0,5672,2023-04-04T22:24,0,29000
574,3012243,35,29900,39900,98.0,59,2023-04-04T22:24,0,29900
575,3142351,36,49000,0,100.0,10,2023-04-04T22:24,-4900,44100
576,2280146,37,35100,39000,97.0,919,2023-04-04T22:24,0,35100
577,1524720,38,36000,0,96.0,3367,2023-04-04T22:24,0,36000
578,1300684,39,41300,59000,92.0,247,2023-04-04T22:24,0,41300
579,2287131,40,37000,0,94.0,1602,2023-04-04T22:24,0,37000
580,2028240,41,39000,0,98.0,3339,2023-04-04T22:24,0,39000
581,2573131,42,39900,42000,98.0,688,2023-04-04T22:24,0,39900
582,2107999,43,36000,0,97.0,2654,2023-04-04T22:24,0,36000
583,1945782,44,56000,0,97.0,2506,2023-04-04T22:24,0,56000
584,1497550,45,29600,37000,95.0,5670,2023-04-04T22:24,0,29600
585,2164773,46,69000,0,97.0,515,2023-04-04T22:24,0,69000
586,2560668,47,58650,69000,97.0,1238,2023-04-04T22:24,0,58650
587,2864918,48,49000,0,99.0,119,2023-04-04T22:24,0,49000
588,1335132,49,29000,0,95.0,1100,2023-04-04T22:24,0,29000
589,3038180,50,43700,46000,97.0,118,2023-04-04T22:24,-4370,39330
590,2089719,51,36000,0,97.0,2397,2023-04-04T22:24,0,36000
591,2645237,52,49000,0,95.0,120,2023-04-04T22:24,0,49000
592,1632175,53,39000,0,97.0,2699,2023-04-04T22:24,-3900,35100
593,2922336,54,52000,0,97.0,137,2023-04-04T22:24,0,52000
594,2221221,55,35100,39000,96.0,1847,2023-04-04T22:24,0,35100
595,2687157,56,45000,0,97.0,1023,2023-04-04T22:24,0,45000
596,2424822,57,35100,39000,96.0,1041,2023-04-04T22:24,0,35100
597,2591291,58,39200,49000,97.0,1018,2023-04-04T22:24,0,39200
598,1744607,59,27300,39000,95.0,274,2023-04-04T22:24,0,27300
599,2998516,60,29000,0,96.0,138,2023-04-04T22:24,0,29000
600,2381807,61,58650,69000,98.0,1150,2023-04-04T22:24,0,58650
601,2707659,62,42000,0,97.0,507,2023-04-04T22:24,0,42000
602,3155974,63,33300,37000,96.0,6,2023-04-04T22:24,-3330,29970
603,1906772,64,39900,42000,97.0,3050,2023-04-04T22:24,0,39900
604,3142350,65,49000,0,100.0,5,2023-04-04T22:24,-4900,44100
605,1214171,66,36000,0,97.0,1702,2023-04-04T22:24,0,36000
606,2650965,67,46900,53000,98.0,362,2023-04-04T22:24,0,46900
607,3142349,68,49000,0,100.0,1,2023-04-04T22:24,-4900,44100
608,2070540,69,329000,0,100.0,3,2023-04-04T22:24,0,329000
609,2157077,70,37800,42000,95.0,729,2023-04-04T22:24,0,37800
610,1433907,71,29250,39000,93.0,1475,2023-04-04T22:24,0,29250
611,1755276,72,49000,0,97.0,2402,2023-04-04T22:24,0,49000
612,3051109,73,39200,49000,96.0,34,2023-04-04T22:24,0,39200
613,1602670,74,56050,59000,97.0,739,2023-04-04T22:24,0,56050
614,1906773,75,39900,42000,97.0,654,2023-04-04T22:24,0,39900
615,2658143,76,35100,39000,96.0,259,2023-04-04T22:24,0,35100
616,3099783,77,57000,0,97.0,7,2023-04-04T22:24,0,57000
617,2244284,78,36000,0,97.0,589,2023-04-04T22:24,0,36000
618,2280751,79,29000,0,97.0,1334,2023-04-04T22:24,0,29000
619,3125919,80,62100,69000,0.0,0,2023-04-04T22:24,0,62100
620,1214193,81,39000,0,97.0,15334,2023-04-04T22:24,0,39000
621,1836699,82,79000,0,96.0,258,2023-04-04T22:24,0,79000
622,2879417,83,46900,55000,98.0,187,2023-04-04T22:24,0,46900
623,1939301,84,39000,0,97.0,800,2023-04-04T22:24,0,39000
624,1086824,85,29600,37000,95.0,18613,2023-04-04T22:24,0,29600
625,1214106,86,36000,0,96.0,9720,2023-04-04T22:24,0,36000
626,1214316,87,36000,0,97.0,1983,2023-04-04T22:24,0,36000
627,3129450,88,44100,49000,0.0,0,2023-04-04T22:24,0,44100
628,2234533,89,31200,39000,97.0,508,2023-04-04T22:24,0,31200
629,1760824,90,49700,59000,97.0,300,2023-04-04T22:24,0,49700
630,3171883,1,149000,0,0.0,0,2023-04-04T22:24,0,149000
631,3111732,2,67200,84000,100.0,3,2023-04-04T22:24,-3360,63840
632,3106487,3,148000,0,99.0,24,2023-04-04T22:24,0,148000
633,3174221,4,209000,0,0.0,0,2023-04-04T22:24,-37620,171380
634,3073257,5,196200,218000,94.0,10,2023-04-04T22:24,-35316,160884
635,3135904,6,92000,0,100.0,2,2023-04-04T22:24,0,92000
636,3112829,7,360000,0,0.0,0,2023-04-04T22:24,-64800,295200
637,2717506,8,348000,0,0.0,0,2023-04-04T22:24,0,348000
638,3171882,9,149000,0,100.0,2,2023-04-04T22:24,0,149000
639,3053219,10,159000,0,100.0,2,2023-04-04T22:24,0,159000
640,3122373,11,151200,168000,0.0,0,2023-04-04T22:24,-27216,123984
641,3149931,12,109000,0,0.0,0,2023-04-04T22:24,0,109000
642,3171881,13,149000,0,100.0,2,2023-04-04T22:24,0,149000
643,2585187,14,148000,0,94.0,11,2023-04-04T22:24,0,148000
644,3119224,15,199000,0,100.0,3,2023-04-04T22:24,0,199000
645,2605850,16,94000,0,97.0,164,2023-04-04T22:24,0,94000
646,1779568,17,57600,64000,95.0,289,2023-04-04T22:24,0,57600
647,3160500,18,278000,0,0.0,0,2023-04-04T22:24,-13900,264100
648,2568529,19,220000,0,100.0,10,2023-04-04T22:24,0,220000
649,3145662,20,269000,0,0.0,0,2023-04-04T22:24,-13450,255550
650,3046091,21,235600,248000,100.0,5,2023-04-04T22:24,0,235600
651,2489894,22,142200,158000,98.0,102,2023-04-04T22:24,0,142200
652,1955908,23,55800,93000,92.0,63,2023-04-04T22:24,0,55800
653,3134492,24,79000,0,100.0,3,2023-04-04T22:24,0,79000
654,1341924,25,98800,152000,96.0,79,2023-04-04T22:24,0,98800
655,1794791,26,218000,0,100.0,8,2023-04-04T22:24,0,218000
656,3154902,27,218000,0,0.0,0,2023-04-04T22:24,0,218000
657,3109987,28,223000,298000,0.0,0,2023-04-04T22:24,0,223000
658,3081771,29,189000,0,100.0,5,2023-04-04T22:24,0,189000
659,3053760,30,178200,198000,0.0,0,2023-04-04T22:24,0,178200
660,2593633,31,212000,0,100.0,3,2023-04-04T22:24,0,212000
661,2765755,32,198000,0,100.0,3,2023-04-04T22:24,0,198000
662,3155026,33,58500,78000,100.0,2,2023-04-04T22:24,-11700,46800
663,3041848,34,168000,0,0.0,0,2023-04-04T22:24,0,168000
664,3053223,35,179000,0,100.0,4,2023-04-04T22:24,0,179000
665,2568590,36,185000,0,100.0,5,2023-04-04T22:24,0,185000
666,3119222,37,179000,0,0.0,0,2023-04-04T22:24,0,179000
667,3119223,38,199000,0,0.0,0,2023-04-04T22:24,0,199000
668,3173636,39,178000,0,0.0,0,2023-04-04T22:24,0,178000
669,3119226,40,199000,0,0.0,0,2023-04-04T22:24,0,199000
670,3050856,41,189000,0,93.0,12,2023-04-04T22:24,0,189000
671,3093945,42,199000,0,0.0,0,2023-04-04T22:24,0,199000
672,1989644,43,169000,0,100.0,1,2023-04-04T22:24,0,169000
673,1579103,44,126400,158000,96.0,97,2023-04-04T22:24,0,126400
674,3122381,45,151200,168000,92.0,5,2023-04-04T22:24,-27216,123984
675,3075322,46,198000,0,0.0,0,2023-04-04T22:24,0,198000
676,3130645,47,119000,0,0.0,0,2023-04-04T22:24,0,119000
677,3053218,48,159000,0,86.0,3,2023-04-04T22:24,0,159000
678,3196917,49,159000,0,0.0,0,2023-04-04T22:24,0,159000
679,2584899,50,187000,0,0.0,0,2023-04-04T22:24,0,187000
680,2524827,51,188000,0,100.0,3,2023-04-04T22:24,0,188000
681,3132939,52,158000,0,0.0,0,2023-04-04T22:24,0,158000
682,3173691,53,178000,0,0.0,0,2023-04-04T22:24,0,178000
683,2489892,54,142200,158000,95.0,20,2023-04-04T22:24,0,142200
684,2478652,55,57800,68000,94.0,329,2023-04-04T22:24,0,57800
685,2492336,56,89100,99000,94.0,27,2023-04-04T22:24,0,89100
686,3173662,57,178000,0,0.0,0,2023-04-04T22:24,0,178000
687,3055337,58,159000,0,0.0,0,2023-04-04T22:24,0,159000
688,3135234,59,80100,89000,100.0,2,2023-04-04T22:24,-8010,72090
689,2569941,60,139000,0,96.0,18,2023-04-04T22:24,0,139000
690,3146668,61,159600,168000,100.0,3,2023-04-04T22:24,0,159600
691,1455772,62,94000,0,96.0,208,2023-04-04T22:24,0,94000
692,2392489,63,31900,0,97.0,724,2023-04-04T22:24,0,31900
693,1810935,64,169200,188000,0.0,0,2023-04-04T22:24,0,169200
694,3144919,65,179100,199000,0.0,0,2023-04-04T22:24,0,179100
695,2558167,66,159200,199000,97.0,9,2023-04-04T22:24,0,159200
696,3179874,67,148000,0,0.0,0,2023-04-04T22:24,0,148000
697,1946246,68,159000,0,100.0,1,2023-04-04T22:24,0,159000
698,2533599,69,45050,53000,95.0,64,2023-04-04T22:24,0,45050
699,2580032,70,159000,199000,100.0,1,2023-04-04T22:24,0,159000
700,3152277,71,119000,178000,0.0,0,2023-04-04T22:24,0,119000
701,3134135,72,158000,0,0.0,0,2023-04-04T22:24,0,158000
702,2996346,73,145800,162000,100.0,2,2023-04-04T22:24,0,145800
703,2537957,74,153000,219000,100.0,1,2023-04-04T22:24,0,153000
704,2453664,75,148400,185500,100.0,5,2023-04-04T22:24,0,148400
705,2388209,76,94000,0,96.0,156,2023-04-04T22:24,0,94000
706,3178109,77,150000,0,0.0,0,2023-04-04T22:24,0,150000
707,2512635,78,35400,59000,96.0,205,2023-04-04T22:24,0,35400
708,2699769,79,139000,0,100.0,5,2023-04-04T22:24,0,139000
709,2848613,80,86900,0,100.0,3,2023-04-04T22:24,0,86900
710,3195364,81,129000,0,0.0,0,2023-04-04T22:24,0,129000
711,3182232,82,132000,0,0.0,0,2023-04-04T22:24,0,132000
712,3134129,83,128000,0,0.0,0,2023-04-04T22:24,0,128000
713,3084762,84,119000,0,100.0,1,2023-04-04T22:24,0,119000
714,3150242,85,71920,89900,0.0,0,2023-04-04T22:24,0,71920
715,1622447,86,62100,69000,90.0,185,2023-04-04T22:24,0,62100
716,3171849,87,119000,0,0.0,0,2023-04-04T22:24,-11900,107100
717,3167114,88,125100,139000,0.0,0,2023-04-04T22:24,0,125100
718,3041479,89,118000,0,100.0,1,2023-04-04T22:24,0,118000
719,2714533,90,48300,69000,93.0,232,2023-04-04T22:24,-9660,38640
720,3031104,1,55200,69000,98.0,54,2023-04-04T22:24,0,55200
721,2117249,2,32900,0,94.0,450,2023-04-04T22:24,0,32900
722,2942764,3,189000,0,98.0,12,2023-04-04T22:24,0,189000
723,2448900,4,39490,43900,96.0,94,2023-04-04T22:24,0,39490
724,3062954,5,87200,109000,100.0,2,2023-04-04T22:24,0,87200
725,2864414,6,69300,99000,94.0,84,2023-04-04T22:24,0,69300
726,3040745,7,88000,110000,94.0,14,2023-04-04T22:24,-4400,83600
727,2551401,8,37900,0,94.0,297,2023-04-04T22:24,0,37900
728,3119333,9,379000,0,0.0,0,2023-04-04T22:24,0,379000
729,2756335,10,125400,132000,96.0,57,2023-04-04T22:24,0,125400
730,2713273,11,359000,0,100.0,1,2023-04-04T22:24,0,359000
731,3038425,12,111200,139000,93.0,3,2023-04-04T22:24,0,111200
732,3081768,13,169000,0,100.0,3,2023-04-04T22:24,0,169000
733,2257612,14,43900,0,96.0,59,2023-04-04T22:24,0,43900
734,1645760,15,39390,43900,96.0,340,2023-04-04T22:24,0,39390
735,2830808,16,139000,0,97.0,16,2023-04-04T22:24,0,139000
736,2925522,17,58500,65000,95.0,97,2023-04-04T22:24,0,58500
737,2551407,18,37900,0,97.0,158,2023-04-04T22:24,0,37900
738,3000422,19,59000,0,97.0,25,2023-04-04T22:24,0,59000
739,2408970,20,268000,0,0.0,0,2023-04-04T22:24,0,268000
740,3037452,21,126650,149000,100.0,3,2023-04-04T22:24,0,126650
741,1931894,22,37900,0,95.0,505,2023-04-04T22:24,0,37900
742,2390967,23,39530,59000,93.0,206,2023-04-04T22:24,-7906,31624
743,2643770,24,124000,138000,98.0,18,2023-04-04T22:24,-22320,101680
744,2643318,25,124000,138000,96.0,13,2023-04-04T22:24,-22320,101680
745,2117256,26,37900,0,96.0,246,2023-04-04T22:24,0,37900
746,2413507,27,129000,0,95.0,43,2023-04-04T22:24,-23220,105780
747,3037451,28,239200,299000,0.0,0,2023-04-04T22:24,0,239200
748,2733218,29,238000,0,0.0,0,2023-04-04T22:24,-42840,195160
749,2340410,30,62300,89000,96.0,19,2023-04-04T22:24,0,62300
750,3120375,31,68000,0,100.0,8,2023-04-04T22:24,0,68000
751,3130581,32,119000,0,0.0,0,2023-04-04T22:24,-21420,97580
752,3104752,33,219000,0,0.0,0,2023-04-04T22:24,0,219000
753,3040758,34,83200,111000,98.0,10,2023-04-04T22:24,-4160,79040
754,2504390,35,110600,158000,92.0,14,2023-04-04T22:24,-11060,99540
755,1961666,36,73000,0,96.0,58,2023-04-04T22:24,0,73000
756,3111743,37,58650,69000,100.0,2,2023-04-04T22:24,-2933,55717
757,2794722,38,199000,0,0.0,0,2023-04-04T22:24,-23880,175120
758,2448902,39,37290,43900,94.0,97,2023-04-04T22:24,0,37290
759,3124643,40,198000,0,0.0,0,2023-04-04T22:24,-29700,168300
760,3134486,41,188340,219000,0.0,0,2023-04-04T22:24,-33902,154438
761,2378593,42,88200,98000,94.0,70,2023-04-04T22:24,0,88200
762,2873429,43,198000,0,0.0,0,2023-04-04T22:24,0,198000
763,3149629,44,125100,139000,0.0,0,2023-04-04T22:24,-22518,102582
764,3058718,45,96000,0,97.0,9,2023-04-04T22:24,-17280,78720
765,3134481,46,188340,219000,0.0,0,2023-04-04T22:24,-33902,154438
766,3073252,47,160200,178000,100.0,4,2023-04-04T22:24,-28836,131364
767,3058716,48,96000,0,100.0,5,2023-04-04T22:24,-17280,78720
768,2842784,49,188000,0,0.0,0,2023-04-04T22:24,0,188000
769,1819994,50,36500,43000,92.0,657,2023-04-04T22:24,0,36500
770,3080578,51,89000,0,0.0,0,2023-04-04T22:24,-8900,80100
771,3104488,52,98000,0,100.0,1,2023-04-04T22:24,0,98000
772,3125453,53,55200,89900,93.0,3,2023-04-04T22:24,-2760,52440
773,3133082,54,171000,0,80.0,3,2023-04-04T22:24,0,171000
774,2664567,55,173000,0,0.0,0,2023-04-04T22:24,0,173000
775,3035265,56,58900,62000,97.0,14,2023-04-04T22:24,0,58900
776,1955949,57,29700,45000,96.0,480,2023-04-04T22:24,-5940,23760
777,3040573,58,169100,178000,100.0,5,2023-04-04T22:24,0,169100
778,3144417,59,79000,0,0.0,0,2023-04-04T22:24,0,79000
779,3133296,60,159000,0,0.0,0,2023-04-04T22:24,0,159000
780,3043138,61,43200,54000,100.0,1,2023-04-04T22:24,-2160,41040
781,3126112,62,63200,79000,97.0,14,2023-04-04T22:24,0,63200
782,2300718,63,39390,43900,95.0,238,2023-04-04T22:24,0,39390
783,3170471,64,139000,0,0.0,0,2023-04-04T22:24,0,139000
784,3122281,65,160200,178000,100.0,1,2023-04-04T22:24,-28836,131364
785,3079664,66,168000,0,100.0,1,2023-04-04T22:24,0,168000
786,3073258,67,160200,178000,97.0,7,2023-04-04T22:24,-28836,131364
787,1645762,68,39390,43900,94.0,334,2023-04-04T22:24,0,39390
788,2551404,69,37900,0,94.0,77,2023-04-04T22:24,0,37900
789,3033937,70,89900,0,0.0,0,2023-04-04T22:24,0,89900
790,1944554,71,36900,0,96.0,535,2023-04-04T22:24,0,36900
791,2117252,72,32900,0,97.0,135,2023-04-04T22:24,0,32900
792,2796164,73,59200,74000,96.0,106,2023-04-04T22:24,0,59200
793,3200263,74,144000,0,0.0,0,2023-04-04T22:24,0,144000
794,3193136,75,149000,0,0.0,0,2023-04-04T22:24,0,149000
795,2551400,76,39900,0,93.0,133,2023-04-04T22:24,0,39900
796,2644801,77,142400,178000,100.0,1,2023-04-04T22:24,-25632,116768
797,3178147,78,150000,0,0.0,0,2023-04-04T22:24,0,150000
798,1980169,79,37100,53000,93.0,152,2023-04-04T22:24,-7420,29680
799,3064827,80,50150,59000,99.0,22,2023-04-04T22:24,-10030,40120
800,2745019,81,152600,218000,91.0,19,2023-04-04T22:24,-15260,137340
801,2111542,82,39900,0,95.0,387,2023-04-04T22:24,0,39900
802,2801882,83,79900,0,91.0,9,2023-04-04T22:24,0,79900
803,3111739,84,65600,82000,100.0,3,2023-04-04T22:24,-3280,62320
804,3093417,85,149000,0,100.0,2,2023-04-04T22:24,0,149000
805,2737869,86,146300,209000,93.0,3,2023-04-04T22:24,-26334,119966
806,2614300,87,147000,0,80.0,1,2023-04-04T22:24,0,147000
807,3122265,88,124200,138000,88.0,5,2023-04-04T22:24,-22356,101844
808,3062947,89,124200,138000,100.0,3,2023-04-04T22:24,0,124200
809,3092933,90,139000,0,0.0,0,2023-04-04T22:24,0,139000
810,991339,1,17890,19900,97.0,52547,2023-04-04T22:24,0,17890
811,1986031,2,24990,27900,97.0,10488,2023-04-04T22:24,0,24990
812,1094748,3,19900,0,97.0,19048,2023-04-04T22:24,0,19900
813,998051,4,12900,24000,97.0,162212,2023-04-04T22:24,0,12900
814,991340,5,17890,19900,97.0,30770,2023-04-04T22:24,0,17890
815,763821,6,13900,22000,96.0,31311,2023-04-04T22:24,0,13900
816,1477845,7,15400,22000,96.0,9603,2023-04-04T22:24,0,15400
817,792919,8,15190,16900,96.0,17906,2023-04-04T22:24,0,15190
818,1094835,9,14290,15900,97.0,6184,2023-04-04T22:24,0,14290
819,1342874,10,16900,33000,97.0,12701,2023-04-04T22:24,0,16900
820,2959925,11,22000,27500,99.0,84,2023-04-04T22:24,-2200,19800
821,991570,12,12900,20000,97.0,19017,2023-04-04T22:24,0,12900
822,1986029,13,27900,0,97.0,3915,2023-04-04T22:24,0,27900
823,746154,14,17900,0,96.0,5151,2023-04-04T22:24,0,17900
824,479245,15,15400,22000,93.0,5383,2023-04-04T22:24,0,15400
825,1996702,16,23690,27900,97.0,1914,2023-04-04T22:24,0,23690
826,1094750,17,16890,19900,97.0,3547,2023-04-04T22:24,0,16890
827,746158,18,22900,0,96.0,20505,2023-04-04T22:24,0,22900
828,1443937,19,12900,24000,97.0,7848,2023-04-04T22:24,0,12900
829,734085,20,10900,19800,96.0,64648,2023-04-04T22:24,0,10900
830,1996705,21,23690,27900,98.0,2678,2023-04-04T22:24,0,23690
831,991341,22,16890,19900,96.0,10185,2023-04-04T22:24,0,16890
832,1986030,23,23690,27900,97.0,1655,2023-04-04T22:24,0,23690
833,1729576,24,9500,13900,97.0,15993,2023-04-04T22:24,0,9500
834,2960555,25,19000,0,94.0,97,2023-04-04T22:24,0,19000
835,2832613,26,11200,33000,97.0,638,2023-04-04T22:24,0,11200
836,2297277,27,19900,22000,95.0,275,2023-04-04T22:24,0,19900
837,1346009,28,9900,12000,97.0,6679,2023-04-04T22:24,0,9900
838,792920,29,15190,16900,96.0,9659,2023-04-04T22:24,0,15190
839,1821485,30,30000,0,96.0,1248,2023-04-04T22:24,0,30000
840,746159,31,22900,0,95.0,28713,2023-04-04T22:24,0,22900
841,1094834,32,21490,23900,96.0,2455,2023-04-04T22:24,0,21490
842,2011850,33,21490,23900,98.0,858,2023-04-04T22:24,0,21490
843,2845854,34,13200,18900,97.0,204,2023-04-04T22:24,0,13200
844,2821598,35,19390,22900,97.0,141,2023-04-04T22:24,0,19390
845,1094836,36,14290,15900,97.0,1310,2023-04-04T22:24,0,14290
846,2011852,37,21490,23900,97.0,1301,2023-04-04T22:24,0,21490
847,1974077,38,42090,46900,97.0,896,2023-04-04T22:24,0,42090
848,1477846,39,15400,22000,96.0,2666,2023-04-04T22:24,0,15400
849,1821487,40,30000,0,97.0,675,2023-04-04T22:24,0,30000
850,1360044,41,19900,0,97.0,1755,2023-04-04T22:24,0,19900
851,2467197,42,30000,0,95.0,130,2023-04-04T22:24,0,30000
852,1094749,43,19900,0,96.0,4946,2023-04-04T22:24,0,19900
853,1996704,44,22290,27900,97.0,695,2023-04-04T22:24,0,22290
854,1348077,45,10900,16500,97.0,1857,2023-04-04T22:24,0,10900
855,1094837,46,13490,15900,96.0,1750,2023-04-04T22:24,0,13490
856,1260388,47,20900,0,95.0,671,2023-04-04T22:24,0,20900
857,2477852,48,17890,19900,98.0,677,2023-04-04T22:24,0,17890
858,2821588,49,19690,21900,97.0,52,2023-04-04T22:24,0,19690
859,1260383,50,19900,0,95.0,1451,2023-04-04T22:24,0,19900
860,1358721,51,14200,22000,96.0,1113,2023-04-04T22:24,0,14200
861,1092995,52,20590,22900,96.0,1591,2023-04-04T22:24,0,20590
862,2509300,53,19900,0,96.0,390,2023-04-04T22:24,0,19900
863,2821589,54,19690,21900,95.0,33,2023-04-04T22:24,0,19690
864,2618262,55,39200,49000,98.0,25,2023-04-04T22:24,-1960,37240
865,2711708,56,26100,29000,98.0,67,2023-04-04T22:24,-5220,20880
866,1286366,57,11900,24000,97.0,9790,2023-04-04T22:24,0,11900
867,2347097,58,14900,24000,98.0,1541,2023-04-04T22:24,0,14900
868,2346958,59,18200,24000,98.0,509,2023-04-04T22:24,0,18200
869,3065854,60,21250,25000,98.0,13,2023-04-04T22:24,0,21250
870,3009680,61,12590,14900,98.0,99,2023-04-04T22:24,0,12590
871,1475031,62,16900,27000,96.0,1716,2023-04-04T22:24,0,16900
872,2798430,63,24000,29000,97.0,41,2023-04-04T22:24,-3600,20400
873,792921,64,15190,16900,95.0,7806,2023-04-04T22:24,0,15190
874,2929635,65,15900,27000,97.0,507,2023-04-04T22:24,0,15900
875,752821,66,9900,0,94.0,23734,2023-04-04T22:24,0,9900
876,472686,67,9500,14800,94.0,710,2023-04-04T22:24,0,9500
877,1392772,68,16890,19900,96.0,1137,2023-04-04T22:24,0,16890
878,1777081,69,8000,12800,96.0,1162,2023-04-04T22:24,0,8000
879,2835702,70,13900,15800,97.0,61,2023-04-04T22:24,-1390,12510
880,2652498,71,9500,12000,97.0,108,2023-04-04T22:24,0,9500
881,2832629,72,9600,25600,96.0,70,2023-04-04T22:24,0,9600
882,1360043,73,17890,19900,97.0,788,2023-04-04T22:24,0,17890
883,1475055,74,16200,22000,96.0,1167,2023-04-04T22:24,0,16200
884,1092994,75,22900,0,96.0,2644,2023-04-04T22:24,0,22900
885,1260384,76,19900,0,95.0,1796,2023-04-04T22:24,0,19900
886,2971853,77,19000,0,94.0,43,2023-04-04T22:24,0,19000
887,2870865,78,15900,19900,96.0,57,2023-04-04T22:24,0,15900
888,3129049,79,19000,0,100.0,5,2023-04-04T22:24,-1900,17100
889,2821597,80,22900,0,98.0,103,2023-04-04T22:24,0,22900
890,1573974,81,39790,46900,97.0,1450,2023-04-04T22:24,0,39790
891,2477854,82,17890,19900,98.0,1449,2023-04-04T22:24,0,17890
892,1387502,83,12690,15900,95.0,511,2023-04-04T22:24,0,12690
893,1062062,84,17890,19900,96.0,1454,2023-04-04T22:24,0,17890
894,1392773,85,16890,19900,95.0,1470,2023-04-04T22:24,0,16890
895,2652523,86,9500,12000,98.0,109,2023-04-04T22:24,0,9500
896,2610915,87,17000,0,94.0,92,2023-04-04T22:24,-3060,13940
897,1547562,88,15400,22000,95.0,1360,2023-04-04T22:24,0,15400
898,1647682,89,14900,23600,97.0,945,2023-04-04T22:24,0,14900
899,2990345,90,27900,0,98.0,45,2023-04-04T22:24,0,27900
