,item_id,rank,price,del_price,rating,rating_count,time,coupon,real_price
0,2272830,1,35910,39900,97.0,18250,2023-03-27T19:34,-3591,32319
1,3071087,2,84550,89000,96.0,270,2023-03-27T19:34,-16910,67640
2,1848166,3,49000,0,97.0,40664,2023-03-27T19:34,0,49000
3,2086653,4,16900,0,97.0,38462,2023-03-27T19:34,0,16900
4,2453556,5,39900,42000,97.0,6128,2023-03-27T19:34,-7980,31920
5,345889,6,29900,47900,95.0,9522,2023-03-27T19:34,0,29900
6,1503352,7,39900,42000,97.0,8289,2023-03-27T19:34,-7980,31920
7,2313388,8,76500,85000,96.0,2053,2023-03-27T19:34,0,76500
8,2646350,9,59800,94000,95.0,3887,2023-03-27T19:34,-2990,56810
9,2375962,10,59000,62000,98.0,5097,2023-03-27T19:34,-8850,50150
10,3056873,11,47520,72000,96.0,55,2023-03-27T19:34,0,47520
11,2149254,12,37800,0,97.0,32159,2023-03-27T19:34,-5670,32130
12,2453552,13,39900,42000,97.0,2864,2023-03-27T19:34,-7980,31920
13,1201421,14,199000,0,94.0,106,2023-03-27T19:34,0,199000
14,2038497,15,36000,45000,95.0,16106,2023-03-27T19:34,-3600,32400
15,2396645,16,39900,59000,96.0,23017,2023-03-27T19:34,0,39900
16,2314616,17,39000,43000,97.0,8008,2023-03-27T19:34,0,39000
17,1817394,18,59900,150000,93.0,7013,2023-03-27T19:34,0,59900
18,1549281,19,71250,75000,97.0,5719,2023-03-27T19:34,-14250,57000
19,2204747,20,71250,75000,97.0,2079,2023-03-27T19:34,-14250,57000
20,2326935,21,55300,79000,96.0,12792,2023-03-27T19:34,-5530,49770
21,1782647,22,39900,42000,97.0,3454,2023-03-27T19:34,-7980,31920
22,1939099,23,29400,49000,97.0,11561,2023-03-27T19:34,0,29400
23,2996536,24,39900,59000,97.0,375,2023-03-27T19:34,0,39900
24,1582356,25,49200,82000,96.0,15945,2023-03-27T19:34,0,49200
25,2377269,26,45000,0,97.0,3738,2023-03-27T19:34,0,45000
26,1782641,27,39900,42000,97.0,2571,2023-03-27T19:34,-7980,31920
27,1943792,28,34400,43000,96.0,5191,2023-03-27T19:34,0,34400
28,2354252,29,71250,75000,97.0,1733,2023-03-27T19:34,-14250,57000
29,3071084,30,51300,54000,95.0,94,2023-03-27T19:34,-10260,41040
30,854337,31,33900,0,95.0,17101,2023-03-27T19:34,-3390,30510
31,1706633,32,199000,0,97.0,2359,2023-03-27T19:34,0,199000
32,2442409,33,39000,78000,96.0,8683,2023-03-27T19:34,0,39000
33,1763157,34,49400,52000,95.0,2584,2023-03-27T19:34,0,49400
34,1848797,35,169000,0,96.0,74,2023-03-27T19:34,0,169000
35,996177,36,15900,0,95.0,77173,2023-03-27T19:34,0,15900
36,3034895,37,101150,119000,98.0,307,2023-03-27T19:34,0,101150
37,3037619,38,36210,42600,93.0,88,2023-03-27T19:34,-7242,28968
38,2877493,39,59800,92000,95.0,1319,2023-03-27T19:34,0,59800
39,1498105,40,189000,0,97.0,1950,2023-03-27T19:34,0,189000
40,3071089,41,84550,89000,98.0,88,2023-03-27T19:34,-16910,67640
41,2085005,42,58650,69000,95.0,2006,2023-03-27T19:34,-2933,55717
42,2122566,43,33800,0,97.0,15202,2023-03-27T19:34,-6760,27040
43,1848855,44,169000,0,97.0,94,2023-03-27T19:34,0,169000
44,3032250,45,44800,64000,95.0,696,2023-03-27T19:34,0,44800
45,2660716,46,50400,72000,96.0,2069,2023-03-27T19:34,0,50400
46,2065708,47,59000,62000,98.0,6427,2023-03-27T19:34,-8850,50150
47,2775710,48,39800,49000,93.0,2391,2023-03-27T19:34,-3980,35820
48,2364807,49,219000,0,96.0,687,2023-03-27T19:34,0,219000
49,2784043,50,1260000,0,100.0,4,2023-03-27T19:34,-30000,1230000
50,1841764,51,31200,39000,96.0,12971,2023-03-27T19:34,-3120,28080
51,3052036,52,59400,66000,95.0,109,2023-03-27T19:34,0,59400
52,1763123,53,84550,89000,96.0,1651,2023-03-27T19:34,-4228,80322
53,2321863,54,49000,65000,96.0,3099,2023-03-27T19:34,0,49000
54,2305840,55,59700,0,97.0,3835,2023-03-27T19:34,0,59700
55,2065712,56,59000,62000,98.0,6571,2023-03-27T19:34,-8850,50150
56,3133235,57,32500,50000,100.0,8,2023-03-27T19:34,0,32500
57,2913656,58,44900,64000,95.0,240,2023-03-27T19:34,0,44900
58,2637710,59,680000,0,86.0,3,2023-03-27T19:34,-30000,650000
59,2065703,60,59000,62000,98.0,5348,2023-03-27T19:34,-8850,50150
60,1417691,61,13900,0,97.0,18232,2023-03-27T19:34,0,13900
61,1557508,62,27600,69000,96.0,14954,2023-03-27T19:34,0,27600
62,994588,63,39900,53000,93.0,5924,2023-03-27T19:34,-3990,35910
63,2034137,64,31800,0,97.0,16603,2023-03-27T19:34,-4770,27030
64,3150516,65,79800,126000,94.0,15,2023-03-27T19:34,-3990,75810
65,404474,66,27900,47800,94.0,43950,2023-03-27T19:34,0,27900
66,2392759,67,39680,49600,95.0,3845,2023-03-27T19:34,-7936,31744
67,1608272,68,39800,65590,96.0,3998,2023-03-27T19:34,0,39800
68,2226767,69,68400,76000,97.0,7113,2023-03-27T19:34,0,68400
69,407067,70,29250,39000,95.0,21369,2023-03-27T19:34,0,29250
70,2742638,71,992000,0,100.0,1,2023-03-27T19:34,-30000,962000
71,3043051,72,76500,85000,96.0,49,2023-03-27T19:34,0,76500
72,1382658,73,16900,0,94.0,47101,2023-03-27T19:34,0,16900
73,3026606,74,47900,64000,96.0,147,2023-03-27T19:34,-4790,43110
74,1005680,75,17500,35000,94.0,8911,2023-03-27T19:34,0,17500
75,2758254,76,31050,69000,97.0,606,2023-03-27T19:34,0,31050
76,2194649,77,63000,79000,96.0,4214,2023-03-27T19:34,-3150,59850
77,1211169,78,49680,69000,95.0,5667,2023-03-27T19:34,0,49680
78,1944612,79,35800,59700,97.0,2759,2023-03-27T19:34,-1790,34010
79,1828538,80,39900,69900,95.0,2864,2023-03-27T19:34,0,39900
80,1793989,81,199000,0,97.0,902,2023-03-27T19:34,0,199000
81,1921901,82,39800,70500,96.0,7536,2023-03-27T19:34,0,39800
82,1622019,83,32800,82000,96.0,4277,2023-03-27T19:34,0,32800
83,2758252,84,31050,69000,96.0,651,2023-03-27T19:34,0,31050
84,1336398,85,40200,67000,96.0,18956,2023-03-27T19:34,0,40200
85,3168846,86,79800,125000,100.0,3,2023-03-27T19:34,0,79800
86,1574201,87,71100,79000,97.0,4536,2023-03-27T19:34,0,71100
87,2775713,88,39800,49000,93.0,2823,2023-03-27T19:34,-3980,35820
88,2354305,89,71250,75000,96.0,1609,2023-03-27T19:34,-14250,57000
89,956939,90,61750,65000,95.0,13448,2023-03-27T19:34,-12350,49400
90,1778404,1,42000,45000,96.0,66410,2023-03-27T19:34,0,42000
91,1790383,2,59000,86000,95.0,5141,2023-03-27T19:34,-5900,53100
92,2723218,3,69900,109000,97.0,1926,2023-03-27T19:34,0,69900
93,2732486,4,109000,179000,98.0,538,2023-03-27T19:34,0,109000
94,2064545,5,74900,94000,97.0,10851,2023-03-27T19:34,-3745,71155
95,1576682,6,245000,339000,97.0,8479,2023-03-27T19:34,0,245000
96,1856181,7,35910,39900,97.0,6912,2023-03-27T19:34,-3591,32319
97,1576700,8,89000,129000,97.0,16350,2023-03-27T19:34,0,89000
98,1558197,9,81900,0,97.0,31956,2023-03-27T19:34,-8190,73710
99,1530516,10,69900,79000,96.0,2149,2023-03-27T19:34,0,69900
100,841230,11,154000,172000,96.0,7186,2023-03-27T19:34,0,154000
101,2723216,12,69900,109000,97.0,945,2023-03-27T19:34,0,69900
102,3012082,13,59900,79000,97.0,777,2023-03-27T19:34,-5990,53910
103,1618312,14,75390,83900,97.0,6971,2023-03-27T19:34,0,75390
104,1776552,15,65000,69000,94.0,6027,2023-03-27T19:34,0,65000
105,1283757,16,75390,83900,96.0,26435,2023-03-27T19:34,-7539,67851
106,2110493,17,389000,0,96.0,601,2023-03-27T19:34,0,389000
107,1195307,18,82400,103000,96.0,12475,2023-03-27T19:34,-8240,74160
108,2752332,19,84200,105300,95.0,2393,2023-03-27T19:34,0,84200
109,1571879,20,79900,112900,96.0,6954,2023-03-27T19:34,-7990,71910
110,3042936,21,90900,105000,97.0,284,2023-03-27T19:34,0,90900
111,2343198,22,119000,129000,97.0,4875,2023-03-27T19:34,0,119000
112,1108007,23,71790,79900,95.0,47774,2023-03-27T19:34,-7179,64611
113,2788216,24,127200,159000,98.0,82,2023-03-27T19:34,-14600,112600
114,1620285,25,299000,0,97.0,151,2023-03-27T19:34,0,299000
115,1337094,26,69900,0,95.0,5230,2023-03-27T19:34,-6990,62910
116,3044101,27,89900,99000,100.0,11,2023-03-27T19:34,-8990,80910
117,1530517,28,69900,79000,96.0,1950,2023-03-27T19:34,0,69900
118,2700381,29,1496000,0,100.0,3,2023-03-27T19:34,-30000,1466000
119,1291017,30,67900,96000,95.0,12829,2023-03-27T19:34,0,67900
120,1833230,31,95200,136000,97.0,5341,2023-03-27T19:34,0,95200
121,1776549,32,65000,69000,94.0,4565,2023-03-27T19:34,0,65000
122,1571878,33,79900,112900,96.0,4566,2023-03-27T19:34,-7990,71910
123,1778408,34,42000,45000,95.0,11502,2023-03-27T19:34,0,42000
124,1633664,35,76300,109000,97.0,4064,2023-03-27T19:34,0,76300
125,2471405,36,99000,138000,97.0,1939,2023-03-27T19:34,0,99000
126,2284220,37,79900,112900,96.0,1605,2023-03-27T19:34,0,79900
127,1280576,38,37200,62000,96.0,25010,2023-03-27T19:34,-7440,29760
128,2184463,39,389000,0,98.0,369,2023-03-27T19:34,0,389000
129,1139192,40,71100,94900,97.0,14274,2023-03-27T19:34,-7110,63990
130,2322836,41,139200,174000,97.0,960,2023-03-27T19:34,0,139200
131,2102252,42,69900,129000,94.0,6209,2023-03-27T19:34,-3495,66405
132,2496650,43,43900,109000,96.0,694,2023-03-27T19:34,0,43900
133,2288704,44,105600,132000,97.0,3165,2023-03-27T19:34,-12100,93500
134,3010527,45,237150,279000,97.0,147,2023-03-27T19:34,0,237150
135,1337096,46,69900,0,96.0,2828,2023-03-27T19:34,-6990,62910
136,3029811,47,63200,79000,98.0,182,2023-03-27T19:34,-6320,56880
137,1737051,48,62300,89000,96.0,5029,2023-03-27T19:34,0,62300
138,2683549,49,126650,149000,97.0,2490,2023-03-27T19:34,0,126650
139,1593755,50,89360,111700,97.0,14365,2023-03-27T19:34,-17872,71488
140,2742656,51,1445000,0,0.0,0,2023-03-27T19:34,-30000,1415000
141,2715055,52,159000,189000,97.0,1925,2023-03-27T19:34,-31800,127200
142,2293391,53,98000,124000,95.0,1739,2023-03-27T19:34,-4900,93100
143,3033224,54,59900,74000,96.0,485,2023-03-27T19:34,-5990,53910
144,2086731,55,95000,129000,97.0,2137,2023-03-27T19:34,0,95000
145,3047185,56,109650,129000,90.0,8,2023-03-27T19:34,0,109650
146,2159724,57,29900,32000,95.0,2123,2023-03-27T19:34,0,29900
147,3056018,58,62300,89000,97.0,263,2023-03-27T19:34,0,62300
148,3039957,59,71910,79900,99.0,90,2023-03-27T19:34,0,71910
149,1751722,60,53910,59900,97.0,3278,2023-03-27T19:34,-5391,48519
150,2718413,61,126650,149000,97.0,1348,2023-03-27T19:34,0,126650
151,3139167,62,74000,95000,0.0,0,2023-03-27T19:34,-7400,66600
152,3141923,63,242100,269000,0.0,0,2023-03-27T19:34,0,242100
153,3036129,64,79800,94000,95.0,1555,2023-03-27T19:34,-3990,75810
154,3042244,65,159200,199000,96.0,45,2023-03-27T19:34,-31840,127360
155,1731130,66,143200,179000,95.0,1735,2023-03-27T19:34,-28640,114560
156,2701889,67,58200,97000,95.0,4080,2023-03-27T19:34,0,58200
157,3141918,68,157500,175000,0.0,0,2023-03-27T19:34,0,157500
158,2381781,69,211650,249000,98.0,816,2023-03-27T19:34,0,211650
159,3071109,70,140600,148000,90.0,28,2023-03-27T19:34,-28120,112480
160,3046035,71,125100,139000,97.0,56,2023-03-27T19:34,0,125100
161,1969617,72,162000,0,96.0,2635,2023-03-27T19:34,0,162000
162,2322838,73,139200,174000,97.0,317,2023-03-27T19:34,0,139200
163,3039465,74,69000,74800,97.0,89,2023-03-27T19:34,-10350,58650
164,3092695,75,179000,0,100.0,15,2023-03-27T19:34,0,179000
165,2329532,76,119200,149000,97.0,3884,2023-03-27T19:34,0,119200
166,2668986,77,35910,39900,96.0,3334,2023-03-27T19:34,-3591,32319
167,1817381,78,47900,69000,96.0,921,2023-03-27T19:34,0,47900
168,2357957,79,126650,149000,97.0,2096,2023-03-27T19:34,0,126650
169,2699160,80,179000,0,96.0,79,2023-03-27T19:34,0,179000
170,709189,81,156700,209000,96.0,7352,2023-03-27T19:34,0,156700
171,2102243,82,69900,129000,96.0,2789,2023-03-27T19:34,-3495,66405
172,2288426,83,79000,109000,94.0,772,2023-03-27T19:34,0,79000
173,3037473,84,69900,85900,97.0,122,2023-03-27T19:34,0,69900
174,3100493,85,139000,0,98.0,10,2023-03-27T19:34,0,139000
175,2122596,86,39800,57000,96.0,2577,2023-03-27T19:34,0,39800
176,2375909,87,76290,89900,97.0,1462,2023-03-27T19:34,0,76290
177,3054935,88,89900,0,0.0,0,2023-03-27T19:34,0,89900
178,2352895,89,69520,86900,97.0,3451,2023-03-27T19:34,-13904,55616
179,2704962,90,59400,99000,97.0,8317,2023-03-27T19:34,-5940,53460
180,1551840,1,39000,0,97.0,82743,2023-03-27T19:34,-3900,35100
181,750908,2,35900,54000,96.0,83387,2023-03-27T19:34,0,35900
182,2112059,3,33900,52000,97.0,42076,2023-03-27T19:34,0,33900
183,1149329,4,39900,0,96.0,85268,2023-03-27T19:34,-3990,35910
184,2060719,5,47800,69000,96.0,4809,2023-03-27T19:34,-2390,45410
185,2092852,6,42000,52800,96.0,10749,2023-03-27T19:34,-2100,39900
186,1168906,7,41900,0,97.0,70458,2023-03-27T19:34,-4190,37710
187,1149328,8,39900,0,96.0,94153,2023-03-27T19:34,-3990,35910
188,858911,9,44100,49000,95.0,66525,2023-03-27T19:34,0,44100
189,1568057,10,43400,62000,96.0,21900,2023-03-27T19:34,0,43400
190,2112061,11,36400,52000,97.0,14240,2023-03-27T19:34,-3640,32760
191,1552753,12,62400,78000,97.0,27941,2023-03-27T19:34,-6240,56160
192,2028327,13,49900,0,97.0,8744,2023-03-27T19:34,-4990,44910
193,2184087,14,49000,89000,96.0,3944,2023-03-27T19:34,0,49000
194,1551839,15,39000,0,97.0,23032,2023-03-27T19:34,-3900,35100
195,2060717,16,47800,69000,95.0,3589,2023-03-27T19:34,0,47800
196,1555407,17,62400,78000,97.0,11349,2023-03-27T19:34,-6240,56160
197,1370101,18,39000,89000,96.0,22424,2023-03-27T19:34,0,39000
198,2028326,19,49900,0,97.0,5927,2023-03-27T19:34,-4990,44910
199,3091296,20,129000,0,93.0,3,2023-03-27T19:34,0,129000
200,2060720,21,55200,69000,95.0,2430,2023-03-27T19:34,-2760,52440
201,890338,22,44100,49000,95.0,47442,2023-03-27T19:34,0,44100
202,2107115,23,121500,135000,98.0,11588,2023-03-27T19:34,0,121500
203,3163314,24,63700,98000,96.0,103,2023-03-27T19:34,-6370,57330
204,1573215,25,133200,148000,98.0,9176,2023-03-27T19:34,0,133200
205,1736085,26,39900,59800,96.0,36130,2023-03-27T19:34,0,39900
206,396185,27,109000,0,95.0,8670,2023-03-27T19:34,-21800,87200
207,2060759,28,59800,74800,97.0,7030,2023-03-27T19:34,-8970,50830
208,1539028,29,61900,89000,95.0,4672,2023-03-27T19:34,0,61900
209,1568032,30,43400,62000,96.0,5965,2023-03-27T19:34,0,43400
210,890521,31,39800,63000,94.0,10877,2023-03-27T19:34,0,39800
211,3011537,32,44910,49900,97.0,205,2023-03-27T19:34,-4491,40419
212,2351467,33,39800,54000,96.0,5858,2023-03-27T19:34,-3980,35820
213,1222184,34,41900,0,97.0,48064,2023-03-27T19:34,-4190,37710
214,2092849,35,42000,52800,96.0,9597,2023-03-27T19:34,-2100,39900
215,2706287,36,39800,54000,95.0,3490,2023-03-27T19:34,-3980,35820
216,2358429,37,159000,0,98.0,2546,2023-03-27T19:34,0,159000
217,2723714,38,52000,58000,96.0,1358,2023-03-27T19:34,0,52000
218,2060743,39,33000,55000,95.0,3404,2023-03-27T19:34,0,33000
219,1477272,40,44200,68000,96.0,17601,2023-03-27T19:34,0,44200
220,1323090,41,73600,92000,96.0,5886,2023-03-27T19:34,-7360,66240
221,2131950,42,44100,49000,97.0,3578,2023-03-27T19:34,0,44100
222,732703,43,116100,129000,97.0,3888,2023-03-27T19:34,0,116100
223,3163311,44,63700,98000,97.0,47,2023-03-27T19:34,-6370,57330
224,3098372,45,109000,139000,97.0,684,2023-03-27T19:34,-21800,87200
225,1627892,46,43900,0,97.0,10264,2023-03-27T19:34,0,43900
226,2069525,47,41900,0,96.0,3629,2023-03-27T19:34,-4190,37710
227,1666442,48,49900,0,97.0,10791,2023-03-27T19:34,0,49900
228,2049103,49,62400,78000,97.0,7026,2023-03-27T19:34,-6240,56160
229,2789111,50,84150,99000,97.0,723,2023-03-27T19:34,-4208,79942
230,3059333,51,39800,54000,95.0,104,2023-03-27T19:34,-3980,35820
231,2569078,52,79000,0,96.0,2359,2023-03-27T19:34,0,79000
232,2709031,53,42000,52800,96.0,3389,2023-03-27T19:34,-2100,39900
233,2789091,54,84150,99000,96.0,618,2023-03-27T19:34,-4208,79942
234,1926048,55,32000,0,97.0,14510,2023-03-27T19:34,-3200,28800
235,2310310,56,116100,129000,98.0,888,2023-03-27T19:34,0,116100
236,2749153,57,66600,74000,97.0,502,2023-03-27T19:34,0,66600
237,1246215,58,52000,65000,96.0,6238,2023-03-27T19:34,0,52000
238,1212776,59,28690,31900,96.0,23053,2023-03-27T19:34,0,28690
239,2028329,60,49900,0,96.0,6362,2023-03-27T19:34,-4990,44910
240,1595607,61,57900,89000,97.0,5596,2023-03-27T19:34,-5790,52110
241,2319844,62,85600,107000,98.0,3763,2023-03-27T19:34,0,85600
242,3049798,63,96800,121000,96.0,36,2023-03-27T19:34,0,96800
243,2980254,64,44910,49900,97.0,122,2023-03-27T19:34,-4491,40419
244,2150457,65,119250,159000,97.0,3677,2023-03-27T19:34,0,119250
245,2744549,66,43400,62000,97.0,4837,2023-03-27T19:34,0,43400
246,2562527,67,29400,42000,97.0,3852,2023-03-27T19:34,-4410,24990
247,1924274,68,49900,66000,95.0,22364,2023-03-27T19:34,-4990,44910
248,1168922,69,43900,0,96.0,18013,2023-03-27T19:34,-4390,39510
249,2297033,70,119200,149000,97.0,1788,2023-03-27T19:34,-23840,95360
250,3043508,71,75650,89000,98.0,63,2023-03-27T19:34,-3783,71867
251,1854665,72,139000,0,97.0,1022,2023-03-27T19:34,0,139000
252,2032901,73,39900,0,97.0,6641,2023-03-27T19:34,-3990,35910
253,1885479,74,44100,49000,96.0,5379,2023-03-27T19:34,0,44100
254,2723206,75,59900,89000,95.0,378,2023-03-27T19:34,-8985,50915
255,2392464,76,27090,33900,94.0,3628,2023-03-27T19:34,0,27090
256,3022892,77,44100,49000,96.0,285,2023-03-27T19:34,0,44100
257,2578996,78,39900,59000,95.0,4561,2023-03-27T19:34,-5985,33915
258,2929838,79,69550,107000,96.0,314,2023-03-27T19:34,0,69550
259,1960424,80,49500,59000,95.0,1079,2023-03-27T19:34,0,49500
260,1885631,81,44100,49000,96.0,23621,2023-03-27T19:34,0,44100
261,241111,82,69000,0,96.0,10494,2023-03-27T19:34,-13800,55200
262,3118937,83,80100,89000,100.0,2,2023-03-27T19:34,0,80100
263,1324127,84,33900,0,96.0,13636,2023-03-27T19:34,0,33900
264,2261213,85,121500,135000,98.0,4033,2023-03-27T19:34,0,121500
265,3141395,86,49900,73900,97.0,53,2023-03-27T19:34,-4990,44910
266,1212777,87,27090,31900,96.0,21490,2023-03-27T19:34,0,27090
267,1224095,88,35890,39900,97.0,24201,2023-03-27T19:34,-3589,32301
268,2737165,89,59800,79000,96.0,2514,2023-03-27T19:34,-8970,50830
269,2503133,90,35800,52800,96.0,3033,2023-03-27T19:34,0,35800
270,1789507,1,79000,0,98.0,25554,2023-03-27T19:34,0,79000
271,1969507,2,88000,0,98.0,5244,2023-03-27T19:34,0,88000
272,1034480,3,135000,150000,97.0,17876,2023-03-27T19:34,0,135000
273,3038000,4,66400,83000,97.0,253,2023-03-27T19:34,-9960,56440
274,2344540,5,96000,0,98.0,9055,2023-03-27T19:34,0,96000
275,2558648,6,119000,0,98.0,1204,2023-03-27T19:34,0,119000
276,2789785,7,140600,148000,97.0,547,2023-03-27T19:34,0,140600
277,1264107,8,65000,90000,97.0,6217,2023-03-27T19:34,0,65000
278,1564343,9,92800,119000,98.0,8044,2023-03-27T19:34,-6496,86304
279,1969488,10,88000,0,98.0,1681,2023-03-27T19:34,0,88000
280,2271789,11,71100,79000,97.0,2440,2023-03-27T19:34,0,71100
281,1842449,12,84000,99000,97.0,5285,2023-03-27T19:34,0,84000
282,2344538,13,119000,0,98.0,6228,2023-03-27T19:34,0,119000
283,1835080,14,98000,0,97.0,2671,2023-03-27T19:34,0,98000
284,3034751,15,61200,72000,97.0,322,2023-03-27T19:34,0,61200
285,2320927,16,39000,51000,97.0,1995,2023-03-27T19:34,0,39000
286,1744101,17,103500,109000,98.0,2812,2023-03-27T19:34,0,103500
287,2657250,18,125400,149000,98.0,93,2023-03-27T19:34,0,125400
288,3024801,19,138000,0,100.0,13,2023-03-27T19:34,0,138000
289,2698604,20,1550000,0,100.0,1,2023-03-27T19:34,-30000,1520000
290,2066837,21,79000,119000,97.0,6340,2023-03-27T19:34,-7900,71100
291,342189,22,39500,52000,95.0,15622,2023-03-27T19:34,0,39500
292,2577899,23,138000,0,98.0,284,2023-03-27T19:34,0,138000
293,2514819,24,59000,66000,97.0,754,2023-03-27T19:34,0,59000
294,2637722,25,380000,0,100.0,8,2023-03-27T19:34,-30000,350000
295,3034749,26,61200,72000,97.0,340,2023-03-27T19:34,0,61200
296,2998775,27,142200,158000,96.0,429,2023-03-27T19:34,-28440,113760
297,2859226,28,2750000,3980000,0.0,0,2023-03-27T19:34,-30000,2720000
298,1581689,29,75600,89000,97.0,3910,2023-03-27T19:34,0,75600
299,2343665,30,89000,0,97.0,4466,2023-03-27T19:34,0,89000
300,913402,31,83000,98000,95.0,7996,2023-03-27T19:34,0,83000
301,2890575,32,118000,0,95.0,116,2023-03-27T19:34,0,118000
302,2688604,33,159000,0,97.0,805,2023-03-27T19:34,0,159000
303,3017823,34,2365500,3500000,0.0,0,2023-03-27T19:34,-30000,2335500
304,693318,35,79000,110000,96.0,13099,2023-03-27T19:34,0,79000
305,2789786,36,150100,158000,97.0,209,2023-03-27T19:34,0,150100
306,3037524,37,79200,88000,96.0,12,2023-03-27T19:34,0,79200
307,2637702,38,2359000,0,90.0,2,2023-03-27T19:34,-30000,2329000
308,2584181,39,57600,72000,98.0,773,2023-03-27T19:34,0,57600
309,2615405,40,219000,0,97.0,221,2023-03-27T19:34,0,219000
310,2967326,41,2172000,2750000,0.0,0,2023-03-27T19:34,-30000,2142000
311,2954959,42,95000,0,95.0,174,2023-03-27T19:34,0,95000
312,1528287,43,46500,49000,96.0,4501,2023-03-27T19:34,0,46500
313,3050557,44,2027000,3290000,0.0,0,2023-03-27T19:34,-30000,1997000
314,2754080,45,88000,0,97.0,451,2023-03-27T19:34,0,88000
315,2760920,46,80100,89000,97.0,202,2023-03-27T19:34,-16020,64080
316,1910358,47,99000,0,98.0,2431,2023-03-27T19:34,0,99000
317,1576725,48,137000,197000,97.0,5211,2023-03-27T19:34,0,137000
318,2849886,49,1880000,2430000,93.0,6,2023-03-27T19:34,-30000,1850000
319,3050558,50,2089000,3290000,0.0,0,2023-03-27T19:34,-30000,2059000
320,2458214,51,1879000,3395000,100.0,11,2023-03-27T19:34,-30000,1849000
321,2273014,52,1791000,2390000,100.0,1,2023-03-27T19:34,-30000,1761000
322,1758217,53,43900,56000,97.0,13042,2023-03-27T19:34,-2195,41705
323,3056918,54,280000,0,97.0,7,2023-03-27T19:34,0,280000
324,3045584,55,130500,145000,97.0,3744,2023-03-27T19:34,-13050,117450
325,2123839,56,74610,82900,97.0,1269,2023-03-27T19:34,0,74610
326,2770504,57,138000,0,95.0,127,2023-03-27T19:34,0,138000
327,2702033,58,127200,159000,97.0,372,2023-03-27T19:34,0,127200
328,2422175,59,137700,162000,98.0,185,2023-03-27T19:34,0,137700
329,1263004,60,159000,0,97.0,5230,2023-03-27T19:34,0,159000
330,2777545,61,130000,0,96.0,165,2023-03-27T19:34,0,130000
331,2743470,62,1550000,0,100.0,1,2023-03-27T19:34,-30000,1520000
332,2112494,63,105000,0,95.0,95,2023-03-27T19:34,0,105000
333,1320752,64,69800,135000,97.0,4693,2023-03-27T19:34,0,69800
334,1456515,65,49500,55000,97.0,8664,2023-03-27T19:34,0,49500
335,1745100,66,103500,109000,97.0,971,2023-03-27T19:34,0,103500
336,1447194,67,64900,230000,96.0,2769,2023-03-27T19:34,0,64900
337,938746,68,80100,89000,95.0,12479,2023-03-27T19:34,0,80100
338,2245910,69,46000,69000,95.0,689,2023-03-27T19:34,0,46000
339,3082387,70,139000,0,98.0,97,2023-03-27T19:34,0,139000
340,1534526,71,52200,55000,97.0,2373,2023-03-27T19:34,0,52200
341,1216585,72,32000,59000,95.0,13844,2023-03-27T19:34,0,32000
342,3029922,73,295000,0,97.0,77,2023-03-27T19:34,0,295000
343,2993947,74,100000,0,96.0,129,2023-03-27T19:34,0,100000
344,2630526,75,100000,0,96.0,586,2023-03-27T19:34,0,100000
345,2743468,76,1410000,0,0.0,0,2023-03-27T19:34,-30000,1380000
346,693525,77,46800,65000,96.0,3933,2023-03-27T19:34,0,46800
347,2789787,78,140600,148000,96.0,310,2023-03-27T19:34,0,140600
348,3045081,79,58800,84000,95.0,199,2023-03-27T19:34,0,58800
349,2131979,80,132050,139000,97.0,362,2023-03-27T19:34,-6603,125447
350,2395671,81,98000,0,97.0,909,2023-03-27T19:34,0,98000
351,3061872,82,80100,89000,92.0,22,2023-03-27T19:34,0,80100
352,3061969,83,80100,89000,93.0,9,2023-03-27T19:34,0,80100
353,2679537,84,162000,0,95.0,88,2023-03-27T19:34,0,162000
354,1256451,85,49700,89000,97.0,4248,2023-03-27T19:34,0,49700
355,3111136,86,129600,144000,100.0,22,2023-03-27T19:34,0,129600
356,2820554,87,583000,0,0.0,0,2023-03-27T19:34,-30000,553000
357,1597319,88,89100,99000,97.0,547,2023-03-27T19:34,-8910,80190
358,2392115,89,78400,98000,96.0,329,2023-03-27T19:34,0,78400
359,3028885,90,143100,159000,95.0,12,2023-03-27T19:34,0,143100
360,2705117,1,654000,0,0.0,0,2023-03-27T19:34,-30000,624000
361,2705116,2,654000,0,93.0,3,2023-03-27T19:34,-30000,624000
362,577636,3,99900,139000,95.0,30977,2023-03-27T19:34,0,99900
363,2638067,4,99000,139000,97.0,2864,2023-03-27T19:34,0,99000
364,969541,5,69000,0,97.0,29063,2023-03-27T19:34,0,69000
365,2293400,6,129000,0,96.0,860,2023-03-27T19:34,0,129000
366,810034,7,85500,95000,97.0,45023,2023-03-27T19:34,0,85500
367,1622068,8,119000,0,97.0,6394,2023-03-27T19:34,0,119000
368,2673444,9,89900,149000,95.0,158,2023-03-27T19:34,0,89900
369,1762406,10,260000,0,98.0,3210,2023-03-27T19:34,0,260000
370,311052,11,53100,59000,97.0,40973,2023-03-27T19:34,0,53100
371,3091287,12,119000,0,98.0,199,2023-03-27T19:34,0,119000
372,2675279,13,41300,59000,96.0,53,2023-03-27T19:34,-8260,33040
373,1955217,14,69000,109000,96.0,5096,2023-03-27T19:34,-13800,55200
374,1955210,15,69000,109000,95.0,1470,2023-03-27T19:34,-13800,55200
375,2622254,16,109000,0,98.0,830,2023-03-27T19:34,0,109000
376,2320478,17,129000,0,97.0,439,2023-03-27T19:34,0,129000
377,1762407,18,260000,0,97.0,3023,2023-03-27T19:34,0,260000
378,2859857,19,62900,79000,96.0,184,2023-03-27T19:34,0,62900
379,186610,20,75900,85000,97.0,16422,2023-03-27T19:34,0,75900
380,2889745,21,1034000,0,0.0,0,2023-03-27T19:34,-30000,1004000
381,2859859,22,62900,79000,94.0,124,2023-03-27T19:34,0,62900
382,2861393,23,109900,139000,93.0,258,2023-03-27T19:34,0,109900
383,810032,24,85500,95000,97.0,13682,2023-03-27T19:34,0,85500
384,181907,25,89900,119000,97.0,7010,2023-03-27T19:34,0,89900
385,3030422,26,139000,0,96.0,754,2023-03-27T19:34,0,139000
386,2733049,27,79900,119000,96.0,451,2023-03-27T19:34,0,79900
387,2741233,28,109000,0,97.0,2590,2023-03-27T19:34,0,109000
388,695334,29,78900,99000,96.0,9150,2023-03-27T19:34,0,78900
389,810033,30,89100,99000,97.0,34161,2023-03-27T19:34,0,89100
390,1017974,31,71100,79000,95.0,2911,2023-03-27T19:34,0,71100
391,2970198,32,89000,0,97.0,179,2023-03-27T19:34,0,89000
392,2778805,33,99000,0,97.0,894,2023-03-27T19:34,0,99000
393,3033248,34,109000,0,97.0,558,2023-03-27T19:34,0,109000
394,3096431,35,139000,0,98.0,19,2023-03-27T19:34,0,139000
395,102620,36,69000,0,97.0,17701,2023-03-27T19:34,0,69000
396,816033,37,70900,89000,96.0,13151,2023-03-27T19:34,0,70900
397,2161992,38,69900,95000,98.0,3126,2023-03-27T19:34,0,69900
398,1354129,39,67000,99000,95.0,8640,2023-03-27T19:34,-13400,53600
399,1900410,40,129000,0,97.0,4826,2023-03-27T19:34,0,129000
400,1792640,41,99000,0,98.0,3395,2023-03-27T19:34,0,99000
401,2268512,42,109000,0,97.0,397,2023-03-27T19:34,0,109000
402,2383963,43,139000,0,96.0,127,2023-03-27T19:34,0,139000
403,2764372,44,125000,0,97.0,323,2023-03-27T19:34,0,125000
404,2233180,45,75900,109000,97.0,14065,2023-03-27T19:34,0,75900
405,1493265,46,85500,95000,98.0,4837,2023-03-27T19:34,0,85500
406,1608813,47,75000,0,97.0,912,2023-03-27T19:34,0,75000
407,2577087,48,89900,139000,97.0,341,2023-03-27T19:34,0,89900
408,1594351,49,85000,0,96.0,4017,2023-03-27T19:34,0,85000
409,1686571,50,59900,129000,97.0,5309,2023-03-27T19:34,0,59900
410,3081253,51,112900,129000,95.0,70,2023-03-27T19:34,0,112900
411,3071174,52,107000,164000,100.0,17,2023-03-27T19:34,-21400,85600
412,2818756,53,1030000,0,100.0,1,2023-03-27T19:34,-30000,1000000
413,3005191,54,169000,0,96.0,146,2023-03-27T19:34,-8450,160550
414,2493214,55,169000,0,98.0,154,2023-03-27T19:34,0,169000
415,2996167,56,109900,139000,98.0,130,2023-03-27T19:34,0,109900
416,1130307,57,109000,0,97.0,6023,2023-03-27T19:34,0,109000
417,1744960,58,119900,149000,97.0,8185,2023-03-27T19:34,0,119900
418,2992063,59,280000,0,98.0,2086,2023-03-27T19:34,0,280000
419,2861395,60,109900,139000,96.0,480,2023-03-27T19:34,0,109900
420,1296778,61,99000,0,98.0,2028,2023-03-27T19:34,0,99000
421,1494180,62,71100,79000,95.0,5194,2023-03-27T19:34,0,71100
422,1017973,63,71100,79000,95.0,1173,2023-03-27T19:34,0,71100
423,1608838,64,85000,0,97.0,12557,2023-03-27T19:34,0,85000
424,2229208,65,109000,0,97.0,1586,2023-03-27T19:34,0,109000
425,2355071,66,265000,0,97.0,476,2023-03-27T19:34,0,265000
426,1729744,67,76500,85000,97.0,3302,2023-03-27T19:34,0,76500
427,957758,68,89000,0,97.0,4330,2023-03-27T19:34,0,89000
428,3100522,69,129000,0,98.0,132,2023-03-27T19:34,0,129000
429,490136,70,76000,95000,98.0,2001,2023-03-27T19:34,0,76000
430,1353454,71,67000,99000,95.0,4407,2023-03-27T19:34,-13400,53600
431,1473136,72,119900,149000,97.0,10742,2023-03-27T19:34,0,119900
432,2631192,73,98100,109000,98.0,326,2023-03-27T19:34,0,98100
433,490135,74,75900,95000,97.0,3109,2023-03-27T19:34,0,75900
434,104240,75,69000,0,96.0,3832,2023-03-27T19:34,0,69000
435,311051,76,58500,65000,97.0,19491,2023-03-27T19:34,0,58500
436,1817778,77,69000,0,97.0,4061,2023-03-27T19:34,0,69000
437,1478592,78,75900,95000,97.0,2891,2023-03-27T19:34,0,75900
438,3136271,79,89100,99000,0.0,0,2023-03-27T19:34,0,89100
439,2440110,80,53910,59900,97.0,822,2023-03-27T19:34,-4010,49900
440,1492897,81,75000,0,96.0,3014,2023-03-27T19:34,0,75000
441,311050,82,53100,59000,97.0,8964,2023-03-27T19:34,0,53100
442,1635193,83,59390,69900,96.0,3626,2023-03-27T19:34,-5939,53451
443,1493263,84,89100,99000,98.0,4147,2023-03-27T19:34,0,89100
444,2377493,85,48300,69000,95.0,13,2023-03-27T19:34,-9660,38640
445,2233178,86,75900,109000,97.0,4878,2023-03-27T19:34,0,75900
446,2662649,87,485000,790000,98.0,188,2023-03-27T19:34,-30000,455000
447,3023097,88,230000,0,98.0,79,2023-03-27T19:34,0,230000
448,1256468,89,109000,0,97.0,3541,2023-03-27T19:34,0,109000
449,1296776,90,99000,0,98.0,2912,2023-03-27T19:34,0,99000
450,3156676,1,259000,299000,0.0,0,2023-03-27T19:34,-12950,246050
451,1092992,2,69000,0,97.0,37580,2023-03-27T19:34,0,69000
452,2664372,3,65000,0,97.0,952,2023-03-27T19:34,0,65000
453,2069832,4,199900,332000,95.0,744,2023-03-27T19:34,-9995,189905
454,2432733,5,44900,59000,97.0,2629,2023-03-27T19:34,0,44900
455,1730340,6,258000,0,97.0,4104,2023-03-27T19:34,0,258000
456,595040,7,210000,0,95.0,8694,2023-03-27T19:34,0,210000
457,1890398,8,132000,168000,96.0,2672,2023-03-27T19:34,0,132000
458,2664373,9,65000,0,97.0,915,2023-03-27T19:34,0,65000
459,1568047,10,143100,159000,95.0,11967,2023-03-27T19:34,0,143100
460,2430426,11,169000,0,98.0,696,2023-03-27T19:34,0,169000
461,1339622,12,42900,59000,97.0,16106,2023-03-27T19:34,0,42900
462,2433538,13,86700,102000,96.0,2306,2023-03-27T19:34,0,86700
463,2091749,14,75650,89000,95.0,6147,2023-03-27T19:34,0,75650
464,2624538,15,40900,59000,97.0,1310,2023-03-27T19:34,0,40900
465,3024585,16,59000,0,97.0,74,2023-03-27T19:34,-11800,47200
466,1087674,17,83700,93000,95.0,1745,2023-03-27T19:34,0,83700
467,1699941,18,67150,79000,97.0,4743,2023-03-27T19:34,-3358,63792
468,3062046,19,78300,87000,96.0,56,2023-03-27T19:34,-3915,74385
469,2803698,20,24900,49000,95.0,170,2023-03-27T19:34,0,24900
470,595039,21,210000,0,97.0,3471,2023-03-27T19:34,0,210000
471,2816812,22,119900,0,92.0,1496,2023-03-27T19:34,0,119900
472,2101924,23,99900,0,96.0,1332,2023-03-27T19:34,-9990,89910
473,1562990,24,230000,0,96.0,1271,2023-03-27T19:34,0,230000
474,3061996,25,88200,98000,98.0,44,2023-03-27T19:34,-4410,83790
475,2143833,26,91800,108000,96.0,2364,2023-03-27T19:34,0,91800
476,2210201,27,259000,299000,94.0,191,2023-03-27T19:34,-12950,246050
477,2599641,28,67830,119000,96.0,1964,2023-03-27T19:34,-3392,64438
478,2419871,29,44900,59000,97.0,856,2023-03-27T19:34,0,44900
479,1730341,30,258000,0,97.0,410,2023-03-27T19:34,0,258000
480,2305529,31,132000,168000,98.0,73,2023-03-27T19:34,0,132000
481,2093156,32,259000,0,89.0,21,2023-03-27T19:34,0,259000
482,685185,33,139000,198000,95.0,12463,2023-03-27T19:34,0,139000
483,3124961,34,62100,69000,92.0,14,2023-03-27T19:34,-3105,58995
484,2816816,35,159900,0,97.0,1806,2023-03-27T19:34,0,159900
485,1815709,36,132000,168000,96.0,7101,2023-03-27T19:34,0,132000
486,2217183,37,167000,239000,0.0,0,2023-03-27T19:34,-33400,133600
487,3075621,38,339000,0,98.0,54,2023-03-27T19:34,0,339000
488,2784025,39,1389000,0,0.0,0,2023-03-27T19:34,-30000,1359000
489,2589483,40,65000,0,97.0,1245,2023-03-27T19:34,0,65000
490,2972872,41,65000,0,97.0,287,2023-03-27T19:34,0,65000
491,1439535,42,49000,0,96.0,16278,2023-03-27T19:34,0,49000
492,2518112,43,89250,105000,96.0,914,2023-03-27T19:34,0,89250
493,665782,44,260000,0,95.0,3632,2023-03-27T19:34,0,260000
494,2683782,45,44900,79000,94.0,23,2023-03-27T19:34,0,44900
495,785345,46,210000,0,97.0,175,2023-03-27T19:34,0,210000
496,3049313,47,57100,64900,97.0,391,2023-03-27T19:34,0,57100
497,2452100,48,59000,0,96.0,261,2023-03-27T19:34,0,59000
498,1334440,49,100000,170000,96.0,2043,2023-03-27T19:34,0,100000
499,1129750,50,69000,0,97.0,3857,2023-03-27T19:34,0,69000
500,2378989,51,159000,0,93.0,19,2023-03-27T19:34,0,159000
501,1262092,52,250000,0,96.0,764,2023-03-27T19:34,0,250000
502,2750309,53,44900,59000,98.0,367,2023-03-27T19:34,0,44900
503,2621831,54,64000,85000,95.0,684,2023-03-27T19:34,0,64000
504,2356342,55,103890,129900,94.0,443,2023-03-27T19:34,0,103890
505,1128656,56,86800,99000,95.0,21556,2023-03-27T19:34,0,86800
506,1438359,57,98000,0,97.0,1154,2023-03-27T19:34,0,98000
507,2858618,58,520000,685000,91.0,12,2023-03-27T19:34,-30000,490000
508,3084458,59,138000,197000,90.0,6,2023-03-27T19:34,-13800,124200
509,1262089,60,300000,0,97.0,1578,2023-03-27T19:34,0,300000
510,1021359,61,76000,100000,94.0,5369,2023-03-27T19:34,0,76000
511,2979844,62,976000,1090000,0.0,0,2023-03-27T19:34,-30000,946000
512,2785256,63,57850,89000,94.0,34,2023-03-27T19:34,-2893,54957
513,2910082,64,265500,295000,98.0,424,2023-03-27T19:34,0,265500
514,2910086,65,265500,295000,98.0,171,2023-03-27T19:34,0,265500
515,1439527,66,49000,0,95.0,13417,2023-03-27T19:34,0,49000
516,2640227,67,144000,265000,97.0,41,2023-03-27T19:34,0,144000
517,2735953,68,207000,230000,99.0,384,2023-03-27T19:34,0,207000
518,2790484,69,29900,49000,94.0,641,2023-03-27T19:34,0,29900
519,451851,70,268000,0,97.0,1940,2023-03-27T19:34,0,268000
520,1973858,71,143200,179000,98.0,1160,2023-03-27T19:34,0,143200
521,1754219,72,31200,39000,96.0,2222,2023-03-27T19:34,0,31200
522,2737420,73,87550,103000,95.0,457,2023-03-27T19:34,0,87550
523,2330198,74,59000,0,97.0,389,2023-03-27T19:34,0,59000
524,2742641,75,871800,1443000,0.0,0,2023-03-27T19:34,-30000,841800
525,2210246,76,259000,299000,97.0,84,2023-03-27T19:34,-12950,246050
526,2901233,77,438000,568000,0.0,0,2023-03-27T19:34,-30000,408000
527,2305523,78,139000,198000,96.0,65,2023-03-27T19:34,0,139000
528,2383245,79,99000,0,98.0,789,2023-03-27T19:34,0,99000
529,3103381,80,65000,0,95.0,34,2023-03-27T19:34,0,65000
530,2435822,81,99000,0,97.0,188,2023-03-27T19:34,0,99000
531,2555608,82,259000,299000,93.0,24,2023-03-27T19:34,-12950,246050
532,3062069,83,71100,79000,97.0,19,2023-03-27T19:34,-3555,67545
533,668697,84,66400,73800,94.0,8428,2023-03-27T19:34,0,66400
534,1296051,85,78300,87000,94.0,3443,2023-03-27T19:34,0,78300
535,2889427,86,730000,1190000,97.0,7,2023-03-27T19:34,-30000,700000
536,1990295,87,158400,176000,93.0,149,2023-03-27T19:34,0,158400
537,3045271,88,82000,0,94.0,17,2023-03-27T19:34,0,82000
538,2752886,89,69000,99000,96.0,588,2023-03-27T19:34,-13800,55200
539,2091779,90,75600,89000,97.0,976,2023-03-27T19:34,0,75600
540,2286829,1,37000,0,95.0,4757,2023-03-27T19:34,0,37000
541,2287158,2,37000,0,95.0,1129,2023-03-27T19:34,0,37000
542,2879419,3,46900,55000,98.0,594,2023-03-27T19:34,0,46900
543,2280117,4,35100,39000,97.0,6072,2023-03-27T19:34,0,35100
544,1214164,5,36000,0,96.0,24787,2023-03-27T19:34,0,36000
545,1771137,6,26100,29000,97.0,12341,2023-03-27T19:34,0,26100
546,1214109,7,36000,0,97.0,8012,2023-03-27T19:34,0,36000
547,2134140,8,39000,0,97.0,3436,2023-03-27T19:34,0,39000
548,1822717,9,56050,59000,97.0,4246,2023-03-27T19:34,-2803,53247
549,1272626,10,36000,0,96.0,14032,2023-03-27T19:34,0,36000
550,2286799,11,37000,0,95.0,770,2023-03-27T19:34,0,37000
551,1214174,12,36000,0,97.0,14940,2023-03-27T19:34,0,36000
552,1022014,13,79000,0,96.0,11395,2023-03-27T19:34,0,79000
553,1022013,14,79000,0,96.0,6231,2023-03-27T19:34,0,79000
554,2879425,15,46900,55000,97.0,221,2023-03-27T19:34,0,46900
555,2134158,16,39000,0,97.0,2446,2023-03-27T19:34,0,39000
556,2028240,17,39000,0,98.0,3319,2023-03-27T19:34,0,39000
557,2356713,18,39000,0,97.0,1415,2023-03-27T19:34,0,39000
558,3012243,19,27900,39900,98.0,43,2023-03-27T19:34,0,27900
559,1907733,20,29900,39000,96.0,3770,2023-03-27T19:34,0,29900
560,1498091,21,79000,0,97.0,62,2023-03-27T19:34,0,79000
561,2123132,22,39000,0,97.0,6332,2023-03-27T19:34,0,39000
562,1214317,23,36000,0,97.0,11422,2023-03-27T19:34,0,36000
563,2329375,24,34710,39000,97.0,2043,2023-03-27T19:34,0,34710
564,2356711,25,39000,0,97.0,1438,2023-03-27T19:34,0,39000
565,1214173,26,36000,0,96.0,5506,2023-03-27T19:34,0,36000
566,1771132,27,26100,29000,96.0,5169,2023-03-27T19:34,0,26100
567,2287312,28,37000,0,95.0,205,2023-03-27T19:34,0,37000
568,1855444,29,37800,42000,97.0,2962,2023-03-27T19:34,0,37800
569,2707659,30,42000,0,97.0,485,2023-03-27T19:34,0,42000
570,1925814,31,35100,39000,96.0,1624,2023-03-27T19:34,0,35100
571,1214169,32,36000,0,97.0,5290,2023-03-27T19:34,0,36000
572,1452917,33,69000,0,96.0,2400,2023-03-27T19:34,0,69000
573,1771133,34,26100,29000,97.0,5630,2023-03-27T19:34,0,26100
574,2672186,35,20900,30000,96.0,528,2023-03-27T19:34,0,20900
575,2591291,36,39200,49000,97.0,999,2023-03-27T19:34,0,39200
576,2464070,37,44000,55000,97.0,279,2023-03-27T19:34,-2200,41800
577,2280146,38,35100,39000,97.0,898,2023-03-27T19:34,0,35100
578,1920929,39,39000,0,97.0,3935,2023-03-27T19:34,0,39000
579,2715553,40,68000,0,95.0,233,2023-03-27T19:34,0,68000
580,2221221,41,35100,39000,96.0,1822,2023-03-27T19:34,0,35100
581,1760824,42,49700,59000,97.0,291,2023-03-27T19:34,0,49700
582,1836699,43,79000,0,97.0,236,2023-03-27T19:34,0,79000
583,1497550,44,29600,37000,95.0,5629,2023-03-27T19:34,0,29600
584,2287131,45,37000,0,95.0,1562,2023-03-27T19:34,0,37000
585,1524720,46,36000,0,96.0,3350,2023-03-27T19:34,0,36000
586,1906772,47,37800,42000,97.0,3011,2023-03-27T19:34,0,37800
587,3135790,48,69000,0,100.0,1,2023-03-27T19:34,0,69000
588,1214193,49,39000,0,97.0,15304,2023-03-27T19:34,0,39000
589,2107999,50,36000,0,97.0,2636,2023-03-27T19:34,0,36000
590,1022012,51,79000,0,94.0,2781,2023-03-27T19:34,0,79000
591,1214106,52,36000,0,96.0,9700,2023-03-27T19:34,0,36000
592,2560668,53,58650,69000,97.0,1216,2023-03-27T19:34,0,58650
593,2089719,54,36000,0,97.0,2377,2023-03-27T19:34,0,36000
594,2356693,55,39000,0,97.0,1505,2023-03-27T19:34,0,39000
595,2381807,56,58650,69000,98.0,1135,2023-03-27T19:34,0,58650
596,2698605,57,400000,0,0.0,0,2023-03-27T19:34,-30000,370000
597,2364344,58,26600,38000,97.0,1661,2023-03-27T19:34,0,26600
598,2859190,59,37000,0,96.0,391,2023-03-27T19:34,0,37000
599,2289281,60,26600,38000,96.0,855,2023-03-27T19:34,0,26600
600,1086824,61,29600,37000,95.0,18583,2023-03-27T19:34,0,29600
601,2879417,62,46900,55000,98.0,169,2023-03-27T19:34,0,46900
602,1063518,63,79000,0,96.0,949,2023-03-27T19:34,0,79000
603,2573131,64,37800,42000,98.0,680,2023-03-27T19:34,0,37800
604,2287105,65,38000,0,95.0,1452,2023-03-27T19:34,0,38000
605,2929129,66,384000,475000,100.0,1,2023-03-27T19:34,-30000,354000
606,1157471,67,49000,0,96.0,927,2023-03-27T19:34,0,49000
607,3119342,68,129000,0,0.0,0,2023-03-27T19:34,0,129000
608,2358733,69,35100,39000,97.0,408,2023-03-27T19:34,-2457,32643
609,2134287,70,39000,0,98.0,694,2023-03-27T19:34,0,39000
610,2697592,71,89000,0,97.0,96,2023-03-27T19:34,0,89000
611,1761934,72,49000,0,95.0,541,2023-03-27T19:34,0,49000
612,1792277,73,39000,0,97.0,1300,2023-03-27T19:34,0,39000
613,2610307,74,56000,80000,100.0,2,2023-03-27T19:34,0,56000
614,2169131,75,35100,39000,96.0,429,2023-03-27T19:34,0,35100
615,1602670,76,56050,59000,97.0,730,2023-03-27T19:34,0,56050
616,3012258,77,27900,39900,99.0,20,2023-03-27T19:34,0,27900
617,1335132,78,29000,0,95.0,1092,2023-03-27T19:34,0,29000
618,2340313,79,307000,510000,100.0,8,2023-03-27T19:34,-30000,277000
619,2962388,80,31200,39000,96.0,107,2023-03-27T19:34,0,31200
620,2108000,81,36000,0,96.0,517,2023-03-27T19:34,0,36000
621,3115958,82,59000,0,0.0,0,2023-03-27T19:34,0,59000
622,2538306,83,36000,0,98.0,259,2023-03-27T19:34,0,36000
623,2653685,84,29600,37000,95.0,233,2023-03-27T19:34,0,29600
624,2315824,85,49000,0,97.0,395,2023-03-27T19:34,0,49000
625,1300684,86,41300,59000,92.0,237,2023-03-27T19:34,0,41300
626,2998516,87,29000,0,96.0,119,2023-03-27T19:34,0,29000
627,2157079,88,37800,42000,95.0,445,2023-03-27T19:34,0,37800
628,2157077,89,37800,42000,95.0,726,2023-03-27T19:34,0,37800
629,1906773,90,37800,42000,97.0,636,2023-03-27T19:34,0,37800
630,2605850,1,94000,0,97.0,155,2023-03-27T19:34,-4700,89300
631,3059119,2,179000,0,92.0,13,2023-03-27T19:34,-35800,143200
632,3078694,3,945000,0,0.0,0,2023-03-27T19:34,0,945000
633,3106487,4,148000,0,100.0,12,2023-03-27T19:34,0,148000
634,1103286,5,94000,0,94.0,776,2023-03-27T19:34,-4700,89300
635,2153636,6,173600,248000,97.0,29,2023-03-27T19:34,-8680,164920
636,3125483,7,570000,0,0.0,0,2023-03-27T19:34,0,570000
637,2479682,8,238000,0,100.0,3,2023-03-27T19:34,-47600,190400
638,3171882,9,149000,0,0.0,0,2023-03-27T19:34,0,149000
639,1823859,10,225000,0,100.0,3,2023-03-27T19:34,-45000,180000
640,3083242,11,215100,239000,80.0,3,2023-03-27T19:34,-10755,204345
641,2568529,12,220000,0,100.0,10,2023-03-27T19:34,0,220000
642,2700731,13,212000,0,100.0,2,2023-03-27T19:34,-42400,169600
643,3073257,14,196200,218000,100.0,6,2023-03-27T19:34,-29430,166770
644,3135904,15,92000,0,0.0,0,2023-03-27T19:34,-4600,87400
645,1341924,16,95760,152000,96.0,78,2023-03-27T19:34,-4788,90972
646,3146212,17,69900,0,0.0,0,2023-03-27T19:34,-3495,66405
647,2703252,18,119500,239000,96.0,10,2023-03-27T19:34,-5975,113525
648,3083230,19,159000,0,100.0,3,2023-03-27T19:34,-7950,151050
649,3081772,20,189000,0,0.0,0,2023-03-27T19:34,-9450,179550
650,3008189,21,334000,478000,100.0,2,2023-03-27T19:34,-33400,300600
651,2717506,22,348000,0,0.0,0,2023-03-27T19:34,0,348000
652,3135497,23,150100,158000,0.0,0,2023-03-27T19:34,-30020,120080
653,3125342,24,287100,319000,0.0,0,2023-03-27T19:34,0,287100
654,2585620,25,139000,0,100.0,2,2023-03-27T19:34,-6950,132050
655,3166098,26,159000,0,0.0,0,2023-03-27T19:34,0,159000
656,2920409,27,398000,0,0.0,0,2023-03-27T19:34,0,398000
657,3091290,28,85000,0,0.0,0,2023-03-27T19:34,0,85000
658,3091291,29,85000,0,100.0,1,2023-03-27T19:34,0,85000
659,3130645,30,119000,0,0.0,0,2023-03-27T19:34,-5950,113050
660,2669756,31,143100,159000,100.0,1,2023-03-27T19:34,0,143100
661,2457512,32,237300,339000,98.0,32,2023-03-27T19:34,0,237300
662,2492336,33,89100,99000,93.0,23,2023-03-27T19:34,-4455,84645
663,3158252,34,278000,0,0.0,0,2023-03-27T19:34,-27800,250200
664,3012372,35,287400,479000,0.0,0,2023-03-27T19:34,-43110,244290
665,2052060,36,278000,0,100.0,3,2023-03-27T19:34,0,278000
666,3050174,37,258000,0,0.0,0,2023-03-27T19:34,-51600,206400
667,3047082,38,80100,89000,0.0,0,2023-03-27T19:34,0,80100
668,3171883,39,149000,0,0.0,0,2023-03-27T19:34,0,149000
669,3085822,40,115200,128000,0.0,0,2023-03-27T19:34,0,115200
670,1779568,41,57600,64000,95.0,289,2023-03-27T19:34,0,57600
671,3158231,42,278000,0,0.0,0,2023-03-27T19:34,-27800,250200
672,2131848,43,109000,0,94.0,56,2023-03-27T19:34,-5450,103550
673,2512635,44,35400,59000,96.0,195,2023-03-27T19:34,0,35400
674,2377832,45,195000,0,95.0,172,2023-03-27T19:34,-9750,185250
675,3070522,46,218000,0,0.0,0,2023-03-27T19:34,0,218000
676,2388209,47,94000,0,96.0,152,2023-03-27T19:34,-4700,89300
677,3008035,48,65900,75000,96.0,29,2023-03-27T19:34,0,65900
678,2983380,49,243000,0,0.0,0,2023-03-27T19:34,0,243000
679,3147534,50,218000,0,0.0,0,2023-03-27T19:34,-10900,207100
680,3119224,51,179100,199000,0.0,0,2023-03-27T19:34,-8955,170145
681,2377838,52,210000,0,98.0,34,2023-03-27T19:34,0,210000
682,2662638,53,159000,980000,0.0,0,2023-03-27T19:34,0,159000
683,3037449,54,199000,0,80.0,3,2023-03-27T19:34,-9950,189050
684,3053225,55,159000,0,100.0,2,2023-03-27T19:34,0,159000
685,3129903,56,176000,0,0.0,0,2023-03-27T19:34,-35200,140800
686,3046118,57,169200,188000,100.0,6,2023-03-27T19:34,-8460,160740
687,2052059,58,278000,0,0.0,0,2023-03-27T19:34,0,278000
688,2731616,59,47400,79000,95.0,78,2023-03-27T19:34,0,47400
689,3150257,60,103200,129000,0.0,0,2023-03-27T19:34,0,103200
690,2714533,61,48300,69000,93.0,228,2023-03-27T19:34,-4830,43470
691,2578707,62,218000,0,0.0,0,2023-03-27T19:34,0,218000
692,3147386,63,199000,0,0.0,0,2023-03-27T19:34,0,199000
693,2661885,64,213000,0,100.0,1,2023-03-27T19:34,-31950,181050
694,3053760,65,178200,198000,0.0,0,2023-03-27T19:34,-8910,169290
695,3156584,66,202300,289000,0.0,0,2023-03-27T19:34,0,202300
696,3081771,67,189000,0,100.0,1,2023-03-27T19:34,-9450,179550
697,2478652,68,54400,68000,94.0,326,2023-03-27T19:34,-2720,51680
698,3146734,69,188100,209000,0.0,0,2023-03-27T19:34,-28215,159885
699,2411380,70,182400,228000,100.0,2,2023-03-27T19:34,-9120,173280
700,3077360,71,98000,0,100.0,1,2023-03-27T19:34,-4900,93100
701,3146761,72,169150,199000,0.0,0,2023-03-27T19:34,-25373,143777
702,1421770,73,165600,184000,95.0,41,2023-03-27T19:34,0,165600
703,2617637,74,183000,0,0.0,0,2023-03-27T19:34,0,183000
704,2392489,75,31900,0,97.0,713,2023-03-27T19:34,0,31900
705,3053309,76,178200,198000,100.0,1,2023-03-27T19:34,-8910,169290
706,1455772,77,94000,0,96.0,207,2023-03-27T19:34,-4700,89300
707,3085850,78,115200,128000,0.0,0,2023-03-27T19:34,0,115200
708,2786207,79,167300,239000,0.0,0,2023-03-27T19:34,-8365,158935
709,3111357,80,158000,0,0.0,0,2023-03-27T19:34,-7900,150100
710,1579103,81,126400,158000,96.0,96,2023-03-27T19:34,-6320,120080
711,3066052,82,158100,186000,100.0,1,2023-03-27T19:34,0,158100
712,3104804,83,160550,169000,0.0,0,2023-03-27T19:34,0,160550
713,3173350,84,159000,0,0.0,0,2023-03-27T19:34,0,159000
714,1537416,85,57800,68000,90.0,131,2023-03-27T19:34,-2890,54910
715,1871030,86,133600,167000,95.0,96,2023-03-27T19:34,-6680,126920
716,2714524,87,48300,69000,95.0,391,2023-03-27T19:34,-4830,43470
717,2575827,88,169000,0,0.0,0,2023-03-27T19:34,-25350,143650
718,2585187,89,148000,0,94.0,11,2023-03-27T19:34,-7400,140600
719,3152241,90,159000,0,0.0,0,2023-03-27T19:34,0,159000
720,3051039,1,95200,119000,100.0,17,2023-03-27T19:34,0,95200
721,3026955,2,86700,102000,0.0,0,2023-03-27T19:34,-4335,82365
722,2925522,3,54600,65000,96.0,80,2023-03-27T19:34,0,54600
723,2921957,4,194000,0,90.0,6,2023-03-27T19:34,-38800,155200
724,3142895,5,94050,99000,0.0,0,2023-03-27T19:34,0,94050
725,3133082,6,171000,0,70.0,2,2023-03-27T19:34,-17100,153900
726,3058718,7,96000,0,97.0,7,2023-03-27T19:34,-19200,76800
727,2864414,8,69300,99000,94.0,70,2023-03-27T19:34,-3465,65835
728,2551401,9,37900,0,93.0,275,2023-03-27T19:34,0,37900
729,2448900,10,39490,43900,95.0,81,2023-03-27T19:34,0,39490
730,3073254,11,160200,178000,93.0,3,2023-03-27T19:34,-24030,136170
731,2836351,12,49680,72000,96.0,412,2023-03-27T19:34,-4968,44712
732,2796166,13,51200,64000,96.0,217,2023-03-27T19:34,-2560,48640
733,1931894,14,37900,0,95.0,490,2023-03-27T19:34,0,37900
734,2117253,15,43900,0,94.0,245,2023-03-27T19:34,0,43900
735,2867750,16,135000,0,96.0,35,2023-03-27T19:34,-6750,128250
736,3031103,17,55200,69000,100.0,16,2023-03-27T19:34,0,55200
737,3093412,18,149000,0,0.0,0,2023-03-27T19:34,0,149000
738,3062946,19,110400,138000,100.0,2,2023-03-27T19:34,0,110400
739,2792603,20,43900,0,100.0,39,2023-03-27T19:34,0,43900
740,2830788,21,139000,0,95.0,24,2023-03-27T19:34,-6950,132050
741,3051036,22,95200,119000,100.0,1,2023-03-27T19:34,0,95200
742,3031104,23,55200,69000,98.0,41,2023-03-27T19:34,0,55200
743,2377805,24,188100,198000,92.0,17,2023-03-27T19:34,-28215,159885
744,2551406,25,37900,0,95.0,193,2023-03-27T19:34,0,37900
745,2144842,26,65400,109000,95.0,19,2023-03-27T19:34,0,65400
746,3037454,27,149000,0,0.0,0,2023-03-27T19:34,-7450,141550
747,3130182,28,165000,0,0.0,0,2023-03-27T19:34,-33000,132000
748,3130181,29,165000,0,0.0,0,2023-03-27T19:34,-33000,132000
749,2551407,30,37900,0,97.0,150,2023-03-27T19:34,0,37900
750,2745024,31,166600,238000,96.0,13,2023-03-27T19:34,-16660,149940
751,1645760,32,39390,43900,96.0,330,2023-03-27T19:34,0,39390
752,1645762,33,39390,43900,94.0,328,2023-03-27T19:34,0,39390
753,3038057,34,107100,119000,84.0,5,2023-03-27T19:34,-5355,101745
754,3080578,35,80100,89000,0.0,0,2023-03-27T19:34,-8010,72090
755,1819994,36,36500,43000,92.0,647,2023-03-27T19:34,0,36500
756,3074719,37,84550,89000,0.0,0,2023-03-27T19:34,0,84550
757,3112819,38,320000,0,0.0,0,2023-03-27T19:34,-48000,272000
758,3124839,39,143100,159000,0.0,0,2023-03-27T19:34,0,143100
759,1618698,40,51200,64000,95.0,620,2023-03-27T19:34,-2560,48640
760,3126112,41,63200,79000,96.0,10,2023-03-27T19:34,0,63200
761,3121445,42,79000,98000,100.0,2,2023-03-27T19:34,-3950,75050
762,2316503,43,51200,64000,94.0,308,2023-03-27T19:34,-2560,48640
763,3109155,44,41650,49000,90.0,10,2023-03-27T19:34,0,41650
764,3040812,45,74100,78000,100.0,12,2023-03-27T19:34,-14820,59280
765,3040745,46,88000,110000,93.0,13,2023-03-27T19:34,-4400,83600
766,2551400,47,39900,0,93.0,125,2023-03-27T19:34,0,39900
767,2416846,48,54000,67900,91.0,77,2023-03-27T19:34,-2700,51300
768,3153423,49,125100,139000,0.0,0,2023-03-27T19:34,0,125100
769,2478664,50,45500,65000,96.0,34,2023-03-27T19:34,0,45500
770,3126722,51,132800,149000,0.0,0,2023-03-27T19:34,-6640,126160
771,3000422,52,59000,0,97.0,23,2023-03-27T19:34,0,59000
772,2377814,53,188100,198000,96.0,69,2023-03-27T19:34,-28215,159885
773,1999505,54,71200,89000,94.0,33,2023-03-27T19:34,0,71200
774,3038069,55,89100,99000,100.0,10,2023-03-27T19:34,-4455,84645
775,3077493,56,238000,0,0.0,0,2023-03-27T19:34,-35700,202300
776,1324169,57,29900,0,95.0,1318,2023-03-27T19:34,0,29900
777,2373068,58,109000,0,91.0,55,2023-03-27T19:34,-5450,103550
778,2830808,59,139000,0,97.0,15,2023-03-27T19:34,-6950,132050
779,2390967,60,39530,59000,93.0,202,2023-03-27T19:34,0,39530
780,2300718,61,39390,43900,95.0,232,2023-03-27T19:34,0,39390
781,1788995,62,52000,65000,94.0,551,2023-03-27T19:34,-2600,49400
782,3074718,63,84550,89000,0.0,0,2023-03-27T19:34,0,84550
783,2756335,64,125400,132000,96.0,48,2023-03-27T19:34,-6270,119130
784,2117256,65,37900,0,96.0,240,2023-03-27T19:34,0,37900
785,3065379,66,226000,0,0.0,0,2023-03-27T19:34,-33900,192100
786,3062954,67,98100,109000,0.0,0,2023-03-27T19:34,-4905,93195
787,1807814,68,65550,69000,97.0,241,2023-03-27T19:34,0,65550
788,2796164,69,59200,74000,96.0,100,2023-03-27T19:34,-2960,56240
789,2017521,70,218000,0,0.0,0,2023-03-27T19:34,0,218000
790,1979473,71,35400,59000,94.0,650,2023-03-27T19:34,-3540,31860
791,2391598,72,39440,58000,94.0,128,2023-03-27T19:34,0,39440
792,2725422,73,36900,0,98.0,65,2023-03-27T19:34,0,36900
793,2480018,74,195000,0,0.0,0,2023-03-27T19:34,-39000,156000
794,2377812,75,188100,198000,97.0,57,2023-03-27T19:34,-28215,159885
795,2377811,76,198000,0,89.0,21,2023-03-27T19:34,-29700,168300
796,3051192,77,109000,0,98.0,12,2023-03-27T19:34,0,109000
797,2377804,78,188100,198000,93.0,37,2023-03-27T19:34,-28215,159885
798,2457499,79,199000,0,0.0,0,2023-03-27T19:34,0,199000
799,2117249,80,32900,0,94.0,447,2023-03-27T19:34,0,32900
800,2945937,81,199000,0,0.0,0,2023-03-27T19:34,-29850,169150
801,3037452,82,149000,0,100.0,2,2023-03-27T19:34,-7450,141550
802,2544025,83,189000,270000,100.0,1,2023-03-27T19:34,0,189000
803,2063237,84,55200,69000,94.0,152,2023-03-27T19:34,0,55200
804,3109158,85,41650,49000,100.0,3,2023-03-27T19:34,0,41650
805,3098868,86,195000,0,0.0,0,2023-03-27T19:34,0,195000
806,3088488,87,67150,79000,0.0,0,2023-03-27T19:34,-3358,63792
807,2384620,88,93000,0,100.0,12,2023-03-27T19:34,0,93000
808,3100900,89,159600,168000,0.0,0,2023-03-27T19:34,-23940,135660
809,3069519,90,160650,189000,90.0,2,2023-03-27T19:34,-24098,136552
810,991339,1,17890,19900,97.0,52161,2023-03-27T19:34,0,17890
811,1986031,2,24990,27900,97.0,10308,2023-03-27T19:34,0,24990
812,998051,3,12900,24000,97.0,161008,2023-03-27T19:34,0,12900
813,1094748,4,19900,0,97.0,18926,2023-03-27T19:34,0,19900
814,991340,5,17890,19900,97.0,30574,2023-03-27T19:34,0,17890
815,763821,6,13900,22000,96.0,31199,2023-03-27T19:34,0,13900
816,1477845,7,15400,22000,96.0,9462,2023-03-27T19:34,0,15400
817,1094835,8,14290,15900,97.0,6128,2023-03-27T19:34,0,14290
818,1986029,9,27900,0,98.0,3866,2023-03-27T19:34,0,27900
819,1996705,10,23690,27900,98.0,2643,2023-03-27T19:34,0,23690
820,1342874,11,16900,33000,97.0,12538,2023-03-27T19:34,0,16900
821,792919,12,15190,16900,96.0,17869,2023-03-27T19:34,0,15190
822,1996702,13,23690,27900,97.0,1891,2023-03-27T19:34,0,23690
823,991341,14,16890,19900,96.0,10131,2023-03-27T19:34,0,16890
824,746158,15,22900,0,96.0,20465,2023-03-27T19:34,0,22900
825,1443937,16,12900,24000,97.0,7620,2023-03-27T19:34,0,12900
826,734085,17,10900,19800,96.0,64347,2023-03-27T19:34,0,10900
827,991570,18,12900,20000,97.0,18932,2023-03-27T19:34,0,12900
828,479245,19,15400,22000,93.0,5352,2023-03-27T19:34,0,15400
829,2832613,20,11200,33000,97.0,570,2023-03-27T19:34,0,11200
830,2297277,21,19900,22000,96.0,250,2023-03-27T19:34,0,19900
831,1729576,22,9500,13900,97.0,15807,2023-03-27T19:34,0,9500
832,2845854,23,14900,18900,97.0,175,2023-03-27T19:34,0,14900
833,1821487,24,30000,0,97.0,667,2023-03-27T19:34,0,30000
834,1094749,25,19900,0,96.0,4922,2023-03-27T19:34,0,19900
835,1094750,26,16890,19900,97.0,3528,2023-03-27T19:34,0,16890
836,792920,27,15190,16900,96.0,9643,2023-03-27T19:34,0,15190
837,746159,28,20590,22900,95.0,28679,2023-03-27T19:34,0,20590
838,1094836,29,14290,15900,97.0,1295,2023-03-27T19:34,0,14290
839,1475055,30,16200,22000,96.0,1155,2023-03-27T19:34,0,16200
840,2346958,31,18200,24000,98.0,500,2023-03-27T19:34,0,18200
841,1346009,32,9900,12000,97.0,6633,2023-03-27T19:34,0,9900
842,1094834,33,21490,23900,96.0,2436,2023-03-27T19:34,0,21490
843,1821485,34,30000,0,96.0,1229,2023-03-27T19:34,0,30000
844,2011852,35,21490,23900,97.0,1293,2023-03-27T19:34,0,21490
845,1974077,36,42090,46900,97.0,886,2023-03-27T19:34,0,42090
846,1348077,37,10900,16500,97.0,1840,2023-03-27T19:34,0,10900
847,752821,38,9900,0,94.0,23671,2023-03-27T19:34,0,9900
848,2649999,39,12800,16000,94.0,67,2023-03-27T19:34,0,12800
849,2477852,40,17890,19900,98.0,665,2023-03-27T19:34,0,17890
850,1986030,41,23690,27900,97.0,1632,2023-03-27T19:34,0,23690
851,1777081,42,8000,12800,96.0,1107,2023-03-27T19:34,0,8000
852,2959925,43,22000,27500,98.0,72,2023-03-27T19:34,0,22000
853,2960555,44,14900,19000,93.0,86,2023-03-27T19:34,0,14900
854,1556774,45,15200,16000,96.0,464,2023-03-27T19:34,-3040,12160
855,1358721,46,14200,22000,96.0,1080,2023-03-27T19:34,0,14200
856,1260384,47,19900,0,95.0,1792,2023-03-27T19:34,0,19900
857,1996704,48,22290,27900,97.0,688,2023-03-27T19:34,0,22290
858,2821589,49,19690,21900,96.0,28,2023-03-27T19:34,0,19690
859,3009680,50,12590,14900,98.0,88,2023-03-27T19:34,0,12590
860,2377936,51,25000,0,97.0,272,2023-03-27T19:34,-3750,21250
861,1260388,52,20900,0,96.0,658,2023-03-27T19:34,0,20900
862,2821598,53,19390,22900,97.0,133,2023-03-27T19:34,0,19390
863,792921,54,15190,16900,95.0,7804,2023-03-27T19:34,0,15190
864,1286366,55,11900,24000,97.0,9772,2023-03-27T19:34,0,11900
865,1121544,56,15190,16900,96.0,859,2023-03-27T19:34,0,15190
866,1573974,57,39790,46900,97.0,1447,2023-03-27T19:34,0,39790
867,1094837,58,13490,15900,96.0,1745,2023-03-27T19:34,0,13490
868,2509300,59,19900,0,96.0,386,2023-03-27T19:34,0,19900
869,2929635,60,15900,27000,97.0,475,2023-03-27T19:34,0,15900
870,3106972,61,19900,0,92.0,8,2023-03-27T19:34,0,19900
871,1475031,62,16900,27000,96.0,1706,2023-03-27T19:34,0,16900
872,2347097,63,14900,24000,98.0,1507,2023-03-27T19:34,0,14900
873,2959926,64,14850,16500,98.0,108,2023-03-27T19:34,0,14850
874,3040542,65,20900,22000,100.0,8,2023-03-27T19:34,-4180,16720
875,3118094,66,28800,32000,0.0,0,2023-03-27T19:34,-1440,27360
876,3040532,67,20900,22000,91.0,9,2023-03-27T19:34,-4180,16720
877,1821480,68,30000,0,98.0,226,2023-03-27T19:34,0,30000
878,1477846,69,15400,22000,96.0,2645,2023-03-27T19:34,0,15400
879,1296443,70,16900,23800,97.0,918,2023-03-27T19:34,0,16900
880,2738094,71,19900,0,96.0,166,2023-03-27T19:34,0,19900
881,1360044,72,19900,0,97.0,1751,2023-03-27T19:34,0,19900
882,2990345,73,27900,0,99.0,40,2023-03-27T19:34,0,27900
883,1062063,74,9490,15900,96.0,2112,2023-03-27T19:34,0,9490
884,746161,75,20590,22900,95.0,7724,2023-03-27T19:34,0,20590
885,2973915,76,14850,16500,99.0,44,2023-03-27T19:34,0,14850
886,3092677,77,24700,26000,0.0,0,2023-03-27T19:34,0,24700
887,1092994,78,22900,0,96.0,2633,2023-03-27T19:34,0,22900
888,1556773,79,15200,16000,96.0,672,2023-03-27T19:34,-3040,12160
889,2829802,80,14900,18900,97.0,21,2023-03-27T19:34,0,14900
890,2011850,81,21490,23900,98.0,846,2023-03-27T19:34,0,21490
891,2477851,82,19900,0,98.0,625,2023-03-27T19:34,0,19900
892,2467197,83,30000,0,95.0,125,2023-03-27T19:34,0,30000
893,1387502,84,12690,15900,95.0,500,2023-03-27T19:34,0,12690
894,2122868,85,9500,13900,97.0,3781,2023-03-27T19:34,0,9500
895,2973952,86,28800,48000,100.0,6,2023-03-27T19:34,-4320,24480
896,2798430,87,29000,0,96.0,37,2023-03-27T19:34,0,29000
897,1360043,88,17890,19900,97.0,777,2023-03-27T19:34,0,17890
898,768442,89,12500,0,96.0,1220,2023-03-27T19:34,0,12500
899,1392772,90,16890,19900,96.0,1129,2023-03-27T19:34,0,16890
