,item_id,rank,price,del_price,rating,rating_count,time,coupon,real_price
0,1848166,1,34300,49000,97.0,41857,2023-05-01T21:08,0,34300
1,2442409,2,27300,78000,96.0,9603,2023-05-01T21:08,0,27300
2,1763157,3,49300,52000,96.0,3128,2023-05-01T21:08,0,49300
3,2272830,4,35910,39900,97.0,21412,2023-05-01T21:08,-7182,28728
4,3187851,5,49900,110000,96.0,505,2023-05-01T21:08,-4990,44910
5,1921901,6,36900,70500,96.0,7933,2023-05-01T21:08,0,36900
6,3143791,7,45900,68000,97.0,1108,2023-05-01T21:08,-6885,39015
7,2285512,8,49300,52000,96.0,1966,2023-05-01T21:08,-2465,46835
8,3105468,9,63200,79000,98.0,162,2023-05-01T21:08,0,63200
9,2575342,10,39900,59000,96.0,1078,2023-05-01T21:08,-5985,33915
10,1944612,11,35800,59700,97.0,3308,2023-05-01T21:08,0,35800
11,345889,12,29900,47900,96.0,10730,2023-05-01T21:08,0,29900
12,1884943,13,27900,39000,96.0,19278,2023-05-01T21:08,0,27900
13,3204179,14,49900,0,98.0,128,2023-05-01T21:08,0,49900
14,2646350,15,59800,94000,95.0,5342,2023-05-01T21:08,-5980,53820
15,3219911,16,69900,118000,97.0,99,2023-05-01T21:08,-10485,59415
16,3046771,17,34960,46000,98.0,253,2023-05-01T21:08,0,34960
17,1763123,18,80100,89000,96.0,1738,2023-05-01T21:08,0,80100
18,1899755,19,27900,39000,96.0,5221,2023-05-01T21:08,0,27900
19,2086653,20,16900,0,97.0,41433,2023-05-01T21:08,0,16900
20,2479911,21,49400,76000,97.0,4806,2023-05-01T21:08,-2470,46930
21,3259338,22,88200,98000,100.0,1,2023-05-01T21:08,0,88200
22,3043740,23,49700,59000,98.0,116,2023-05-01T21:08,-2485,47215
23,3265079,24,42000,0,97.0,132,2023-05-01T21:08,0,42000
24,2462040,25,38000,45000,95.0,4148,2023-05-01T21:08,0,38000
25,2398380,26,27000,45000,96.0,1957,2023-05-01T21:08,0,27000
26,1939099,27,31850,49000,97.0,12339,2023-05-01T21:08,-6370,25480
27,2376229,28,32400,36000,97.0,4047,2023-05-01T21:08,0,32400
28,1882578,29,35910,39900,97.0,11127,2023-05-01T21:08,-7182,28728
29,2376233,30,32400,36000,97.0,2393,2023-05-01T21:08,0,32400
30,2453556,31,39900,42000,97.0,6584,2023-05-01T21:08,0,39900
31,2409894,32,27300,78000,97.0,5427,2023-05-01T21:08,0,27300
32,3214271,33,49200,82000,98.0,399,2023-05-01T21:08,0,49200
33,2645415,34,55300,79000,98.0,397,2023-05-01T21:08,0,55300
34,1706633,35,199000,0,97.0,2531,2023-05-01T21:08,0,199000
35,2034137,36,31800,0,97.0,18757,2023-05-01T21:08,-4770,27030
36,1779737,37,20800,32000,96.0,7629,2023-05-01T21:08,0,20800
37,3227259,38,39900,45000,97.0,9,2023-05-01T21:08,-11970,27930
38,994588,39,39900,53000,94.0,6248,2023-05-01T21:08,-7980,31920
39,2996536,40,39900,59000,96.0,916,2023-05-01T21:08,-5985,33915
40,1336398,41,33500,67000,96.0,19318,2023-05-01T21:08,-6700,26800
41,2623779,42,88200,98000,97.0,147,2023-05-01T21:08,0,88200
42,3201923,43,87200,109000,100.0,9,2023-05-01T21:08,-13080,74120
43,2630449,44,29400,42000,96.0,698,2023-05-01T21:08,0,29400
44,1763218,45,80100,89000,96.0,1573,2023-05-01T21:08,0,80100
45,2015684,46,39000,0,94.0,6580,2023-05-01T21:08,0,39000
46,1503352,47,39900,42000,97.0,8649,2023-05-01T21:08,0,39900
47,3257423,48,69300,99000,0.0,0,2023-05-01T21:08,0,69300
48,3070584,49,58000,0,97.0,89,2023-05-01T21:08,0,58000
49,3157193,50,39000,0,95.0,91,2023-05-01T21:08,0,39000
50,3211815,51,24500,35000,97.0,122,2023-05-01T21:08,-4900,19600
51,2326935,52,47400,79000,96.0,13241,2023-05-01T21:08,-7110,40290
52,2368712,53,38700,43000,97.0,5752,2023-05-01T21:08,-7740,30960
53,1848797,54,169000,0,97.0,149,2023-05-01T21:08,0,169000
54,3133235,55,32500,50000,96.0,106,2023-05-01T21:08,-4875,27625
55,2364807,56,219000,0,96.0,764,2023-05-01T21:08,0,219000
56,3132776,57,27900,43000,98.0,48,2023-05-01T21:08,0,27900
57,1934937,58,38700,43000,97.0,829,2023-05-01T21:08,-7740,30960
58,3129723,59,31200,39000,97.0,184,2023-05-01T21:08,-4680,26520
59,3074122,60,33150,39000,97.0,178,2023-05-01T21:08,-3315,29835
60,2461377,61,169000,0,96.0,359,2023-05-01T21:08,0,169000
61,3105470,62,63200,79000,98.0,127,2023-05-01T21:08,0,63200
62,2426596,63,34400,43000,96.0,3095,2023-05-01T21:08,0,34400
63,2377269,64,45000,0,97.0,4423,2023-05-01T21:08,0,45000
64,1842348,65,79200,99000,96.0,3084,2023-05-01T21:08,-11880,67320
65,2456003,66,54900,82900,94.0,2353,2023-05-01T21:08,0,54900
66,3174960,67,69900,87900,97.0,16,2023-05-01T21:08,0,69900
67,3206068,68,52900,74000,98.0,784,2023-05-01T21:08,-2645,50255
68,1742666,69,46900,66000,96.0,4121,2023-05-01T21:08,-7035,39865
69,3176118,70,69000,0,97.0,141,2023-05-01T21:08,-10350,58650
70,3042516,71,42000,65000,96.0,299,2023-05-01T21:08,-6300,35700
71,1955452,72,39800,69990,95.0,2842,2023-05-01T21:08,0,39800
72,3214275,73,49200,82000,98.0,602,2023-05-01T21:08,0,49200
73,996177,74,15900,0,95.0,78372,2023-05-01T21:08,0,15900
74,3241797,75,69700,118000,98.0,15,2023-05-01T21:08,-10455,59245
75,3132887,76,27900,43000,98.0,142,2023-05-01T21:08,0,27900
76,3064420,77,61500,69000,98.0,196,2023-05-01T21:08,-3075,58425
77,1820701,78,31500,35000,97.0,5677,2023-05-01T21:08,0,31500
78,2375962,79,59000,62000,98.0,6087,2023-05-01T21:08,0,59000
79,2471760,80,27300,39000,97.0,6720,2023-05-01T21:08,0,27300
80,1782647,81,39900,42000,97.0,3664,2023-05-01T21:08,0,39900
81,2445758,82,59700,0,98.0,1445,2023-05-01T21:08,0,59700
82,1911516,83,48900,81900,95.0,6258,2023-05-01T21:08,0,48900
83,3162396,84,38700,43000,96.0,31,2023-05-01T21:08,0,38700
84,1846930,85,17500,39000,96.0,8547,2023-05-01T21:08,0,17500
85,2913659,86,47900,64000,96.0,433,2023-05-01T21:08,-9580,38320
86,3046818,87,34960,46000,98.0,168,2023-05-01T21:08,0,34960
87,3129117,88,45000,0,98.0,123,2023-05-01T21:08,0,45000
88,2462039,89,38000,45000,97.0,1607,2023-05-01T21:08,0,38000
89,2453552,90,39900,42000,97.0,3180,2023-05-01T21:08,0,39900
90,1778404,1,39000,45000,96.0,68908,2023-05-01T21:08,-3900,35100
91,3033083,2,69760,109000,97.0,104,2023-05-01T21:08,-20928,48832
92,2061715,3,79900,105000,97.0,2924,2023-05-01T21:08,0,79900
93,2329532,4,129630,149000,97.0,4216,2023-05-01T21:08,0,129630
94,1558197,5,69590,81900,97.0,33380,2023-05-01T21:08,0,69590
95,3012082,6,59900,79000,96.0,1394,2023-05-01T21:08,-8985,50915
96,2723218,7,69900,85900,97.0,3354,2023-05-01T21:08,-10485,59415
97,3046899,8,79900,105000,96.0,194,2023-05-01T21:08,-23970,55930
98,1856181,9,35910,39900,97.0,8963,2023-05-01T21:08,-7182,28728
99,1776552,10,59000,69000,94.0,6341,2023-05-01T21:08,-8850,50150
100,2329533,11,129630,149000,97.0,1461,2023-05-01T21:08,0,129630
101,1790383,12,54700,86000,95.0,6072,2023-05-01T21:08,-8205,46495
102,1571879,13,79900,112900,96.0,7342,2023-05-01T21:08,-11985,67915
103,2934225,14,2394000,2520000,0.0,0,2023-05-01T21:08,0,2394000
104,1283757,15,71290,83900,96.0,27046,2023-05-01T21:08,0,71290
105,1139192,16,66400,94900,97.0,14605,2023-05-01T21:08,-9960,56440
106,2732486,17,99000,179000,98.0,907,2023-05-01T21:08,0,99000
107,1737051,18,62300,89000,96.0,5235,2023-05-01T21:08,-12460,49840
108,2723216,19,69900,85900,97.0,1313,2023-05-01T21:08,-10485,59415
109,1530516,20,69900,79000,96.0,2587,2023-05-01T21:08,-10485,59415
110,3033224,21,59900,74000,97.0,978,2023-05-01T21:08,-8985,50915
111,3029811,22,63200,79000,96.0,384,2023-05-01T21:08,-12640,50560
112,946995,23,106250,125000,94.0,2922,2023-05-01T21:08,-15938,90312
113,2788216,24,146000,159000,98.0,234,2023-05-01T21:08,0,146000
114,1778408,25,39000,45000,95.0,12086,2023-05-01T21:08,-3900,35100
115,1969617,26,162000,0,96.0,2731,2023-05-01T21:08,0,162000
116,1683384,27,599000,0,99.0,37,2023-05-01T21:08,0,599000
117,2471405,28,89000,138000,97.0,2294,2023-05-01T21:08,-8900,80100
118,2991501,29,387000,435000,90.0,2,2023-05-01T21:08,0,387000
119,1576682,30,228050,339000,97.0,8717,2023-05-01T21:08,0,228050
120,1530517,31,69900,79000,96.0,2299,2023-05-01T21:08,-10485,59415
121,3054935,32,89900,0,96.0,141,2023-05-01T21:08,0,89900
122,3055246,33,159000,0,97.0,106,2023-05-01T21:08,0,159000
123,2991484,34,379000,425000,100.0,1,2023-05-01T21:08,0,379000
124,2184466,35,359000,0,98.0,37,2023-05-01T21:08,0,359000
125,1285424,36,59900,109000,95.0,4430,2023-05-01T21:08,0,59900
126,1576700,37,89000,129000,97.0,17270,2023-05-01T21:08,-8900,80100
127,1776549,38,59000,69000,94.0,4684,2023-05-01T21:08,-8850,50150
128,3157691,39,209000,0,98.0,19,2023-05-01T21:08,-41800,167200
129,2991502,40,387000,435000,0.0,0,2023-05-01T21:08,0,387000
130,3042939,41,75900,95000,93.0,47,2023-05-01T21:08,-22770,53130
131,1618312,42,83900,0,97.0,7381,2023-05-01T21:08,0,83900
132,1751722,43,53910,59900,97.0,3619,2023-05-01T21:08,-10782,43128
133,3116512,44,2436000,0,0.0,0,2023-05-01T21:08,0,2436000
134,2064545,45,59800,94000,97.0,11554,2023-05-01T21:08,-2990,56810
135,3042934,46,109900,139000,98.0,35,2023-05-01T21:08,-32970,76930
136,2110493,47,389000,0,96.0,681,2023-05-01T21:08,0,389000
137,3037473,48,69900,85900,95.0,438,2023-05-01T21:08,-10485,59415
138,1108007,49,67890,79900,95.0,48086,2023-05-01T21:08,0,67890
139,1571878,50,79900,112900,96.0,4925,2023-05-01T21:08,-11985,67915
140,1776365,51,53400,89000,96.0,4737,2023-05-01T21:08,-8010,45390
141,2751502,52,103200,129000,90.0,10,2023-05-01T21:08,-10320,92880
142,3037472,53,69900,85900,96.0,298,2023-05-01T21:08,-10485,59415
143,2159724,54,29900,32000,95.0,2543,2023-05-01T21:08,0,29900
144,2343199,55,119000,129000,98.0,1997,2023-05-01T21:08,0,119000
145,2801177,56,59900,95000,95.0,73,2023-05-01T21:08,-17970,41930
146,2288426,57,69000,109000,94.0,904,2023-05-01T21:08,-10350,58650
147,2752332,58,84200,105300,95.0,2777,2023-05-01T21:08,0,84200
148,3100493,59,139000,0,97.0,110,2023-05-01T21:08,0,139000
149,2381781,60,186750,249000,98.0,887,2023-05-01T21:08,0,186750
150,3098909,61,150100,158000,96.0,10,2023-05-01T21:08,0,150100
151,1737049,62,62300,89000,96.0,2113,2023-05-01T21:08,-12460,49840
152,1558683,63,69590,81900,97.0,6419,2023-05-01T21:08,0,69590
153,3042259,64,151200,189000,97.0,127,2023-05-01T21:08,-22680,128520
154,3209891,65,49800,63000,88.0,10,2023-05-01T21:08,-2490,47310
155,3037468,66,49900,68500,97.0,128,2023-05-01T21:08,-7485,42415
156,2552220,67,158000,0,97.0,28,2023-05-01T21:08,0,158000
157,3010441,68,186750,249000,98.0,143,2023-05-01T21:08,0,186750
158,3186581,69,126650,149000,100.0,2,2023-05-01T21:08,-12665,113985
159,1882525,70,139000,0,97.0,1930,2023-05-01T21:08,0,139000
160,3098417,71,159000,199000,97.0,674,2023-05-01T21:08,0,159000
161,2991491,72,379000,425000,93.0,6,2023-05-01T21:08,0,379000
162,3167964,73,99900,119000,93.0,12,2023-05-01T21:08,-29970,69930
163,2444808,74,75490,83900,97.0,768,2023-05-01T21:08,0,75490
164,2668986,75,35910,39900,96.0,3796,2023-05-01T21:08,-7182,28728
165,1833230,76,95200,136000,97.0,5569,2023-05-01T21:08,-14280,80920
166,3047188,77,109650,129000,99.0,78,2023-05-01T21:08,0,109650
167,2715055,78,159000,189000,97.0,2084,2023-05-01T21:08,0,159000
168,3125671,79,148000,0,99.0,40,2023-05-01T21:08,0,148000
169,2991494,80,379000,435000,100.0,1,2023-05-01T21:08,0,379000
170,3162818,81,520000,0,0.0,0,2023-05-01T21:08,0,520000
171,2697873,82,107000,0,97.0,926,2023-05-01T21:08,0,107000
172,1272812,83,62300,89000,96.0,2847,2023-05-01T21:08,-12460,49840
173,3051261,84,53400,89000,97.0,194,2023-05-01T21:08,-8010,45390
174,3048144,85,109200,182000,95.0,299,2023-05-01T21:08,-16380,92820
175,1291017,86,67900,96000,95.0,13263,2023-05-01T21:08,0,67900
176,1195307,87,87550,103000,96.0,12863,2023-05-01T21:08,0,87550
177,1567183,88,71175,94900,97.0,7588,2023-05-01T21:08,-10677,60498
178,2322836,89,139200,174000,97.0,1094,2023-05-01T21:08,-20880,118320
179,2499152,90,159000,266000,94.0,373,2023-05-01T21:08,0,159000
180,2112059,1,36400,52000,97.0,44813,2023-05-01T21:08,-3640,32760
181,2092852,2,42000,52800,96.0,11884,2023-05-01T21:08,-6300,35700
182,1924274,3,49900,66000,95.0,23042,2023-05-01T21:08,-7485,42415
183,750908,4,34900,54000,96.0,85445,2023-05-01T21:08,0,34900
184,1926048,5,32000,0,97.0,15431,2023-05-01T21:08,-3200,28800
185,2060719,6,55200,69000,96.0,5845,2023-05-01T21:08,-8280,46920
186,3141395,7,49900,73900,96.0,402,2023-05-01T21:08,0,49900
187,2060717,8,55200,69000,95.0,4250,2023-05-01T21:08,-8280,46920
188,2028327,9,42390,49900,96.0,9698,2023-05-01T21:08,0,42390
189,1551840,10,39000,0,97.0,85664,2023-05-01T21:08,-3900,35100
190,2112061,11,36400,52000,97.0,15613,2023-05-01T21:08,-3640,32760
191,1149329,12,39900,0,96.0,87420,2023-05-01T21:08,0,39900
192,3044076,13,80100,89000,97.0,74,2023-05-01T21:08,0,80100
193,1370101,14,39000,89000,96.0,24019,2023-05-01T21:08,0,39000
194,1168906,15,35590,41900,97.0,72419,2023-05-01T21:08,0,35590
195,2060720,16,55200,69000,96.0,2835,2023-05-01T21:08,-8280,46920
196,2503133,17,42000,52800,96.0,3268,2023-05-01T21:08,-6300,35700
197,2495075,18,49800,72000,95.0,12465,2023-05-01T21:08,-4980,44820
198,1568057,19,49600,62000,96.0,23060,2023-05-01T21:08,-7440,42160
199,1885631,20,39000,49000,96.0,24046,2023-05-01T21:08,-3900,35100
200,2569078,21,59250,79000,96.0,2632,2023-05-01T21:08,0,59250
201,2351467,22,39800,54000,96.0,6966,2023-05-01T21:08,-5970,33830
202,1555407,23,70200,78000,97.0,11917,2023-05-01T21:08,0,70200
203,2150457,24,119250,159000,97.0,4251,2023-05-01T21:08,0,119250
204,2358429,25,119250,159000,98.0,2823,2023-05-01T21:08,-11925,107325
205,858911,26,39000,49000,95.0,67647,2023-05-01T21:08,-3900,35100
206,3043508,27,71200,89000,98.0,404,2023-05-01T21:08,0,71200
207,3154699,28,49800,63000,97.0,271,2023-05-01T21:08,0,49800
208,2789091,29,79200,99000,97.0,1128,2023-05-01T21:08,0,79200
209,1627892,30,43900,0,97.0,11790,2023-05-01T21:08,0,43900
210,1149328,31,35890,39900,96.0,95168,2023-05-01T21:08,0,35890
211,3120144,32,63000,84000,98.0,81,2023-05-01T21:08,0,63000
212,1552753,33,70200,78000,97.0,28536,2023-05-01T21:08,0,70200
213,3220911,34,129000,0,97.0,324,2023-05-01T21:08,0,129000
214,2060759,35,59800,74800,97.0,7596,2023-05-01T21:08,-8970,50830
215,2060743,36,33000,55000,95.0,3841,2023-05-01T21:08,-4950,28050
216,2789111,37,79200,99000,97.0,1144,2023-05-01T21:08,0,79200
217,2129180,38,76300,109000,96.0,458,2023-05-01T21:08,-7630,68670
218,2723714,39,46400,58000,96.0,1965,2023-05-01T21:08,0,46400
219,1551839,40,39000,0,97.0,24460,2023-05-01T21:08,-3900,35100
220,1595607,41,57900,89000,97.0,5945,2023-05-01T21:08,-8685,49215
221,2184087,42,47200,89000,96.0,4378,2023-05-01T21:08,0,47200
222,2381406,43,103500,138000,98.0,2409,2023-05-01T21:08,0,103500
223,1539028,44,56070,89000,95.0,4820,2023-05-01T21:08,-16821,39249
224,1222184,45,37690,41900,97.0,49045,2023-05-01T21:08,0,37690
225,1159065,46,59000,83000,95.0,21877,2023-05-01T21:08,-5900,53100
226,2725611,47,89600,128000,98.0,2380,2023-05-01T21:08,0,89600
227,2107115,48,98500,135000,98.0,11898,2023-05-01T21:08,0,98500
228,2578996,49,39900,59000,95.0,4922,2023-05-01T21:08,-5985,33915
229,1436504,50,41900,0,96.0,9440,2023-05-01T21:08,0,41900
230,3252638,51,59800,86000,96.0,24,2023-05-01T21:08,-8970,50830
231,2028326,52,49900,0,97.0,6671,2023-05-01T21:08,0,49900
232,2330460,53,118400,148000,97.0,1999,2023-05-01T21:08,-11840,106560
233,2749153,54,66600,74000,97.0,728,2023-05-01T21:08,0,66600
234,2678399,55,33900,69000,96.0,1060,2023-05-01T21:08,-10170,23730
235,1323090,56,73600,92000,96.0,6230,2023-05-01T21:08,-11040,62560
236,3154697,57,49800,63000,96.0,207,2023-05-01T21:08,0,49800
237,2562527,58,29400,42000,97.0,4433,2023-05-01T21:08,-5880,23520
238,1985223,59,39000,89000,96.0,1865,2023-05-01T21:08,0,39000
239,1440874,60,39900,0,95.0,15371,2023-05-01T21:08,0,39900
240,3129951,61,39800,49800,98.0,93,2023-05-01T21:08,-5970,33830
241,1926034,62,32000,0,97.0,3311,2023-05-01T21:08,-3200,28800
242,2817384,63,69300,99000,98.0,252,2023-05-01T21:08,-6930,62370
243,3163311,64,58800,98000,95.0,786,2023-05-01T21:08,0,58800
244,2706287,65,29000,54000,95.0,4477,2023-05-01T21:08,0,29000
245,3086712,66,41900,85000,96.0,208,2023-05-01T21:08,-6285,35615
246,2704218,67,107000,126000,97.0,201,2023-05-01T21:08,0,107000
247,3024451,68,79900,109000,94.0,21,2023-05-01T21:08,-7990,71910
248,3129953,69,39800,49800,98.0,52,2023-05-01T21:08,-5970,33830
249,1778523,70,39000,49000,96.0,3589,2023-05-01T21:08,-3900,35100
250,883004,71,69900,89000,94.0,9586,2023-05-01T21:08,0,69900
251,2569079,72,59250,79000,96.0,1252,2023-05-01T21:08,0,59250
252,1477272,73,44200,68000,96.0,18221,2023-05-01T21:08,-2210,41990
253,3037465,74,45500,56900,95.0,464,2023-05-01T21:08,-6825,38675
254,2092849,75,42000,52800,96.0,10062,2023-05-01T21:08,-6300,35700
255,2574822,76,22900,27800,96.0,1966,2023-05-01T21:08,0,22900
256,1436218,77,39900,68000,95.0,20054,2023-05-01T21:08,0,39900
257,2503134,78,42000,52800,96.0,5526,2023-05-01T21:08,-6300,35700
258,2503128,79,35800,45000,96.0,2357,2023-05-01T21:08,-5370,30430
259,1753533,80,59900,105000,95.0,3309,2023-05-01T21:08,-17970,41930
260,1568032,81,49600,62000,96.0,6458,2023-05-01T21:08,-7440,42160
261,1317598,82,39000,0,97.0,5590,2023-05-01T21:08,0,39000
262,3078375,83,335000,0,100.0,18,2023-05-01T21:08,-50250,284750
263,890338,84,39000,49000,95.0,48122,2023-05-01T21:08,-3900,35100
264,2496647,85,34300,49000,96.0,529,2023-05-01T21:08,-10290,24010
265,1666442,86,49900,0,97.0,11195,2023-05-01T21:08,0,49900
266,2402843,87,39900,0,96.0,1409,2023-05-01T21:08,0,39900
267,2192777,88,104250,139000,97.0,2378,2023-05-01T21:08,0,104250
268,3124490,89,37150,53000,93.0,144,2023-05-01T21:08,-5573,31577
269,1885563,90,39000,49000,95.0,4652,2023-05-01T21:08,-3900,35100
270,1789507,1,71100,79000,98.0,26503,2023-05-01T21:08,-7110,63990
271,1034480,2,135000,150000,97.0,18396,2023-05-01T21:08,0,135000
272,1969507,3,88000,0,98.0,5655,2023-05-01T21:08,0,88000
273,2705111,4,2696000,0,100.0,1,2023-05-01T21:08,-20000,2676000
274,2657250,5,125400,149000,97.0,177,2023-05-01T21:08,0,125400
275,2980951,6,752000,870000,0.0,0,2023-05-01T21:08,0,752000
276,2911057,7,1839000,3820000,0.0,0,2023-05-01T21:08,0,1839000
277,2973716,8,798000,1160000,94.0,7,2023-05-01T21:08,0,798000
278,3024801,9,138000,0,98.0,39,2023-05-01T21:08,0,138000
279,1835080,10,98000,0,97.0,2985,2023-05-01T21:08,0,98000
280,2702033,11,127200,159000,97.0,470,2023-05-01T21:08,-12720,114480
281,2770508,12,138000,0,97.0,387,2023-05-01T21:08,0,138000
282,2422175,13,145800,162000,98.0,250,2023-05-01T21:08,0,145800
283,1969488,14,88000,0,98.0,1861,2023-05-01T21:08,0,88000
284,3101111,15,161100,179000,95.0,73,2023-05-01T21:08,0,161100
285,3047568,16,99330,129000,96.0,139,2023-05-01T21:08,0,99330
286,2271789,17,71100,79000,97.0,2665,2023-05-01T21:08,0,71100
287,3034745,18,75600,84000,98.0,264,2023-05-01T21:08,0,75600
288,2818753,19,2690000,0,0.0,0,2023-05-01T21:08,0,2690000
289,2344538,20,119000,0,98.0,6659,2023-05-01T21:08,0,119000
290,3038000,21,74700,83000,96.0,584,2023-05-01T21:08,-11205,63495
291,3034751,22,64800,72000,96.0,781,2023-05-01T21:08,0,64800
292,1564343,23,92800,119000,98.0,8224,2023-05-01T21:08,0,92800
293,2954961,24,95000,0,96.0,404,2023-05-01T21:08,0,95000
294,2637681,25,2430000,0,0.0,0,2023-05-01T21:08,0,2430000
295,2992124,26,2403000,3090000,0.0,0,2023-05-01T21:08,0,2403000
296,2066837,27,69000,119000,97.0,6736,2023-05-01T21:08,-10350,58650
297,2261685,28,125000,0,98.0,215,2023-05-01T21:08,0,125000
298,2344540,29,96000,0,98.0,9589,2023-05-01T21:08,0,96000
299,2630526,30,100000,0,96.0,746,2023-05-01T21:08,0,100000
300,2401550,31,2221000,3280000,96.0,6,2023-05-01T21:08,-20000,2201000
301,2789785,32,140600,148000,97.0,742,2023-05-01T21:08,-7030,133570
302,1264107,33,62000,90000,97.0,6615,2023-05-01T21:08,-9300,52700
303,2849890,34,2133000,2550000,100.0,3,2023-05-01T21:08,0,2133000
304,2451701,35,2070000,2335000,100.0,1,2023-05-01T21:08,-20000,2050000
305,2343664,36,89000,0,97.0,1358,2023-05-01T21:08,0,89000
306,342189,37,39500,52000,95.0,15981,2023-05-01T21:08,0,39500
307,2713917,38,1940000,0,0.0,0,2023-05-01T21:08,-20000,1920000
308,3029922,39,295000,0,97.0,125,2023-05-01T21:08,0,295000
309,2105328,40,55300,79000,97.0,597,2023-05-01T21:08,0,55300
310,2754080,41,88000,0,97.0,553,2023-05-01T21:08,0,88000
311,2408317,42,145800,162000,96.0,440,2023-05-01T21:08,0,145800
312,1842449,43,84000,99000,97.0,5585,2023-05-01T21:08,-12600,71400
313,2888946,44,79000,0,98.0,223,2023-05-01T21:08,0,79000
314,2584181,45,72000,0,99.0,1307,2023-05-01T21:08,0,72000
315,3029926,46,285000,0,99.0,80,2023-05-01T21:08,0,285000
316,1744101,47,103500,109000,98.0,2986,2023-05-01T21:08,0,103500
317,3164863,48,69000,139000,0.0,0,2023-05-01T21:08,0,69000
318,2514819,49,54000,66000,97.0,957,2023-05-01T21:08,0,54000
319,2875369,50,873000,0,86.0,10,2023-05-01T21:08,0,873000
320,2654166,51,82000,108000,95.0,196,2023-05-01T21:08,0,82000
321,1447194,52,59900,230000,96.0,3009,2023-05-01T21:08,-2995,56905
322,2537631,53,329000,388000,100.0,24,2023-05-01T21:08,-77600,251400
323,3029905,54,395000,0,99.0,66,2023-05-01T21:08,0,395000
324,1576725,55,127150,197000,97.0,5288,2023-05-01T21:08,0,127150
325,2849886,56,1851000,2430000,93.0,6,2023-05-01T21:08,0,1851000
326,3174245,57,399000,599000,100.0,3,2023-05-01T21:08,0,399000
327,1528287,58,46500,49000,96.0,4817,2023-05-01T21:08,0,46500
328,2875847,59,1609000,2270000,0.0,0,2023-05-01T21:08,-20000,1589000
329,3034749,60,64800,72000,97.0,595,2023-05-01T21:08,0,64800
330,2086532,61,91800,124000,97.0,444,2023-05-01T21:08,0,91800
331,1323612,62,238000,0,97.0,3888,2023-05-01T21:08,-35700,202300
332,2112607,63,178000,0,97.0,386,2023-05-01T21:08,0,178000
333,1790465,64,188000,0,98.0,640,2023-05-01T21:08,-28200,159800
334,2633468,65,1556000,0,0.0,0,2023-05-01T21:08,-20000,1536000
335,1263004,66,159000,0,97.0,5306,2023-05-01T21:08,0,159000
336,693318,67,75000,110000,96.0,13326,2023-05-01T21:08,-11250,63750
337,2757112,68,359000,0,93.0,113,2023-05-01T21:08,-71800,287200
338,3140959,69,108800,128000,97.0,15,2023-05-01T21:08,-5440,103360
339,2555081,70,1577000,2600000,100.0,2,2023-05-01T21:08,-20000,1557000
340,3037524,71,74800,88000,96.0,77,2023-05-01T21:08,-3740,71060
341,3000157,72,158000,0,96.0,185,2023-05-01T21:08,0,158000
342,1581689,73,75600,89000,97.0,4169,2023-05-01T21:08,0,75600
343,3140650,74,39000,0,98.0,47,2023-05-01T21:08,-11700,27300
344,1534526,75,52200,55000,97.0,2583,2023-05-01T21:08,0,52200
345,1910358,76,99000,0,98.0,2584,2023-05-01T21:08,0,99000
346,2998775,77,142200,158000,96.0,578,2023-05-01T21:08,0,142200
347,3238873,78,179000,0,0.0,0,2023-05-01T21:08,0,179000
348,2513032,79,1339000,1950000,0.0,0,2023-05-01T21:08,-20000,1319000
349,3011494,80,69900,79000,95.0,309,2023-05-01T21:08,-10485,59415
350,3128165,81,178000,0,90.0,11,2023-05-01T21:08,0,178000
351,3029920,82,275000,0,98.0,55,2023-05-01T21:08,0,275000
352,2606343,83,82000,0,97.0,217,2023-05-01T21:08,0,82000
353,2954959,84,95000,0,96.0,236,2023-05-01T21:08,0,95000
354,3070516,85,138000,0,98.0,61,2023-05-01T21:08,0,138000
355,3036071,86,65000,0,98.0,254,2023-05-01T21:08,0,65000
356,3161081,87,169200,188000,100.0,7,2023-05-01T21:08,0,169200
357,2624678,88,145000,0,96.0,163,2023-05-01T21:08,0,145000
358,1456515,89,49500,55000,97.0,8887,2023-05-01T21:08,-7425,42075
359,2559170,90,194000,350000,100.0,16,2023-05-01T21:08,0,194000
360,1622069,1,119000,0,98.0,6077,2023-05-01T21:08,0,119000
361,2638067,2,99000,139000,97.0,3443,2023-05-01T21:08,-29700,69300
362,3030422,3,117900,139000,97.0,1013,2023-05-01T21:08,-35370,82530
363,1762407,4,260000,0,97.0,3599,2023-05-01T21:08,0,260000
364,577636,5,97300,139000,95.0,31426,2023-05-01T21:08,-29190,68110
365,1762406,6,260000,0,98.0,3580,2023-05-01T21:08,0,260000
366,165988,7,69000,0,96.0,4881,2023-05-01T21:08,0,69000
367,2545799,8,149000,0,98.0,2474,2023-05-01T21:08,0,149000
368,2861393,9,96900,139000,93.0,341,2023-05-01T21:08,-29070,67830
369,969541,10,69000,0,97.0,30692,2023-05-01T21:08,0,69000
370,1622068,11,119000,0,97.0,6999,2023-05-01T21:08,0,119000
371,2861392,12,96900,139000,97.0,671,2023-05-01T21:08,-29070,67830
372,181907,13,79900,119000,97.0,7352,2023-05-01T21:08,0,79900
373,311052,14,53100,59000,97.0,41662,2023-05-01T21:08,0,53100
374,810034,15,85500,95000,97.0,45586,2023-05-01T21:08,0,85500
375,490136,16,56900,95000,98.0,2893,2023-05-01T21:08,0,56900
376,2383963,17,139000,0,96.0,195,2023-05-01T21:08,0,139000
377,3091287,18,119000,0,98.0,454,2023-05-01T21:08,0,119000
378,490135,19,59900,95000,98.0,3606,2023-05-01T21:08,0,59900
379,2161992,20,55900,95000,97.0,3644,2023-05-01T21:08,0,55900
380,2293400,21,129000,0,96.0,1162,2023-05-01T21:08,0,129000
381,816033,22,57900,89000,96.0,13555,2023-05-01T21:08,0,57900
382,2565212,23,119000,0,99.0,489,2023-05-01T21:08,0,119000
383,695334,24,63900,99000,96.0,9705,2023-05-01T21:08,0,63900
384,2577087,25,89900,139000,97.0,470,2023-05-01T21:08,-26970,62930
385,2996167,26,96900,139000,97.0,215,2023-05-01T21:08,-29070,67830
386,2785168,27,179000,0,99.0,102,2023-05-01T21:08,0,179000
387,2703013,28,75900,129000,96.0,44,2023-05-01T21:08,-22770,53130
388,186610,29,75900,85000,97.0,16872,2023-05-01T21:08,0,75900
389,3033248,30,109000,0,97.0,807,2023-05-01T21:08,0,109000
390,1492897,31,59900,75000,96.0,3300,2023-05-01T21:08,0,59900
391,1296778,32,99000,0,98.0,2248,2023-05-01T21:08,0,99000
392,2622254,33,109000,0,98.0,1021,2023-05-01T21:08,0,109000
393,2320478,34,129000,0,97.0,614,2023-05-01T21:08,0,129000
394,3172975,35,260000,0,97.0,27,2023-05-01T21:08,0,260000
395,810033,36,89100,99000,97.0,34453,2023-05-01T21:08,0,89100
396,2737457,37,230000,0,98.0,527,2023-05-01T21:08,0,230000
397,810032,38,85500,95000,97.0,13871,2023-05-01T21:08,0,85500
398,1473136,39,79900,149000,97.0,10855,2023-05-01T21:08,0,79900
399,3072685,40,106900,119000,97.0,54,2023-05-01T21:08,-32070,74830
400,3109771,41,133900,149000,98.0,63,2023-05-01T21:08,-40170,93730
401,3024528,42,132050,139000,96.0,131,2023-05-01T21:08,0,132050
402,1493265,43,85500,95000,98.0,5061,2023-05-01T21:08,0,85500
403,2899663,44,69900,159000,95.0,80,2023-05-01T21:08,-20970,48930
404,2801307,45,424000,700000,98.0,73,2023-05-01T21:08,0,424000
405,2992069,46,96900,139000,96.0,232,2023-05-01T21:08,-29070,67830
406,104240,47,54900,69000,96.0,3957,2023-05-01T21:08,0,54900
407,2524840,48,139000,0,97.0,943,2023-05-01T21:08,0,139000
408,2970198,49,89000,0,97.0,295,2023-05-01T21:08,0,89000
409,2233180,50,75900,109000,97.0,14649,2023-05-01T21:08,0,75900
410,2731878,51,44900,79000,97.0,2063,2023-05-01T21:08,0,44900
411,2861396,52,89900,139000,94.0,94,2023-05-01T21:08,-26970,62930
412,1955217,53,69000,109000,96.0,5410,2023-05-01T21:08,-10350,58650
413,2861395,54,96900,139000,96.0,607,2023-05-01T21:08,-29070,67830
414,2355071,55,265000,0,98.0,563,2023-05-01T21:08,0,265000
415,1608838,56,67900,85000,97.0,12738,2023-05-01T21:08,0,67900
416,1900410,57,129000,0,97.0,5021,2023-05-01T21:08,0,129000
417,2493214,58,169000,0,97.0,242,2023-05-01T21:08,0,169000
418,1798273,59,75000,119000,96.0,1262,2023-05-01T21:08,0,75000
419,2741233,60,109000,0,97.0,2916,2023-05-01T21:08,0,109000
420,1493263,61,89100,99000,98.0,4326,2023-05-01T21:08,0,89100
421,1470186,62,49900,75000,97.0,3027,2023-05-01T21:08,0,49900
422,2827950,63,1056000,1445000,98.0,24,2023-05-01T21:08,0,1056000
423,3072688,64,115900,129000,100.0,19,2023-05-01T21:08,-34770,81130
424,102620,65,69000,0,97.0,18126,2023-05-01T21:08,0,69000
425,2849854,66,419000,1100000,88.0,5,2023-05-01T21:08,0,419000
426,2899664,67,60420,159000,97.0,176,2023-05-01T21:08,0,60420
427,716244,68,59900,95000,98.0,1447,2023-05-01T21:08,0,59900
428,1469860,69,51900,75000,97.0,6875,2023-05-01T21:08,0,51900
429,3188621,70,119000,0,100.0,8,2023-05-01T21:08,0,119000
430,3033084,71,129000,0,99.0,93,2023-05-01T21:08,0,129000
431,165990,72,54900,69000,97.0,1750,2023-05-01T21:08,0,54900
432,1494180,73,71100,79000,95.0,5362,2023-05-01T21:08,0,71100
433,2631192,74,98100,109000,98.0,486,2023-05-01T21:08,0,98100
434,1478592,75,75900,95000,97.0,3238,2023-05-01T21:08,0,75900
435,3091289,76,119000,0,98.0,98,2023-05-01T21:08,0,119000
436,1729744,77,76500,85000,97.0,3433,2023-05-01T21:08,0,76500
437,2999350,78,280000,0,98.0,82,2023-05-01T21:08,0,280000
438,2861394,79,89900,139000,97.0,82,2023-05-01T21:08,-26970,62930
439,311050,80,53100,59000,97.0,9182,2023-05-01T21:08,0,53100
440,3138474,81,106900,119000,98.0,40,2023-05-01T21:08,-32070,74830
441,2670201,82,39900,109000,97.0,1156,2023-05-01T21:08,0,39900
442,1868015,83,129000,0,97.0,2006,2023-05-01T21:08,0,129000
443,2688397,84,265000,0,97.0,69,2023-05-01T21:08,0,265000
444,1107127,85,69900,149000,97.0,4628,2023-05-01T21:08,0,69900
445,1231944,86,119000,0,97.0,1461,2023-05-01T21:08,0,119000
446,2691016,87,306000,0,98.0,215,2023-05-01T21:08,0,306000
447,3072404,88,113900,129000,97.0,43,2023-05-01T21:08,-34170,79730
448,3156633,89,520000,910000,100.0,3,2023-05-01T21:08,0,520000
449,3156630,90,500000,815000,93.0,3,2023-05-01T21:08,0,500000
450,2624538,1,34810,59000,97.0,1756,2023-05-01T21:08,-10443,24367
451,1092992,2,69000,0,97.0,38756,2023-05-01T21:08,0,69000
452,3062046,3,78300,87000,97.0,399,2023-05-01T21:08,-3915,74385
453,3061996,4,88200,98000,97.0,279,2023-05-01T21:08,-4410,83790
454,3134621,5,136800,152000,97.0,101,2023-05-01T21:08,-6840,129960
455,2237841,6,195000,0,98.0,76,2023-05-01T21:08,0,195000
456,3134606,7,125100,139000,97.0,119,2023-05-01T21:08,-6255,118845
457,3124961,8,65550,69000,97.0,492,2023-05-01T21:08,-3278,62272
458,1339622,9,42900,59000,97.0,16602,2023-05-01T21:08,-12870,30030
459,1720822,10,209000,0,97.0,343,2023-05-01T21:08,-10450,198550
460,3062069,11,71100,79000,96.0,137,2023-05-01T21:08,-3555,67545
461,1568047,12,159000,0,95.0,12105,2023-05-01T21:08,-23850,135150
462,2432733,13,40120,59000,97.0,3087,2023-05-01T21:08,-12036,28084
463,2383245,14,99000,0,98.0,961,2023-05-01T21:08,0,99000
464,1334438,15,170000,0,96.0,4479,2023-05-01T21:08,0,170000
465,595040,16,210000,0,95.0,8780,2023-05-01T21:08,0,210000
466,1834405,17,39900,55000,96.0,2742,2023-05-01T21:08,-11970,27930
467,2621831,18,64400,92000,95.0,823,2023-05-01T21:08,-6440,57960
468,2091749,19,75650,89000,95.0,6444,2023-05-01T21:08,0,75650
469,595039,20,210000,0,97.0,3577,2023-05-01T21:08,0,210000
470,1010925,21,170000,0,96.0,2094,2023-05-01T21:08,0,170000
471,3134563,22,88200,98000,95.0,55,2023-05-01T21:08,-4410,83790
472,501198,23,132000,139000,95.0,2787,2023-05-01T21:08,-6600,125400
473,2816812,24,119900,0,93.0,1609,2023-05-01T21:08,0,119900
474,3049313,25,57100,64900,97.0,926,2023-05-01T21:08,0,57100
475,1928038,26,84600,94000,96.0,1204,2023-05-01T21:08,-12690,71910
476,2957149,27,44900,59000,98.0,88,2023-05-01T21:08,-13470,31430
477,3161736,28,67900,158000,98.0,393,2023-05-01T21:08,-6790,61110
478,1419869,29,70300,74000,95.0,10617,2023-05-01T21:08,0,70300
479,3133873,30,169000,0,0.0,0,2023-05-01T21:08,-8450,160550
480,3224811,31,138000,0,96.0,11,2023-05-01T21:08,0,138000
481,2664372,32,65000,0,97.0,1194,2023-05-01T21:08,0,65000
482,1439535,33,49000,0,96.0,16439,2023-05-01T21:08,0,49000
483,1810758,34,160000,0,96.0,378,2023-05-01T21:08,0,160000
484,1262089,35,300000,0,97.0,1601,2023-05-01T21:08,0,300000
485,3008041,36,44900,59000,98.0,266,2023-05-01T21:08,-13470,31430
486,3075621,37,339000,0,98.0,114,2023-05-01T21:08,0,339000
487,2435822,38,94500,99000,97.0,329,2023-05-01T21:08,0,94500
488,1890398,39,132000,168000,96.0,2814,2023-05-01T21:08,-19800,112200
489,2419871,40,40120,59000,97.0,1027,2023-05-01T21:08,-12036,28084
490,3218308,41,195000,0,0.0,0,2023-05-01T21:08,0,195000
491,3018132,42,270000,300000,96.0,5,2023-05-01T21:08,0,270000
492,1815709,43,132000,168000,96.0,7208,2023-05-01T21:08,-19800,112200
493,1794942,44,1390000,0,0.0,0,2023-05-01T21:08,0,1390000
494,2664373,45,65000,0,97.0,1156,2023-05-01T21:08,0,65000
495,1891201,46,155000,0,98.0,247,2023-05-01T21:08,-7750,147250
496,2101924,47,99900,0,96.0,1447,2023-05-01T21:08,0,99900
497,1562990,48,230000,0,96.0,1298,2023-05-01T21:08,0,230000
498,1828166,49,126000,210000,94.0,868,2023-05-01T21:08,0,126000
499,3104658,50,170000,0,97.0,17,2023-05-01T21:08,0,170000
500,1439527,51,49000,0,95.0,13478,2023-05-01T21:08,0,49000
501,1129750,52,69000,0,97.0,4025,2023-05-01T21:08,0,69000
502,3188391,53,107100,170000,96.0,6,2023-05-01T21:08,0,107100
503,2787984,54,229000,266000,98.0,26,2023-05-01T21:08,0,229000
504,636821,55,143650,169000,93.0,2600,2023-05-01T21:08,-7183,136467
505,1334440,56,102000,170000,96.0,2079,2023-05-01T21:08,0,102000
506,1730340,57,232200,258000,97.0,4307,2023-05-01T21:08,0,232200
507,1952910,58,265500,295000,98.0,1758,2023-05-01T21:08,0,265500
508,2735953,59,207000,230000,98.0,478,2023-05-01T21:08,0,207000
509,2379000,60,151500,159000,98.0,151,2023-05-01T21:08,0,151500
510,1762562,61,95100,109000,95.0,339,2023-05-01T21:08,0,95100
511,2818506,62,168000,280000,95.0,141,2023-05-01T21:08,0,168000
512,2816816,63,159900,0,97.0,1922,2023-05-01T21:08,0,159900
513,2518112,64,87150,105000,96.0,1028,2023-05-01T21:08,0,87150
514,1973858,65,125300,179000,98.0,1228,2023-05-01T21:08,-18795,106505
515,1438359,66,99000,0,97.0,1238,2023-05-01T21:08,0,99000
516,1810760,67,135000,150000,96.0,212,2023-05-01T21:08,0,135000
517,2114454,68,478000,0,97.0,118,2023-05-01T21:08,0,478000
518,1810759,69,150000,0,93.0,316,2023-05-01T21:08,0,150000
519,3218310,70,149000,0,100.0,4,2023-05-01T21:08,0,149000
520,595038,71,210000,0,96.0,1346,2023-05-01T21:08,0,210000
521,2143833,72,89640,108000,96.0,2482,2023-05-01T21:08,0,89640
522,2910082,73,265500,295000,98.0,537,2023-05-01T21:08,0,265500
523,1813898,74,219000,0,97.0,41,2023-05-01T21:08,0,219000
524,2750309,75,40120,59000,98.0,477,2023-05-01T21:08,0,40120
525,2736221,76,99000,110000,96.0,331,2023-05-01T21:08,0,99000
526,3124959,77,55100,58000,97.0,89,2023-05-01T21:08,-2755,52345
527,1724193,78,251900,280000,98.0,1507,2023-05-01T21:08,0,251900
528,3255625,79,74800,88000,0.0,0,2023-05-01T21:08,-3740,71060
529,607298,80,44700,59000,93.0,15641,2023-05-01T21:08,-6705,37995
530,3093902,81,169000,0,98.0,34,2023-05-01T21:08,0,169000
531,2818508,82,196000,280000,97.0,78,2023-05-01T21:08,0,196000
532,2775205,83,219000,0,0.0,0,2023-05-01T21:08,0,219000
533,3222762,84,57000,82000,0.0,0,2023-05-01T21:08,0,57000
534,3036051,85,69900,0,99.0,146,2023-05-01T21:08,0,69900
535,1810755,86,140000,0,96.0,271,2023-05-01T21:08,0,140000
536,770006,87,92500,109000,95.0,5692,2023-05-01T21:08,-4625,87875
537,1021359,88,61000,100000,94.0,5429,2023-05-01T21:08,-9150,51850
538,1891202,89,165000,0,98.0,114,2023-05-01T21:08,-8250,156750
539,685185,90,139000,198000,95.0,12535,2023-05-01T21:08,-20850,118150
540,2134140,1,39000,0,97.0,3810,2023-05-01T21:08,0,39000
541,2280117,2,35100,39000,97.0,6637,2023-05-01T21:08,0,35100
542,1907733,3,29900,39000,96.0,3975,2023-05-01T21:08,-8970,20930
543,1214164,4,36000,0,96.0,25220,2023-05-01T21:08,0,36000
544,2356713,5,39000,0,97.0,1631,2023-05-01T21:08,0,39000
545,1272626,6,36000,0,96.0,14324,2023-05-01T21:08,0,36000
546,2356711,7,39000,0,97.0,1632,2023-05-01T21:08,0,39000
547,1822717,8,56050,59000,97.0,4451,2023-05-01T21:08,0,56050
548,2879419,9,46900,55000,98.0,948,2023-05-01T21:08,0,46900
549,2134158,10,39000,0,97.0,2650,2023-05-01T21:08,0,39000
550,2287131,11,29600,37000,95.0,1833,2023-05-01T21:08,0,29600
551,1022014,12,79000,0,96.0,11526,2023-05-01T21:08,0,79000
552,1214174,13,36000,0,97.0,15199,2023-05-01T21:08,0,36000
553,2560668,14,48300,69000,97.0,1330,2023-05-01T21:08,0,48300
554,1920929,15,39000,0,97.0,4179,2023-05-01T21:08,0,39000
555,1022013,16,79000,0,96.0,6352,2023-05-01T21:08,0,79000
556,1214317,17,36000,0,97.0,11617,2023-05-01T21:08,0,36000
557,1836699,18,79000,0,96.0,279,2023-05-01T21:08,0,79000
558,3012243,19,29900,39900,99.0,110,2023-05-01T21:08,0,29900
559,1771137,20,29000,0,97.0,12782,2023-05-01T21:08,0,29000
560,2028240,21,39000,0,98.0,3421,2023-05-01T21:08,0,39000
561,2286829,22,31450,37000,95.0,5169,2023-05-01T21:08,0,31450
562,3232889,23,35010,38900,94.0,15,2023-05-01T21:08,-3501,31509
563,2687157,24,45000,0,97.0,1121,2023-05-01T21:08,-6750,38250
564,1855444,25,39900,42000,97.0,3131,2023-05-01T21:08,-5985,33915
565,1214109,26,36000,0,97.0,8278,2023-05-01T21:08,0,36000
566,1214173,27,36000,0,96.0,5694,2023-05-01T21:08,0,36000
567,2356693,28,39000,0,97.0,1604,2023-05-01T21:08,0,39000
568,2864918,29,49000,0,99.0,164,2023-05-01T21:08,0,49000
569,1771132,30,29000,0,96.0,5428,2023-05-01T21:08,0,29000
570,2329375,31,34710,39000,96.0,2164,2023-05-01T21:08,0,34710
571,1214169,32,36000,0,96.0,5438,2023-05-01T21:08,0,36000
572,3218089,33,109000,0,0.0,0,2023-05-01T21:08,0,109000
573,2381807,34,48300,69000,98.0,1201,2023-05-01T21:08,0,48300
574,1524720,35,36000,0,96.0,3477,2023-05-01T21:08,0,36000
575,3039055,36,36550,43000,96.0,93,2023-05-01T21:08,0,36550
576,2672186,37,20900,30000,96.0,664,2023-05-01T21:08,-2299,18601
577,3099126,38,54000,0,98.0,36,2023-05-01T21:08,0,54000
578,2221221,39,35100,39000,96.0,1939,2023-05-01T21:08,0,35100
579,2879425,40,46900,55000,98.0,387,2023-05-01T21:08,0,46900
580,2123132,41,36900,39000,97.0,6519,2023-05-01T21:08,0,36900
581,2859190,42,33300,37000,96.0,538,2023-05-01T21:08,0,33300
582,3087776,43,33900,39000,97.0,39,2023-05-01T21:08,-10170,23730
583,1214171,44,36000,0,97.0,1754,2023-05-01T21:08,0,36000
584,1925814,45,35100,39000,96.0,1739,2023-05-01T21:08,0,35100
585,1497550,46,29600,37000,95.0,5785,2023-05-01T21:08,0,29600
586,2591291,47,39200,49000,97.0,1075,2023-05-01T21:08,0,39200
587,2280146,48,35100,39000,97.0,991,2023-05-01T21:08,0,35100
588,2287184,49,33300,37000,94.0,267,2023-05-01T21:08,0,33300
589,3129450,50,49000,0,97.0,41,2023-05-01T21:08,-9800,39200
590,2875053,51,138000,207000,98.0,31,2023-05-01T21:08,0,138000
591,2622323,52,19890,39000,96.0,73,2023-05-01T21:08,-5967,13923
592,2715553,53,68000,0,95.0,287,2023-05-01T21:08,0,68000
593,2234533,54,31200,39000,97.0,532,2023-05-01T21:08,0,31200
594,3105042,55,45000,0,100.0,11,2023-05-01T21:08,-9000,36000
595,2134295,56,39000,0,97.0,440,2023-05-01T21:08,0,39000
596,2107999,57,36000,0,97.0,2752,2023-05-01T21:08,0,36000
597,1907732,58,27900,39000,95.0,836,2023-05-01T21:08,-8370,19530
598,2289281,59,28500,38000,96.0,935,2023-05-01T21:08,0,28500
599,2867780,60,9750,39000,94.0,82,2023-05-01T21:08,0,9750
600,2356714,61,39000,0,97.0,507,2023-05-01T21:08,0,39000
601,2149507,62,9860,29000,95.0,468,2023-05-01T21:08,0,9860
602,3263326,63,49000,0,0.0,0,2023-05-01T21:08,0,49000
603,2358733,64,35100,39000,97.0,473,2023-05-01T21:08,-5265,29835
604,1063518,65,79000,0,96.0,973,2023-05-01T21:08,0,79000
605,1771133,66,29000,0,97.0,5812,2023-05-01T21:08,0,29000
606,1535402,67,39000,0,97.0,1225,2023-05-01T21:08,0,39000
607,1755276,68,49000,0,97.0,2450,2023-05-01T21:08,0,49000
608,2573131,69,39900,42000,97.0,756,2023-05-01T21:08,-5985,33915
609,3039061,70,33150,39000,96.0,76,2023-05-01T21:08,0,33150
610,1760824,71,49700,59000,97.0,337,2023-05-01T21:08,0,49700
611,2867785,72,9750,39000,97.0,114,2023-05-01T21:08,0,9750
612,1945782,73,56000,0,97.0,2525,2023-05-01T21:08,0,56000
613,1927034,74,31200,39000,96.0,773,2023-05-01T21:08,0,31200
614,1022015,75,79000,0,96.0,1961,2023-05-01T21:08,0,79000
615,2435766,76,37900,39900,98.0,229,2023-05-01T21:08,-5685,32215
616,2531210,77,26300,35000,96.0,717,2023-05-01T21:08,-3945,22355
617,2879417,78,46900,55000,98.0,248,2023-05-01T21:08,0,46900
618,2507080,79,39000,0,98.0,458,2023-05-01T21:08,0,39000
619,2051581,80,33000,0,96.0,893,2023-05-01T21:08,0,33000
620,3125906,81,89000,0,97.0,35,2023-05-01T21:08,-17800,71200
621,1300684,82,41300,59000,93.0,277,2023-05-01T21:08,0,41300
622,2444602,83,54000,0,97.0,141,2023-05-01T21:08,0,54000
623,1452917,84,69000,0,96.0,2443,2023-05-01T21:08,0,69000
624,3092582,85,37800,42000,98.0,64,2023-05-01T21:08,0,37800
625,1086824,86,29600,37000,95.0,18693,2023-05-01T21:08,0,29600
626,1214106,87,36000,0,96.0,9819,2023-05-01T21:08,0,36000
627,2287105,88,34200,38000,95.0,1525,2023-05-01T21:08,0,34200
628,1022012,89,79000,0,94.0,2807,2023-05-01T21:08,0,79000
629,3051146,90,34000,0,93.0,56,2023-05-01T21:08,0,34000
630,2512635,1,35400,59000,96.0,241,2023-05-01T21:08,-10620,24780
631,2457512,2,237300,339000,98.0,40,2023-05-01T21:08,0,237300
632,2712722,3,46900,79000,96.0,33,2023-05-01T21:08,-14070,32830
633,2605850,4,94000,0,97.0,185,2023-05-01T21:08,0,94000
634,2714524,5,48300,69000,95.0,416,2023-05-01T21:08,0,48300
635,3059119,6,161100,179000,92.0,29,2023-05-01T21:08,-28998,132102
636,1579103,7,126400,158000,96.0,101,2023-05-01T21:08,0,126400
637,2070402,8,195300,279000,0.0,0,2023-05-01T21:08,0,195300
638,3106487,9,133200,148000,99.0,40,2023-05-01T21:08,0,133200
639,3190290,10,249000,0,0.0,0,2023-05-01T21:08,0,249000
640,3081772,11,189000,0,96.0,5,2023-05-01T21:08,0,189000
641,3225126,12,129000,0,100.0,2,2023-05-01T21:08,0,129000
642,3053760,13,198000,0,0.0,0,2023-05-01T21:08,0,198000
643,3228631,14,135150,159000,100.0,1,2023-05-01T21:08,0,135150
644,2489894,15,150100,158000,98.0,112,2023-05-01T21:08,0,150100
645,3059601,16,390000,0,100.0,3,2023-05-01T21:08,-50000,340000
646,2388209,17,94000,0,97.0,162,2023-05-01T21:08,0,94000
647,3053221,18,179000,0,0.0,0,2023-05-01T21:08,0,179000
648,2091668,19,339000,0,80.0,1,2023-05-01T21:08,0,339000
649,2457511,20,339000,0,100.0,17,2023-05-01T21:08,0,339000
650,3228639,21,135150,159000,80.0,1,2023-05-01T21:08,0,135150
651,2392489,22,25490,31900,97.0,751,2023-05-01T21:08,0,25490
652,3200457,23,159000,0,0.0,0,2023-05-01T21:08,-15900,143100
653,3215687,24,342000,0,0.0,0,2023-05-01T21:08,0,342000
654,1779568,25,57600,64000,95.0,301,2023-05-01T21:08,0,57600
655,1875664,26,33190,36900,96.0,580,2023-05-01T21:08,0,33190
656,3130636,27,149000,0,0.0,0,2023-05-01T21:08,0,149000
657,3099416,28,44910,49900,95.0,8,2023-05-01T21:08,-8982,35928
658,3228642,29,135150,159000,0.0,0,2023-05-01T21:08,0,135150
659,1871030,30,133600,167000,95.0,103,2023-05-01T21:08,0,133600
660,3118306,31,298000,0,0.0,0,2023-05-01T21:08,-53640,244360
661,3108920,32,287000,0,0.0,0,2023-05-01T21:08,-51660,235340
662,3145625,33,249000,0,0.0,0,2023-05-01T21:08,-12450,236550
663,1103286,34,94000,0,94.0,788,2023-05-01T21:08,0,94000
664,3120621,35,197100,219000,100.0,2,2023-05-01T21:08,-39420,157680
665,3171882,36,141600,149000,100.0,5,2023-05-01T21:08,0,141600
666,1537416,37,57800,68000,90.0,135,2023-05-01T21:08,0,57800
667,3145607,38,249000,0,100.0,3,2023-05-01T21:08,-12450,236550
668,3137016,39,255000,0,0.0,0,2023-05-01T21:08,-25500,229500
669,3105861,40,129000,0,0.0,0,2023-05-01T21:08,-12900,116100
670,3126194,41,63200,79000,85.0,4,2023-05-01T21:08,0,63200
671,2377832,42,195000,0,95.0,182,2023-05-01T21:08,0,195000
672,3171883,43,141600,149000,100.0,8,2023-05-01T21:08,0,141600
673,2568515,44,220000,0,100.0,1,2023-05-01T21:08,0,220000
674,3205629,45,186000,219000,0.0,0,2023-05-01T21:08,0,186000
675,2552081,46,234000,0,0.0,0,2023-05-01T21:08,0,234000
676,1455772,47,94000,0,96.0,212,2023-05-01T21:08,0,94000
677,2664566,48,230000,0,100.0,4,2023-05-01T21:08,-41400,188600
678,1875663,49,33190,36900,95.0,843,2023-05-01T21:08,0,33190
679,2478652,50,61200,68000,94.0,343,2023-05-01T21:08,0,61200
680,2830893,51,189000,0,100.0,5,2023-05-01T21:08,0,189000
681,1840913,52,143200,179000,92.0,17,2023-05-01T21:08,0,143200
682,2070403,53,181300,259000,0.0,0,2023-05-01T21:08,0,181300
683,3230039,54,190800,212000,0.0,0,2023-05-01T21:08,-9540,181260
684,3235369,55,98100,109000,0.0,0,2023-05-01T21:08,0,98100
685,3054308,56,198000,0,0.0,0,2023-05-01T21:08,0,198000
686,3161727,57,223000,0,0.0,0,2023-05-01T21:08,0,223000
687,3156585,58,218400,273000,0.0,0,2023-05-01T21:08,0,218400
688,3119224,59,189050,199000,100.0,3,2023-05-01T21:08,0,189050
689,3210939,60,99900,0,0.0,0,2023-05-01T21:08,-9990,89910
690,3203077,61,168000,0,100.0,1,2023-05-01T21:08,-25200,142800
691,2044442,62,70000,0,96.0,172,2023-05-01T21:08,0,70000
692,3089214,63,115200,128000,0.0,0,2023-05-01T21:08,0,115200
693,2153636,64,173600,248000,98.0,32,2023-05-01T21:08,0,173600
694,1965581,65,100000,0,95.0,8,2023-05-01T21:08,0,100000
695,3250312,66,160550,169000,0.0,0,2023-05-01T21:08,0,160550
696,3130633,67,149000,0,100.0,9,2023-05-01T21:08,0,149000
697,2830892,68,189000,0,100.0,1,2023-05-01T21:08,0,189000
698,3147383,69,198000,0,0.0,0,2023-05-01T21:08,0,198000
699,3105579,70,189000,0,0.0,0,2023-05-01T21:08,0,189000
700,3211784,71,196200,218000,0.0,0,2023-05-01T21:08,-35316,160884
701,2606151,72,198000,0,0.0,0,2023-05-01T21:08,0,198000
702,2722220,73,197400,329000,0.0,0,2023-05-01T21:08,-35532,161868
703,3069666,74,179100,199000,100.0,4,2023-05-01T21:08,-35820,143280
704,1916082,75,198000,0,100.0,3,2023-05-01T21:08,0,198000
705,3250313,76,151050,159000,100.0,1,2023-05-01T21:08,0,151050
706,3174230,77,179000,0,0.0,0,2023-05-01T21:08,-35800,143200
707,2612357,78,69000,139000,97.0,21,2023-05-01T21:08,0,69000
708,2533599,79,42400,53000,95.0,65,2023-05-01T21:08,0,42400
709,2776621,80,179000,0,100.0,16,2023-05-01T21:08,0,179000
710,3130637,81,169000,0,0.0,0,2023-05-01T21:08,0,169000
711,2392491,82,25490,31900,96.0,413,2023-05-01T21:08,0,25490
712,3055337,83,159000,0,100.0,2,2023-05-01T21:08,0,159000
713,3039222,84,79050,93000,100.0,11,2023-05-01T21:08,0,79050
714,3069674,85,179100,199000,0.0,0,2023-05-01T21:08,-35820,143280
715,3251834,86,169000,0,0.0,0,2023-05-01T21:08,0,169000
716,3122381,87,168000,0,94.0,7,2023-05-01T21:08,-30240,137760
717,3102263,88,165000,0,100.0,2,2023-05-01T21:08,0,165000
718,3135234,89,62300,89000,93.0,9,2023-05-01T21:08,0,62300
719,3122373,90,168000,0,100.0,3,2023-05-01T21:08,-30240,137760
720,3228597,1,75650,89000,100.0,2,2023-05-01T21:08,0,75650
721,3170471,2,139000,0,100.0,3,2023-05-01T21:08,0,139000
722,2864414,3,69300,99000,95.0,114,2023-05-01T21:08,-10395,58905
723,3062952,4,98100,109000,99.0,24,2023-05-01T21:08,0,98100
724,3193136,5,149000,0,0.0,0,2023-05-01T21:08,0,149000
725,2551401,6,37900,0,94.0,366,2023-05-01T21:08,0,37900
726,3144344,7,66000,82000,97.0,7,2023-05-01T21:08,-9900,56100
727,3212541,8,398000,0,0.0,0,2023-05-01T21:08,-71640,326360
728,1520694,9,132100,139000,100.0,10,2023-05-01T21:08,0,132100
729,2716675,10,39900,59000,96.0,218,2023-05-01T21:08,0,39900
730,2551400,11,39900,0,93.0,168,2023-05-01T21:08,0,39900
731,3040745,12,93500,110000,95.0,24,2023-05-01T21:08,0,93500
732,3063419,13,34900,65000,98.0,16,2023-05-01T21:08,-10470,24430
733,3125453,14,49900,89900,94.0,7,2023-05-01T21:08,0,49900
734,3099491,15,379000,0,0.0,0,2023-05-01T21:08,0,379000
735,3105350,16,52000,65000,97.0,14,2023-05-01T21:08,0,52000
736,2830788,17,139000,0,95.0,28,2023-05-01T21:08,0,139000
737,3031104,18,48300,69000,98.0,92,2023-05-01T21:08,-4830,43470
738,3058716,19,86400,96000,100.0,13,2023-05-01T21:08,-15552,70848
739,3014595,20,318000,0,90.0,4,2023-05-01T21:08,-57240,260760
740,3118975,21,318000,0,90.0,2,2023-05-01T21:08,-57240,260760
741,2830762,22,139000,0,99.0,49,2023-05-01T21:08,0,139000
742,2830808,23,139000,0,97.0,15,2023-05-01T21:08,0,139000
743,3190565,24,306000,438000,0.0,0,2023-05-01T21:08,-50000,256000
744,1645762,25,39390,43900,93.0,362,2023-05-01T21:08,0,39390
745,3070528,26,168000,0,97.0,8,2023-05-01T21:08,0,168000
746,3038425,27,97300,139000,92.0,10,2023-05-01T21:08,-9730,87570
747,1645760,28,43900,0,96.0,357,2023-05-01T21:08,0,43900
748,1829249,29,290000,0,80.0,1,2023-05-01T21:08,0,290000
749,2643318,30,138000,0,93.0,19,2023-05-01T21:08,-24840,113160
750,3144374,31,71100,79000,100.0,9,2023-05-01T21:08,0,71100
751,3135305,32,38500,55000,96.0,17,2023-05-01T21:08,0,38500
752,2850491,33,250600,358000,100.0,5,2023-05-01T21:08,-45108,205492
753,3171373,34,91200,96000,0.0,0,2023-05-01T21:08,0,91200
754,2684085,35,220000,349000,0.0,0,2023-05-01T21:08,0,220000
755,2755918,36,119000,0,100.0,2,2023-05-01T21:08,0,119000
756,3109155,37,41650,49000,90.0,26,2023-05-01T21:08,0,41650
757,3051039,38,83300,119000,100.0,50,2023-05-01T21:08,-8330,74970
758,3112848,39,247000,260000,100.0,3,2023-05-01T21:08,-44460,202540
759,3004882,40,89100,99000,94.0,7,2023-05-01T21:08,0,89100
760,3154861,41,42000,56000,96.0,10,2023-05-01T21:08,0,42000
761,3115913,42,118000,0,100.0,1,2023-05-01T21:08,0,118000
762,3144417,43,71100,79000,100.0,4,2023-05-01T21:08,0,71100
763,2836289,44,29500,59000,94.0,229,2023-05-01T21:08,0,29500
764,2377814,45,198000,0,96.0,79,2023-05-01T21:08,-35640,162360
765,3174796,46,223200,248000,0.0,0,2023-05-01T21:08,-40176,183024
766,2384620,47,93000,0,97.0,14,2023-05-01T21:08,0,93000
767,3081767,48,169000,0,93.0,9,2023-05-01T21:08,0,169000
768,3038057,49,107100,119000,92.0,11,2023-05-01T21:08,0,107100
769,2377805,50,198000,0,94.0,22,2023-05-01T21:08,-35640,162360
770,3127271,51,218000,0,0.0,0,2023-05-01T21:08,-39240,178760
771,2416846,52,54000,67900,92.0,103,2023-05-01T21:08,0,54000
772,2378594,53,98000,0,95.0,132,2023-05-01T21:08,0,98000
773,1944554,54,36900,0,96.0,580,2023-05-01T21:08,0,36900
774,3115911,55,118000,0,100.0,5,2023-05-01T21:08,0,118000
775,2437604,56,216000,0,0.0,0,2023-05-01T21:08,-38880,177120
776,3000422,57,59000,0,96.0,51,2023-05-01T21:08,0,59000
777,1944553,58,36900,0,96.0,234,2023-05-01T21:08,0,36900
778,1324169,59,29900,0,95.0,1368,2023-05-01T21:08,0,29900
779,2117256,60,32190,37900,95.0,267,2023-05-01T21:08,0,32190
780,1931894,61,37900,0,95.0,549,2023-05-01T21:08,0,37900
781,2776678,62,98000,0,93.0,26,2023-05-01T21:08,0,98000
782,2894755,63,261000,735000,0.0,0,2023-05-01T21:08,0,261000
783,2377812,64,198000,0,96.0,59,2023-05-01T21:08,-35640,162360
784,2978103,65,47900,0,98.0,20,2023-05-01T21:08,0,47900
785,3202638,66,48300,69000,100.0,1,2023-05-01T21:08,0,48300
786,2117249,67,29590,32900,94.0,474,2023-05-01T21:08,0,29590
787,2836351,68,48240,72000,96.0,501,2023-05-01T21:08,-7236,41004
788,3073252,69,178000,0,95.0,8,2023-05-01T21:08,-32040,145960
789,3134481,70,188340,219000,0.0,0,2023-05-01T21:08,-33902,154438
790,3073242,71,188000,0,100.0,4,2023-05-01T21:08,-33840,154160
791,1788995,72,58500,65000,94.0,571,2023-05-01T21:08,0,58500
792,3123863,73,178000,0,0.0,0,2023-05-01T21:08,-32040,145960
793,1807814,74,65550,69000,97.0,259,2023-05-01T21:08,0,65550
794,2070430,75,181300,259000,0.0,0,2023-05-01T21:08,0,181300
795,2238383,76,189000,270000,95.0,4,2023-05-01T21:08,-34020,154980
796,2414122,77,93000,0,95.0,16,2023-05-01T21:08,0,93000
797,3073258,78,178000,0,97.0,9,2023-05-01T21:08,-32040,145960
798,2516916,79,186000,310000,0.0,0,2023-05-01T21:08,-33480,152520
799,3122278,80,178000,0,100.0,2,2023-05-01T21:08,-32040,145960
800,3037454,81,149000,0,88.0,10,2023-05-01T21:08,0,149000
801,2063992,82,179400,299000,86.0,3,2023-05-01T21:08,-32292,147108
802,3122281,83,178000,0,100.0,4,2023-05-01T21:08,-32040,145960
803,2390967,84,39530,59000,93.0,226,2023-05-01T21:08,0,39530
804,3038073,85,89100,99000,94.0,7,2023-05-01T21:08,0,89100
805,3175455,86,178200,198000,0.0,0,2023-05-01T21:08,-32076,146124
806,2664567,87,173000,0,94.0,7,2023-05-01T21:08,-31140,141860
807,3132879,88,170100,189000,0.0,0,2023-05-01T21:08,0,170100
808,3120581,89,152100,169000,100.0,7,2023-05-01T21:08,-30420,121680
809,3171372,90,91200,96000,0.0,0,2023-05-01T21:08,0,91200
810,991339,1,17890,19900,97.0,54072,2023-05-01T21:08,0,17890
811,1477845,2,15400,22000,96.0,10020,2023-05-01T21:08,-4620,10780
812,1986031,3,27900,0,97.0,11027,2023-05-01T21:08,0,27900
813,998051,4,15200,24000,97.0,165690,2023-05-01T21:08,0,15200
814,991340,5,19900,0,97.0,31236,2023-05-01T21:08,0,19900
815,763821,6,16200,22000,96.0,31704,2023-05-01T21:08,0,16200
816,2845854,7,13000,18900,97.0,400,2023-05-01T21:08,0,13000
817,479245,8,15400,22000,93.0,5501,2023-05-01T21:08,-4620,10780
818,1342874,9,16900,33000,97.0,13302,2023-05-01T21:08,0,16900
819,792919,10,15190,16900,96.0,18071,2023-05-01T21:08,0,15190
820,1094835,11,15900,0,97.0,6392,2023-05-01T21:08,0,15900
821,1094748,12,19900,0,97.0,19436,2023-05-01T21:08,0,19900
822,2297277,13,19900,22000,96.0,358,2023-05-01T21:08,-5970,13930
823,1996702,14,25090,27900,97.0,2018,2023-05-01T21:08,0,25090
824,1996705,15,23690,27900,98.0,2804,2023-05-01T21:08,0,23690
825,1443937,16,12900,24000,97.0,8427,2023-05-01T21:08,0,12900
826,991570,17,13300,20000,97.0,19310,2023-05-01T21:08,0,13300
827,1092994,18,19390,22900,96.0,2690,2023-05-01T21:08,0,19390
828,746154,19,17900,0,96.0,5252,2023-05-01T21:08,0,17900
829,1821485,20,30000,0,96.0,1315,2023-05-01T21:08,0,30000
830,746158,21,19390,22900,96.0,20635,2023-05-01T21:08,0,19390
831,1986029,22,27900,0,97.0,4053,2023-05-01T21:08,0,27900
832,1477846,23,15400,22000,96.0,2722,2023-05-01T21:08,-4620,10780
833,991341,24,16890,19900,96.0,10355,2023-05-01T21:08,0,16890
834,3033249,25,15000,0,95.0,345,2023-05-01T21:08,0,15000
835,792920,26,15190,16900,96.0,9759,2023-05-01T21:08,0,15190
836,734085,27,13200,19800,96.0,65450,2023-05-01T21:08,0,13200
837,2960555,28,19000,0,94.0,144,2023-05-01T21:08,0,19000
838,2832613,29,11900,33000,97.0,909,2023-05-01T21:08,0,11900
839,1729576,30,9600,13900,97.0,16563,2023-05-01T21:08,0,9600
840,1346009,31,9500,12000,97.0,6818,2023-05-01T21:08,0,9500
841,1547562,32,15400,22000,95.0,1393,2023-05-01T21:08,-4620,10780
842,2295818,33,19900,22000,95.0,197,2023-05-01T21:08,-5970,13930
843,2821598,34,19390,22900,97.0,182,2023-05-01T21:08,0,19390
844,472686,35,9500,14800,94.0,807,2023-05-01T21:08,0,9500
845,1986030,36,27900,0,97.0,1750,2023-05-01T21:08,0,27900
846,1094837,37,13490,15900,96.0,1801,2023-05-01T21:08,0,13490
847,2973894,38,22000,27500,98.0,36,2023-05-01T21:08,-1100,20900
848,3118094,39,28800,32000,98.0,13,2023-05-01T21:08,0,28800
849,746159,40,19390,22900,95.0,28788,2023-05-01T21:08,0,19390
850,1996704,41,22290,27900,97.0,740,2023-05-01T21:08,0,22290
851,1348077,42,10900,16500,97.0,1912,2023-05-01T21:08,0,10900
852,3009680,43,12590,14900,98.0,200,2023-05-01T21:08,0,12590
853,2829586,44,13000,18900,97.0,51,2023-05-01T21:08,0,13000
854,2011852,45,21490,23900,97.0,1340,2023-05-01T21:08,0,21490
855,1094750,46,16890,19900,97.0,3611,2023-05-01T21:08,0,16890
856,2821588,47,19690,21900,97.0,69,2023-05-01T21:08,0,19690
857,1062063,48,9490,15900,97.0,2248,2023-05-01T21:08,0,9490
858,2798430,49,29000,0,97.0,56,2023-05-01T21:08,0,29000
859,2347097,50,14900,24000,97.0,1685,2023-05-01T21:08,0,14900
860,3096660,51,13000,18900,97.0,20,2023-05-01T21:08,0,13000
861,2821589,52,19690,21900,96.0,49,2023-05-01T21:08,0,19690
862,3181894,53,22000,0,100.0,7,2023-05-01T21:08,-6600,15400
863,2870865,54,15900,19900,95.0,84,2023-05-01T21:08,0,15900
864,792921,55,15190,16900,95.0,7852,2023-05-01T21:08,0,15190
865,3096637,56,13000,18900,92.0,8,2023-05-01T21:08,0,13000
866,2973952,57,28800,48000,95.0,21,2023-05-01T21:08,-5184,23616
867,1260383,58,19900,0,95.0,1476,2023-05-01T21:08,0,19900
868,1475055,59,16200,22000,96.0,1200,2023-05-01T21:08,0,16200
869,3147419,60,12900,15000,100.0,4,2023-05-01T21:08,0,12900
870,2773510,61,24700,27500,99.0,45,2023-05-01T21:08,0,24700
871,2346958,62,18200,24000,98.0,564,2023-05-01T21:08,0,18200
872,1821487,63,30000,0,97.0,687,2023-05-01T21:08,0,30000
873,2003714,64,15200,22000,97.0,437,2023-05-01T21:08,0,15200
874,2011851,65,21490,23900,98.0,693,2023-05-01T21:08,0,21490
875,2870866,66,15900,19900,95.0,38,2023-05-01T21:08,0,15900
876,2293399,67,19900,22000,95.0,646,2023-05-01T21:08,-5970,13930
877,1974077,68,37490,46900,97.0,915,2023-05-01T21:08,0,37490
878,2829802,69,13000,18900,97.0,38,2023-05-01T21:08,0,13000
879,752821,70,9900,0,95.0,23940,2023-05-01T21:08,0,9900
880,2652523,71,9500,12000,98.0,129,2023-05-01T21:08,0,9500
881,1647682,72,15200,23600,97.0,980,2023-05-01T21:08,0,15200
882,2652498,73,9500,12000,98.0,130,2023-05-01T21:08,0,9500
883,1821480,74,30000,0,97.0,247,2023-05-01T21:08,0,30000
884,1260388,75,20900,0,95.0,701,2023-05-01T21:08,0,20900
885,1979148,76,7900,9900,98.0,299,2023-05-01T21:08,0,7900
886,1094836,77,15900,0,97.0,1348,2023-05-01T21:08,0,15900
887,2846994,78,12500,17900,95.0,23,2023-05-01T21:08,0,12500
888,2812523,79,20000,25000,97.0,111,2023-05-01T21:08,-6000,14000
889,2973095,80,20000,25000,98.0,35,2023-05-01T21:08,-1000,19000
890,2929635,81,15900,27000,97.0,602,2023-05-01T21:08,0,15900
891,2845855,82,13000,18900,98.0,61,2023-05-01T21:08,0,13000
892,1358721,83,14200,22000,96.0,1188,2023-05-01T21:08,0,14200
893,958997,84,15190,17900,95.0,1431,2023-05-01T21:08,0,15190
894,2821592,85,15590,20900,98.0,169,2023-05-01T21:08,0,15590
895,746155,86,17900,0,95.0,1284,2023-05-01T21:08,0,17900
896,2122868,87,9600,13900,97.0,3991,2023-05-01T21:08,0,9600
897,2738095,88,19900,0,95.0,121,2023-05-01T21:08,0,19900
898,2738094,89,19900,0,96.0,187,2023-05-01T21:08,0,19900
899,1260384,90,19900,0,95.0,1818,2023-05-01T21:08,0,19900
