,item_id,rank,price,del_price,rating,rating_count,time,coupon,real_price
0,2272830,1,35910,39900,97.0,20057,2023-04-17T01:03,-5387,30523
1,1848166,2,44100,49000,97.0,41336,2023-04-17T01:03,-4410,39690
2,2313388,3,68000,85000,96.0,2213,2023-04-17T01:03,-13600,54400
3,1763157,4,49400,52000,95.0,2748,2023-04-17T01:03,0,49400
4,2479911,5,49400,76000,97.0,4439,2023-04-17T01:03,0,49400
5,345889,6,29900,47900,95.0,10117,2023-04-17T01:03,0,29900
6,2086653,7,16900,0,97.0,40226,2023-04-17T01:03,0,16900
7,2646350,8,59800,94000,95.0,4636,2023-04-17T01:03,-8970,50830
8,3176118,9,65550,69000,96.0,38,2023-04-17T01:03,-9833,55717
9,1706633,10,199000,0,97.0,2435,2023-04-17T01:03,0,199000
10,3175768,11,49500,66000,97.0,212,2023-04-17T01:03,0,49500
11,2015684,12,39000,0,94.0,6481,2023-04-17T01:03,0,39000
12,3176119,13,65550,69000,97.0,34,2023-04-17T01:03,-9833,55717
13,2442409,14,39000,78000,96.0,9145,2023-04-17T01:03,-5850,33150
14,2085005,15,48300,69000,95.0,2114,2023-04-17T01:03,0,48300
15,1921901,16,36900,70500,96.0,7688,2023-04-17T01:03,0,36900
16,2456003,17,37900,82900,95.0,2265,2023-04-17T01:03,0,37900
17,1882578,18,35910,39900,97.0,10318,2023-04-17T01:03,0,35910
18,2996536,19,39900,59000,97.0,702,2023-04-17T01:03,-3990,35910
19,3219911,20,69900,118000,100.0,6,2023-04-17T01:03,0,69900
20,2034137,21,31800,0,97.0,17745,2023-04-17T01:03,-4770,27030
21,3064420,22,58100,69000,98.0,87,2023-04-17T01:03,0,58100
22,1944612,23,35800,59700,97.0,2988,2023-04-17T01:03,0,35800
23,3129723,24,27300,39000,98.0,37,2023-04-17T01:03,-4095,23205
24,2326935,25,55300,79000,96.0,13077,2023-04-17T01:03,-11060,44240
25,1884943,26,29900,39000,96.0,19000,2023-04-17T01:03,-4485,25415
26,2285512,27,49400,52000,96.0,1771,2023-04-17T01:03,0,49400
27,2462040,28,38000,45000,95.0,3932,2023-04-17T01:03,-7600,30400
28,3105468,29,67150,79000,98.0,85,2023-04-17T01:03,0,67150
29,2377269,30,45000,0,97.0,4144,2023-04-17T01:03,0,45000
30,2149254,31,37800,0,97.0,34015,2023-04-17T01:03,-5670,32130
31,1498103,32,199000,0,96.0,889,2023-04-17T01:03,0,199000
32,2913656,33,47900,64000,96.0,376,2023-04-17T01:03,-4790,43110
33,2708999,34,49800,62500,96.0,675,2023-04-17T01:03,0,49800
34,1779737,35,27200,32000,96.0,7338,2023-04-17T01:03,-5440,21760
35,3187851,36,49900,110000,97.0,267,2023-04-17T01:03,0,49900
36,2364807,37,219000,0,96.0,730,2023-04-17T01:03,0,219000
37,2398380,38,31500,45000,96.0,1676,2023-04-17T01:03,-2700,28800
38,2457846,39,37900,82900,95.0,1464,2023-04-17T01:03,0,37900
39,2376229,40,36000,0,97.0,3885,2023-04-17T01:03,0,36000
40,2314616,41,39000,43000,97.0,8435,2023-04-17T01:03,-5850,33150
41,3175651,42,39600,55000,98.0,143,2023-04-17T01:03,0,39600
42,3149803,43,99000,0,91.0,7,2023-04-17T01:03,0,99000
43,3179497,44,35910,39900,100.0,1,2023-04-17T01:03,0,35910
44,1939099,45,34300,49000,97.0,11974,2023-04-17T01:03,0,34300
45,3067178,46,29750,35000,95.0,163,2023-04-17T01:03,-5950,23800
46,2851485,47,55400,68900,96.0,509,2023-04-17T01:03,-8310,47090
47,2683347,48,48300,69000,96.0,896,2023-04-17T01:03,0,48300
48,1763123,49,84550,89000,96.0,1683,2023-04-17T01:03,0,84550
49,2453556,50,39900,42000,97.0,6338,2023-04-17T01:03,0,39900
50,3042516,51,42000,65000,97.0,143,2023-04-17T01:03,-4200,37800
51,2454238,52,97200,108000,97.0,1606,2023-04-17T01:03,-14580,82620
52,1005680,53,17500,35000,95.0,9345,2023-04-17T01:03,0,17500
53,2575342,54,39900,59000,96.0,896,2023-04-17T01:03,0,39900
54,2401885,55,23900,59000,96.0,3539,2023-04-17T01:03,0,23900
55,3208410,56,59900,68000,100.0,19,2023-04-17T01:03,0,59900
56,3034895,57,101150,119000,98.0,417,2023-04-17T01:03,0,101150
57,2633383,58,613000,0,100.0,4,2023-04-17T01:03,-20000,593000
58,2392759,59,39900,49600,95.0,4153,2023-04-17T01:03,-5985,33915
59,3043045,60,68000,85000,99.0,62,2023-04-17T01:03,-13600,54400
60,3071087,61,84550,89000,95.0,465,2023-04-17T01:03,0,84550
61,2398381,62,31500,45000,96.0,3632,2023-04-17T01:03,-2700,28800
62,2660716,63,50400,72000,96.0,2426,2023-04-17T01:03,-10080,40320
63,2038497,64,36000,45000,95.0,16453,2023-04-17T01:03,-3600,32400
64,3043051,65,68000,85000,96.0,101,2023-04-17T01:03,-13600,54400
65,2461387,66,199000,0,96.0,32,2023-04-17T01:03,0,199000
66,3129721,67,27300,39000,95.0,24,2023-04-17T01:03,-4095,23205
67,2122566,68,33800,0,97.0,16704,2023-04-17T01:03,-5070,28730
68,1582356,69,49200,82000,96.0,16335,2023-04-17T01:03,0,49200
69,2995119,70,39800,49800,96.0,604,2023-04-17T01:03,0,39800
70,2722805,71,63200,79000,96.0,955,2023-04-17T01:03,0,63200
71,3143791,72,45900,68000,98.0,455,2023-04-17T01:03,-6885,39015
72,2305840,73,56715,59700,97.0,4049,2023-04-17T01:03,-2985,53730
73,2375962,74,59000,62000,98.0,5658,2023-04-17T01:03,-5900,53100
74,1005683,75,17500,35000,95.0,10972,2023-04-17T01:03,0,17500
75,2645649,76,38900,43000,96.0,432,2023-04-17T01:03,0,38900
76,3202529,77,29900,94000,96.0,86,2023-04-17T01:03,0,29900
77,1899755,78,29900,39000,96.0,5038,2023-04-17T01:03,-4485,25415
78,2403601,79,32500,50000,96.0,2296,2023-04-17T01:03,-4875,27625
79,2456000,80,37900,82900,95.0,579,2023-04-17T01:03,0,37900
80,1503352,81,39900,42000,97.0,8515,2023-04-17T01:03,0,39900
81,2376233,82,36000,0,97.0,2266,2023-04-17T01:03,0,36000
82,3161295,83,45000,0,0.0,0,2023-04-17T01:03,0,45000
83,1817394,84,59900,150000,93.0,7336,2023-04-17T01:03,0,59900
84,956939,85,65000,0,95.0,13561,2023-04-17T01:03,-9750,55250
85,1574201,86,63200,79000,97.0,4614,2023-04-17T01:03,0,63200
86,3012570,87,54900,79000,96.0,306,2023-04-17T01:03,-6885,48015
87,3026606,88,47900,64000,96.0,242,2023-04-17T01:03,-4790,43110
88,2396645,89,39900,59000,96.0,23741,2023-04-17T01:03,0,39900
89,994588,90,39900,53000,93.0,6130,2023-04-17T01:03,-3990,35910
90,1558197,1,73690,81900,97.0,32716,2023-04-17T01:03,0,73690
91,1778404,2,42000,45000,96.0,67848,2023-04-17T01:03,-6300,35700
92,2723218,3,69900,109000,96.0,2632,2023-04-17T01:03,0,69900
93,2329532,4,119200,149000,97.0,4033,2023-04-17T01:03,-11920,107280
94,3019671,5,188100,209000,95.0,114,2023-04-17T01:03,-28215,159885
95,3012082,6,59900,79000,97.0,1132,2023-04-17T01:03,0,59900
96,1856181,7,35910,39900,97.0,7880,2023-04-17T01:03,-5387,30523
97,2020732,8,70900,89000,95.0,894,2023-04-17T01:03,0,70900
98,1283757,9,75490,83900,96.0,26801,2023-04-17T01:03,0,75490
99,1618312,10,83900,0,97.0,7223,2023-04-17T01:03,0,83900
100,1776552,11,59000,69000,94.0,6208,2023-04-17T01:03,-8850,50150
101,2471405,12,89000,138000,97.0,2156,2023-04-17T01:03,-8900,80100
102,1790383,13,59000,86000,95.0,5743,2023-04-17T01:03,-8850,50150
103,1571879,14,79900,112900,96.0,7182,2023-04-17T01:03,-7990,71910
104,1530517,15,69900,79000,96.0,2171,2023-04-17T01:03,0,69900
105,2061715,16,83900,105000,97.0,2786,2023-04-17T01:03,0,83900
106,1969617,17,162000,0,96.0,2697,2023-04-17T01:03,0,162000
107,1778408,18,42000,45000,95.0,11832,2023-04-17T01:03,-6300,35700
108,2343198,19,119000,129000,97.0,5144,2023-04-17T01:03,0,119000
109,1576700,20,89000,129000,97.0,17017,2023-04-17T01:03,-13350,75650
110,1108007,21,79900,0,95.0,47955,2023-04-17T01:03,0,79900
111,1776365,22,53400,89000,96.0,4650,2023-04-17T01:03,0,53400
112,1530516,23,69900,79000,96.0,2425,2023-04-17T01:03,0,69900
113,2064545,24,59800,94000,97.0,11308,2023-04-17T01:03,-2990,56810
114,2732486,25,109000,179000,98.0,772,2023-04-17T01:03,-10900,98100
115,2668986,26,35910,39900,96.0,3625,2023-04-17T01:03,-5387,30523
116,1195307,27,92700,103000,96.0,12722,2023-04-17T01:03,-13905,78795
117,1760177,28,139200,174000,97.0,367,2023-04-17T01:03,-20880,118320
118,1751722,29,53910,59900,97.0,3470,2023-04-17T01:03,-10782,43128
119,1558683,30,81900,0,97.0,6280,2023-04-17T01:03,0,81900
120,1737051,31,62300,89000,96.0,5156,2023-04-17T01:03,0,62300
121,3037473,32,69900,85900,96.0,285,2023-04-17T01:03,-10485,59415
122,3033224,33,59900,74000,97.0,780,2023-04-17T01:03,0,59900
123,2752332,34,94700,105300,95.0,2661,2023-04-17T01:03,-14205,80495
124,2723216,35,69900,109000,97.0,1169,2023-04-17T01:03,-10485,59415
125,2788216,36,146000,159000,98.0,152,2023-04-17T01:03,0,146000
126,2935313,37,75650,89000,98.0,217,2023-04-17T01:03,-15130,60520
127,1291017,38,67900,96000,95.0,13129,2023-04-17T01:03,0,67900
128,3029811,39,63200,79000,96.0,285,2023-04-17T01:03,0,63200
129,3025211,40,44900,69000,97.0,262,2023-04-17T01:03,-2245,42655
130,2712632,41,107000,0,97.0,1384,2023-04-17T01:03,0,107000
131,727847,42,68500,159000,93.0,10944,2023-04-17T01:03,0,68500
132,1571878,43,79900,112900,96.0,4767,2023-04-17T01:03,-7990,71910
133,1139192,44,71100,94900,97.0,14480,2023-04-17T01:03,-10665,60435
134,1833230,45,108800,136000,97.0,5476,2023-04-17T01:03,-16320,92480
135,1776550,46,59000,69000,94.0,4180,2023-04-17T01:03,-8850,50150
136,2718413,47,126650,149000,97.0,1469,2023-04-17T01:03,0,126650
137,2699160,48,179000,0,96.0,105,2023-04-17T01:03,0,179000
138,2375909,49,80890,89900,98.0,1598,2023-04-17T01:03,0,80890
139,1873073,50,75490,83900,97.0,4089,2023-04-17T01:03,0,75490
140,946995,51,106250,125000,94.0,2889,2023-04-17T01:03,-15938,90312
141,1558688,52,73690,81900,97.0,5790,2023-04-17T01:03,0,73690
142,3082210,53,359000,0,98.0,11,2023-04-17T01:03,0,359000
143,3061903,54,179000,0,98.0,17,2023-04-17T01:03,0,179000
144,2890926,55,79200,99000,98.0,93,2023-04-17T01:03,0,79200
145,965917,56,71890,79900,95.0,13105,2023-04-17T01:03,0,71890
146,2159724,57,29900,32000,95.0,2391,2023-04-17T01:03,0,29900
147,1576682,58,245000,339000,97.0,8651,2023-04-17T01:03,-36750,208250
148,3100493,59,139000,0,97.0,58,2023-04-17T01:03,0,139000
149,1344310,60,239000,0,96.0,362,2023-04-17T01:03,0,239000
150,2407203,61,148500,165000,97.0,326,2023-04-17T01:03,0,148500
151,1280576,62,37200,62000,96.0,25318,2023-04-17T01:03,-5580,31620
152,2782958,63,143100,159000,97.0,541,2023-04-17T01:03,-28620,114480
153,1337094,64,69900,0,95.0,5478,2023-04-17T01:03,0,69900
154,3010527,65,237150,279000,97.0,257,2023-04-17T01:03,0,237150
155,1337096,66,69900,0,97.0,3025,2023-04-17T01:03,0,69900
156,3092774,67,139900,0,0.0,0,2023-04-17T01:03,-20985,118915
157,2329533,68,119200,149000,97.0,1418,2023-04-17T01:03,-11920,107280
158,3079071,69,64900,87000,94.0,204,2023-04-17T01:03,-6490,58410
159,3139603,70,138000,148000,98.0,41,2023-04-17T01:03,0,138000
160,3030665,71,139200,174000,96.0,268,2023-04-17T01:03,-20880,118320
161,3046899,72,95900,105000,96.0,137,2023-04-17T01:03,0,95900
162,2980969,73,1845000,3390000,100.0,3,2023-04-17T01:03,-20000,1825000
163,2403367,74,146000,0,97.0,659,2023-04-17T01:03,0,146000
164,1567183,75,75900,94900,97.0,7490,2023-04-17T01:03,-11385,64515
165,3047197,76,103550,109000,97.0,59,2023-04-17T01:03,-20710,82840
166,3209864,77,89000,111500,95.0,4,2023-04-17T01:03,-4450,84550
167,3100486,78,139000,0,94.0,14,2023-04-17T01:03,0,139000
168,1882525,79,139000,0,97.0,1855,2023-04-17T01:03,0,139000
169,3167989,80,119000,0,98.0,10,2023-04-17T01:03,0,119000
170,3023666,81,42000,49000,97.0,254,2023-04-17T01:03,-6300,35700
171,1593755,82,89360,111700,97.0,14506,2023-04-17T01:03,-13404,75956
172,3125671,83,148000,0,98.0,21,2023-04-17T01:03,0,148000
173,2699162,84,179000,0,99.0,85,2023-04-17T01:03,0,179000
174,1558671,85,81900,0,97.0,3010,2023-04-17T01:03,0,81900
175,2284220,86,79900,112900,96.0,1731,2023-04-17T01:03,-7990,71910
176,2343199,87,119000,129000,98.0,1868,2023-04-17T01:03,0,119000
177,2837409,88,162000,0,96.0,47,2023-04-17T01:03,0,162000
178,3048205,89,208800,232000,98.0,101,2023-04-17T01:03,-31320,177480
179,2352895,90,69520,86900,97.0,3568,2023-04-17T01:03,-10428,59092
180,1551840,1,35100,39000,97.0,84333,2023-04-17T01:03,0,35100
181,2112059,2,36400,0,97.0,43668,2023-04-17T01:03,-5460,30940
182,750908,3,35900,54000,96.0,84572,2023-04-17T01:03,0,35900
183,1149329,4,39900,0,96.0,86565,2023-04-17T01:03,0,39900
184,2092852,5,42000,52800,96.0,11415,2023-04-17T01:03,0,42000
185,1370101,6,39000,89000,96.0,23329,2023-04-17T01:03,-1950,37050
186,2060719,7,55200,69000,96.0,5399,2023-04-17T01:03,0,55200
187,1168906,8,41900,0,97.0,71523,2023-04-17T01:03,0,41900
188,2112061,9,36400,0,97.0,15014,2023-04-17T01:03,-5460,30940
189,1568057,10,49600,62000,96.0,22617,2023-04-17T01:03,-7440,42160
190,858911,11,39000,49000,95.0,67201,2023-04-17T01:03,-5850,33150
191,2150457,12,119250,159000,97.0,4000,2023-04-17T01:03,-17888,101362
192,2060717,13,55200,69000,95.0,3979,2023-04-17T01:03,0,55200
193,1149328,14,39900,0,96.0,94755,2023-04-17T01:03,0,39900
194,2060720,15,55200,69000,95.0,2662,2023-04-17T01:03,0,55200
195,1924274,16,49900,66000,95.0,22693,2023-04-17T01:03,0,49900
196,1926048,17,32000,0,97.0,14922,2023-04-17T01:03,0,32000
197,1552753,18,74100,78000,97.0,28301,2023-04-17T01:03,-11115,62985
198,1551839,19,39000,0,97.0,23855,2023-04-17T01:03,0,39000
199,2503134,20,42000,52800,96.0,5381,2023-04-17T01:03,0,42000
200,1736085,21,39900,59800,96.0,37165,2023-04-17T01:03,0,39900
201,3141395,22,49900,73900,97.0,225,2023-04-17T01:03,-4990,44910
202,2706287,23,29000,54000,95.0,4030,2023-04-17T01:03,0,29000
203,2028327,24,49900,0,97.0,9310,2023-04-17T01:03,0,49900
204,3175685,25,69800,110000,97.0,84,2023-04-17T01:03,0,69800
205,1573215,26,133200,148000,98.0,9413,2023-04-17T01:03,-19980,113220
206,2789091,27,79200,99000,97.0,906,2023-04-17T01:03,-11880,67320
207,3098372,28,89000,139000,97.0,1042,2023-04-17T01:03,0,89000
208,2789111,29,79200,99000,97.0,954,2023-04-17T01:03,-11880,67320
209,1222184,30,41900,0,97.0,48619,2023-04-17T01:03,0,41900
210,2503133,31,42000,52800,96.0,3163,2023-04-17T01:03,0,42000
211,2351467,32,39800,54000,96.0,6542,2023-04-17T01:03,-5970,33830
212,3051674,33,49900,0,100.0,1,2023-04-17T01:03,-4990,44910
213,3043508,34,71200,89000,97.0,181,2023-04-17T01:03,0,71200
214,2184087,35,49000,89000,96.0,4197,2023-04-17T01:03,-2450,46550
215,1436504,36,41900,0,95.0,9279,2023-04-17T01:03,0,41900
216,2562527,37,29400,42000,97.0,4177,2023-04-17T01:03,-4410,24990
217,3049798,38,96800,121000,97.0,95,2023-04-17T01:03,-19360,77440
218,3129951,39,39800,49800,100.0,17,2023-04-17T01:03,0,39800
219,1568032,40,49600,62000,96.0,6272,2023-04-17T01:03,-7440,42160
220,890521,41,39800,63000,94.0,11299,2023-04-17T01:03,0,39800
221,2358429,42,159000,0,98.0,2672,2023-04-17T01:03,0,159000
222,2060743,43,33000,55000,95.0,3670,2023-04-17T01:03,0,33000
223,1555407,44,74100,78000,97.0,11721,2023-04-17T01:03,-11115,62985
224,2060759,45,59800,74800,97.0,7363,2023-04-17T01:03,0,59800
225,2028326,46,49900,0,97.0,6353,2023-04-17T01:03,0,49900
226,1436218,47,25900,68000,95.0,19440,2023-04-17T01:03,0,25900
227,1324127,48,28790,33900,96.0,13873,2023-04-17T01:03,0,28790
228,2744549,49,49600,62000,97.0,5309,2023-04-17T01:03,-7440,42160
229,2723714,50,52000,58000,96.0,1690,2023-04-17T01:03,0,52000
230,1595607,51,57900,89000,97.0,5799,2023-04-17T01:03,-11580,46320
231,2578996,52,39900,59000,95.0,4756,2023-04-17T01:03,-5985,33915
232,1885631,53,39000,49000,96.0,23845,2023-04-17T01:03,-5850,33150
233,1323090,54,64400,92000,96.0,6056,2023-04-17T01:03,-12880,51520
234,1627892,55,43900,0,97.0,11256,2023-04-17T01:03,0,43900
235,2092849,56,42000,52800,96.0,9888,2023-04-17T01:03,0,42000
236,3116618,57,168000,0,100.0,48,2023-04-17T01:03,0,168000
237,2569078,58,79000,0,96.0,2486,2023-04-17T01:03,0,79000
238,883004,59,69900,89000,94.0,9511,2023-04-17T01:03,0,69900
239,2712149,60,29640,78000,96.0,501,2023-04-17T01:03,0,29640
240,2032901,61,39900,0,97.0,6980,2023-04-17T01:03,0,39900
241,2837340,62,53000,59000,96.0,909,2023-04-17T01:03,-10600,42400
242,1854665,63,139000,0,97.0,1125,2023-04-17T01:03,0,139000
243,1985223,64,39000,89000,96.0,1716,2023-04-17T01:03,-1950,37050
244,3034871,65,100800,126000,97.0,192,2023-04-17T01:03,0,100800
245,2713343,66,105000,350000,98.0,10,2023-04-17T01:03,-10500,94500
246,2495075,67,49800,72000,95.0,12125,2023-04-17T01:03,-7470,42330
247,2124896,68,98000,0,98.0,744,2023-04-17T01:03,-14700,83300
248,2351468,69,39800,54000,96.0,1285,2023-04-17T01:03,0,39800
249,3022892,70,39000,49000,96.0,475,2023-04-17T01:03,-5850,33150
250,1477272,71,44200,68000,96.0,17989,2023-04-17T01:03,-2210,41990
251,1168922,72,43900,0,96.0,18337,2023-04-17T01:03,0,43900
252,3040868,73,83300,98000,92.0,59,2023-04-17T01:03,-16660,66640
253,1440874,74,39900,0,95.0,15192,2023-04-17T01:03,0,39900
254,1764739,75,64400,92000,97.0,2778,2023-04-17T01:03,-12880,51520
255,2749153,76,66600,74000,97.0,635,2023-04-17T01:03,0,66600
256,1826978,77,79000,0,96.0,7060,2023-04-17T01:03,-7900,71100
257,1212776,78,28690,31900,96.0,23572,2023-04-17T01:03,0,28690
258,890338,79,39000,49000,95.0,47867,2023-04-17T01:03,-5850,33150
259,2877984,80,59000,0,97.0,454,2023-04-17T01:03,0,59000
260,3175675,81,39600,55000,95.0,78,2023-04-17T01:03,0,39600
261,1666442,82,49900,0,97.0,11020,2023-04-17T01:03,0,49900
262,3062147,83,109000,149000,98.0,68,2023-04-17T01:03,0,109000
263,1212777,84,25490,31900,96.0,21851,2023-04-17T01:03,0,25490
264,2028329,85,49900,0,96.0,6630,2023-04-17T01:03,0,49900
265,1224095,86,35890,39900,97.0,24582,2023-04-17T01:03,0,35890
266,2131950,87,39000,49000,97.0,4067,2023-04-17T01:03,-5850,33150
267,3134710,88,79900,0,0.0,0,2023-04-17T01:03,-11985,67915
268,1246215,89,49000,65000,96.0,6380,2023-04-17T01:03,-9800,39200
269,3047822,90,116100,129000,99.0,101,2023-04-17T01:03,-23220,92880
270,2789785,1,116920,148000,97.0,664,2023-04-17T01:03,-11692,105228
271,2702033,2,127200,159000,97.0,444,2023-04-17T01:03,0,127200
272,1034480,3,135000,150000,97.0,18225,2023-04-17T01:03,0,135000
273,1789507,4,79000,0,98.0,26123,2023-04-17T01:03,0,79000
274,1969507,5,88000,0,98.0,5502,2023-04-17T01:03,0,88000
275,2789787,6,116920,148000,96.0,364,2023-04-17T01:03,-11692,105228
276,1264107,7,65000,90000,97.0,6459,2023-04-17T01:03,-9750,55250
277,3192309,8,93220,118000,98.0,103,2023-04-17T01:03,-9322,83898
278,2789786,9,124820,158000,97.0,252,2023-04-17T01:03,-12482,112338
279,1842449,10,84000,99000,97.0,5477,2023-04-17T01:03,-16800,67200
280,2637686,11,2550000,0,0.0,0,2023-04-17T01:03,-20000,2530000
281,1835080,12,98000,0,97.0,2881,2023-04-17T01:03,0,98000
282,3029905,13,395000,0,99.0,46,2023-04-17T01:03,0,395000
283,2344540,14,96000,0,98.0,9355,2023-04-17T01:03,0,96000
284,1910358,15,89100,99000,98.0,2516,2023-04-17T01:03,-13365,75735
285,2654166,16,69000,108000,96.0,101,2023-04-17T01:03,-10350,58650
286,2066837,17,79000,119000,97.0,6591,2023-04-17T01:03,-11850,67150
287,3038000,18,74700,83000,97.0,454,2023-04-17T01:03,-11205,63495
288,2271789,19,71100,79000,97.0,2578,2023-04-17T01:03,0,71100
289,2770508,20,138000,0,97.0,361,2023-04-17T01:03,0,138000
290,2956540,21,1958000,3135000,0.0,0,2023-04-17T01:03,-20000,1938000
291,2344538,22,119000,0,98.0,6497,2023-04-17T01:03,0,119000
292,1969488,23,88000,0,98.0,1794,2023-04-17T01:03,0,88000
293,2273014,24,1791000,2390000,100.0,1,2023-04-17T01:03,-20000,1771000
294,1581689,25,75600,89000,97.0,4051,2023-04-17T01:03,0,75600
295,1960578,26,47200,59000,97.0,86,2023-04-17T01:03,0,47200
296,3161264,27,98100,109000,98.0,52,2023-04-17T01:03,-19620,78480
297,2992125,28,1733000,2290000,0.0,0,2023-04-17T01:03,-20000,1713000
298,2320927,29,39000,51000,97.0,2281,2023-04-17T01:03,0,39000
299,3206841,30,158000,0,0.0,0,2023-04-17T01:03,0,158000
300,3034751,31,64800,72000,97.0,565,2023-04-17T01:03,0,64800
301,2408317,32,162000,0,96.0,407,2023-04-17T01:03,0,162000
302,2657250,33,125400,149000,97.0,138,2023-04-17T01:03,0,125400
303,342189,34,39500,52000,95.0,15830,2023-04-17T01:03,0,39500
304,1736022,35,188000,0,95.0,456,2023-04-17T01:03,0,188000
305,3024801,36,138000,0,100.0,28,2023-04-17T01:03,0,138000
306,2789784,37,124820,158000,97.0,191,2023-04-17T01:03,-12482,112338
307,1323612,38,238000,0,97.0,3855,2023-04-17T01:03,0,238000
308,3048794,39,1350000,2330000,0.0,0,2023-04-17T01:03,-20000,1330000
309,2901245,40,1351000,1795000,0.0,0,2023-04-17T01:03,-20000,1331000
310,2783624,41,69000,108000,100.0,33,2023-04-17T01:03,-10350,58650
311,3034745,42,75600,84000,97.0,196,2023-04-17T01:03,0,75600
312,2422175,43,145800,162000,98.0,225,2023-04-17T01:03,-21870,123930
313,1090160,44,99000,0,97.0,1335,2023-04-17T01:03,0,99000
314,3101111,45,179000,0,96.0,50,2023-04-17T01:03,0,179000
315,2514819,46,59000,66000,97.0,887,2023-04-17T01:03,0,59000
316,2558648,47,119000,0,98.0,1317,2023-04-17T01:03,0,119000
317,3082387,48,139000,0,98.0,151,2023-04-17T01:03,-13900,125100
318,2888946,49,79000,0,98.0,184,2023-04-17T01:03,-7900,71100
319,1528287,50,46500,49000,96.0,4695,2023-04-17T01:03,0,46500
320,2975285,51,55250,65000,98.0,367,2023-04-17T01:03,0,55250
321,1745100,52,103500,109000,97.0,1027,2023-04-17T01:03,0,103500
322,1564343,53,92800,119000,98.0,8144,2023-04-17T01:03,-13920,78880
323,693318,54,79000,110000,96.0,13234,2023-04-17T01:03,-11850,67150
324,1758217,55,43900,56000,97.0,13210,2023-04-17T01:03,-2195,41705
325,3047568,56,109650,129000,96.0,89,2023-04-17T01:03,-10965,98685
326,2679537,57,162000,0,96.0,125,2023-04-17T01:03,0,162000
327,2967338,58,280000,470000,97.0,27,2023-04-17T01:03,-20000,260000
328,3034749,59,64800,72000,97.0,500,2023-04-17T01:03,0,64800
329,2902045,60,298000,485000,98.0,36,2023-04-17T01:03,-20000,278000
330,3070516,61,138000,0,96.0,33,2023-04-17T01:03,0,138000
331,2664933,62,90000,0,96.0,378,2023-04-17T01:03,-4500,85500
332,2343665,63,89000,0,97.0,4708,2023-04-17T01:03,0,89000
333,3149665,64,98000,0,100.0,8,2023-04-17T01:03,-14700,83300
334,913402,65,83300,98000,95.0,8084,2023-04-17T01:03,-16660,66640
335,1597319,66,89100,99000,97.0,615,2023-04-17T01:03,-4455,84645
336,3216143,67,39900,49600,100.0,6,2023-04-17T01:03,-5985,33915
337,3045584,68,130500,145000,97.0,3800,2023-04-17T01:03,0,130500
338,3029926,69,285000,0,99.0,66,2023-04-17T01:03,0,285000
339,3187993,70,395000,0,100.0,1,2023-04-17T01:03,0,395000
340,693525,71,46800,65000,96.0,4051,2023-04-17T01:03,-7020,39780
341,3034743,72,75600,84000,96.0,238,2023-04-17T01:03,0,75600
342,3028885,73,139920,159000,97.0,27,2023-04-17T01:03,-6996,132924
343,1456515,74,49500,55000,97.0,8783,2023-04-17T01:03,-7425,42075
344,2705106,75,410400,513000,100.0,1,2023-04-17T01:03,-20000,390400
345,3045076,76,54600,84000,97.0,111,2023-04-17T01:03,-2730,51870
346,2279619,77,71200,89000,97.0,482,2023-04-17T01:03,0,71200
347,2002697,78,76000,0,97.0,3518,2023-04-17T01:03,0,76000
348,2977841,79,390000,0,100.0,1,2023-04-17T01:03,0,390000
349,3130030,80,74700,83000,99.0,24,2023-04-17T01:03,-11205,63495
350,2869053,81,369000,0,98.0,30,2023-04-17T01:03,0,369000
351,2306062,82,89000,139000,97.0,1206,2023-04-17T01:03,-13350,75650
352,2914920,83,369000,439000,100.0,6,2023-04-17T01:03,0,369000
353,2105328,84,55300,79000,97.0,537,2023-04-17T01:03,-8295,47005
354,2633449,85,403200,504000,100.0,1,2023-04-17T01:03,-20000,383200
355,2373982,86,977000,1820000,100.0,13,2023-04-17T01:03,-20000,957000
356,3216131,87,39900,49600,100.0,2,2023-04-17T01:03,-5985,33915
357,2993947,88,100000,0,96.0,165,2023-04-17T01:03,-5000,95000
358,1964770,89,59400,66000,97.0,2540,2023-04-17T01:03,-8910,50490
359,2193458,90,159000,0,97.0,598,2023-04-17T01:03,0,159000
360,3116973,1,126000,140000,90.0,2,2023-04-17T01:03,0,126000
361,969541,2,69000,0,97.0,29988,2023-04-17T01:03,0,69000
362,1762406,3,260000,0,98.0,3447,2023-04-17T01:03,0,260000
363,2545799,4,149000,0,98.0,2264,2023-04-17T01:03,0,149000
364,1762407,5,260000,0,97.0,3406,2023-04-17T01:03,0,260000
365,3026310,6,99000,0,99.0,811,2023-04-17T01:03,0,99000
366,1622068,7,119000,0,97.0,6781,2023-04-17T01:03,0,119000
367,810034,8,85500,95000,97.0,45378,2023-04-17T01:03,0,85500
368,2638067,9,99000,139000,97.0,3225,2023-04-17T01:03,0,99000
369,2731878,10,44900,79000,97.0,1822,2023-04-17T01:03,0,44900
370,2293400,11,129000,0,96.0,1059,2023-04-17T01:03,0,129000
371,490136,12,56900,95000,98.0,2533,2023-04-17T01:03,0,56900
372,1955217,13,69000,109000,96.0,5250,2023-04-17T01:03,-13800,55200
373,695334,14,78900,99000,96.0,9511,2023-04-17T01:03,0,78900
374,1622069,15,119000,0,98.0,5923,2023-04-17T01:03,0,119000
375,311052,16,53100,59000,97.0,41362,2023-04-17T01:03,0,53100
376,2320478,17,129000,0,97.0,557,2023-04-17T01:03,0,129000
377,2855992,18,159000,0,97.0,611,2023-04-17T01:03,0,159000
378,810033,19,89100,99000,97.0,34334,2023-04-17T01:03,0,89100
379,1478592,20,75900,95000,97.0,3106,2023-04-17T01:03,0,75900
380,577636,21,99900,139000,95.0,31287,2023-04-17T01:03,0,99900
381,2524840,22,139000,0,97.0,888,2023-04-17T01:03,0,139000
382,3079037,23,195000,0,97.0,293,2023-04-17T01:03,0,195000
383,490135,24,75900,95000,98.0,3411,2023-04-17T01:03,0,75900
384,1231944,25,119000,0,97.0,1374,2023-04-17T01:03,0,119000
385,2785168,26,179000,0,97.0,60,2023-04-17T01:03,0,179000
386,2233180,27,75900,109000,97.0,14315,2023-04-17T01:03,0,75900
387,2161992,28,69900,95000,97.0,3434,2023-04-17T01:03,0,69900
388,1493265,29,85500,95000,98.0,4982,2023-04-17T01:03,0,85500
389,2565212,30,119000,0,99.0,437,2023-04-17T01:03,0,119000
390,2622254,31,109000,0,98.0,958,2023-04-17T01:03,0,109000
391,2670201,32,39900,109000,98.0,941,2023-04-17T01:03,0,39900
392,1900410,33,129000,0,97.0,4951,2023-04-17T01:03,0,129000
393,181907,34,89900,119000,97.0,7195,2023-04-17T01:03,0,89900
394,3024528,35,132050,139000,95.0,113,2023-04-17T01:03,0,132050
395,816033,36,70900,89000,96.0,13404,2023-04-17T01:03,0,70900
396,1594352,37,85000,0,97.0,5612,2023-04-17T01:03,0,85000
397,3091287,38,119000,0,98.0,371,2023-04-17T01:03,0,119000
398,2440110,39,59900,0,97.0,1169,2023-04-17T01:03,-11980,47920
399,3030422,40,139000,0,96.0,908,2023-04-17T01:03,0,139000
400,810032,41,85500,95000,97.0,13802,2023-04-17T01:03,0,85500
401,1608838,42,85000,0,97.0,12671,2023-04-17T01:03,0,85000
402,3033248,43,109000,0,97.0,686,2023-04-17T01:03,0,109000
403,1492897,44,75000,0,96.0,3202,2023-04-17T01:03,0,75000
404,716244,45,69900,95000,98.0,1329,2023-04-17T01:03,0,69900
405,2233178,46,75900,109000,97.0,5006,2023-04-17T01:03,0,75900
406,1354129,47,69000,99000,95.0,8751,2023-04-17T01:03,-13800,55200
407,3200836,48,179000,0,96.0,44,2023-04-17T01:03,0,179000
408,3172975,49,260000,0,96.0,10,2023-04-17T01:03,0,260000
409,186610,50,75900,85000,97.0,16672,2023-04-17T01:03,0,75900
410,2741233,51,109000,0,97.0,2793,2023-04-17T01:03,0,109000
411,311051,52,58500,65000,97.0,19626,2023-04-17T01:03,0,58500
412,3218651,53,149000,0,0.0,0,2023-04-17T01:03,0,149000
413,311050,54,53100,59000,97.0,9101,2023-04-17T01:03,0,53100
414,2777005,55,477000,815000,94.0,34,2023-04-17T01:03,-30000,447000
415,2673444,56,49900,149000,95.0,407,2023-04-17T01:03,0,49900
416,1296778,57,99000,0,98.0,2174,2023-04-17T01:03,0,99000
417,2631192,58,98100,109000,98.0,419,2023-04-17T01:03,0,98100
418,1494180,59,71100,79000,95.0,5292,2023-04-17T01:03,0,71100
419,922322,60,95000,0,95.0,9592,2023-04-17T01:03,0,95000
420,2530875,61,39900,109000,97.0,1653,2023-04-17T01:03,0,39900
421,2229208,62,109000,0,97.0,1634,2023-04-17T01:03,0,109000
422,2909715,63,119000,0,97.0,113,2023-04-17T01:03,0,119000
423,3023097,64,230000,0,98.0,126,2023-04-17T01:03,0,230000
424,2778805,65,99000,0,97.0,1054,2023-04-17T01:03,0,99000
425,2370193,66,333000,720000,96.0,10,2023-04-17T01:03,-30000,303000
426,2786813,67,149000,0,94.0,235,2023-04-17T01:03,0,149000
427,2970197,68,79000,0,98.0,274,2023-04-17T01:03,0,79000
428,3096431,69,139000,0,99.0,65,2023-04-17T01:03,0,139000
429,1296776,70,99000,0,98.0,2970,2023-04-17T01:03,0,99000
430,2670200,71,39900,109000,97.0,1171,2023-04-17T01:03,0,39900
431,3109771,72,133900,149000,98.0,55,2023-04-17T01:03,0,133900
432,2752946,73,69000,109000,98.0,225,2023-04-17T01:03,-13800,55200
433,490134,74,75900,95000,97.0,2064,2023-04-17T01:03,0,75900
434,1473136,75,119900,149000,97.0,10812,2023-04-17T01:03,0,119900
435,1493263,76,89100,99000,98.0,4277,2023-04-17T01:03,0,89100
436,2297397,77,129000,0,96.0,225,2023-04-17T01:03,0,129000
437,1990244,78,129000,0,98.0,1133,2023-04-17T01:03,0,129000
438,1744960,79,119900,149000,97.0,8271,2023-04-17T01:03,0,119900
439,2554105,80,39900,109000,96.0,750,2023-04-17T01:03,0,39900
440,2637672,81,1010000,0,100.0,4,2023-04-17T01:03,-20000,990000
441,1739446,82,109900,129000,97.0,834,2023-04-17T01:03,0,109900
442,2784035,83,445800,743000,90.0,8,2023-04-17T01:03,-30000,415800
443,2267008,84,89100,99000,98.0,534,2023-04-17T01:03,0,89100
444,2801305,85,443000,700000,99.0,201,2023-04-17T01:03,-30000,413000
445,3081253,86,112900,129000,95.0,100,2023-04-17T01:03,0,112900
446,3188621,87,119000,0,0.0,0,2023-04-17T01:03,0,119000
447,2638808,88,139000,0,97.0,765,2023-04-17T01:03,0,139000
448,2312772,89,69900,139800,96.0,1426,2023-04-17T01:03,-13980,55920
449,3172970,90,148000,0,98.0,43,2023-04-17T01:03,0,148000
450,1092992,1,69000,0,97.0,38194,2023-04-17T01:03,0,69000
451,3134606,2,125100,139000,98.0,23,2023-04-17T01:03,-6255,118845
452,3062046,3,78300,87000,97.0,203,2023-04-17T01:03,-3915,74385
453,3134621,4,136800,152000,96.0,21,2023-04-17T01:03,-6840,129960
454,3124961,5,62100,69000,97.0,227,2023-04-17T01:03,-3105,58995
455,3061996,6,88200,98000,98.0,147,2023-04-17T01:03,-4410,83790
456,1720822,7,209000,0,97.0,309,2023-04-17T01:03,0,209000
457,2091749,8,80100,89000,95.0,6313,2023-04-17T01:03,0,80100
458,3161736,9,55300,158000,98.0,233,2023-04-17T01:03,-11060,44240
459,1334438,10,170000,0,96.0,4432,2023-04-17T01:03,0,170000
460,3075621,11,339000,0,98.0,89,2023-04-17T01:03,0,339000
461,2378989,12,159000,0,96.0,32,2023-04-17T01:03,-31800,127200
462,2383245,13,99000,0,98.0,859,2023-04-17T01:03,-19800,79200
463,3223241,14,119000,0,100.0,2,2023-04-17T01:03,0,119000
464,1568047,15,159000,0,95.0,12041,2023-04-17T01:03,-31800,127200
465,1720813,16,149000,0,97.0,495,2023-04-17T01:03,0,149000
466,2816812,17,119900,0,93.0,1558,2023-04-17T01:03,0,119900
467,2993229,18,1457000,2503000,100.0,1,2023-04-17T01:03,-20000,1437000
468,3223186,19,119000,0,0.0,0,2023-04-17T01:03,0,119000
469,3062069,20,71100,79000,97.0,84,2023-04-17T01:03,-3555,67545
470,2432733,21,44900,59000,97.0,2918,2023-04-17T01:03,0,44900
471,2435822,22,99000,0,97.0,275,2023-04-17T01:03,-19800,79200
472,3192443,23,77420,98000,97.0,123,2023-04-17T01:03,-7742,69678
473,3049313,24,57100,64900,97.0,729,2023-04-17T01:03,0,57100
474,1129750,25,69000,0,97.0,3962,2023-04-17T01:03,0,69000
475,2379000,26,159000,0,97.0,118,2023-04-17T01:03,-31800,127200
476,2688345,27,1143000,1360000,98.0,38,2023-04-17T01:03,-20000,1123000
477,1439535,28,49000,0,96.0,16373,2023-04-17T01:03,0,49000
478,1010925,29,170000,0,96.0,2088,2023-04-17T01:03,0,170000
479,2237841,30,195000,0,98.0,66,2023-04-17T01:03,0,195000
480,1724193,31,251900,280000,98.0,1485,2023-04-17T01:03,0,251900
481,2101924,32,99900,0,97.0,1403,2023-04-17T01:03,0,99900
482,2433538,33,84660,102000,96.0,2449,2023-04-17T01:03,0,84660
483,2664373,34,65000,0,96.0,1062,2023-04-17T01:03,0,65000
484,1890398,35,138000,168000,96.0,2766,2023-04-17T01:03,-13800,124200
485,3143034,36,31700,79000,98.0,41,2023-04-17T01:03,-6340,25360
486,1339622,37,42900,59000,97.0,16426,2023-04-17T01:03,0,42900
487,2363570,38,39900,55000,97.0,1110,2023-04-17T01:03,0,39900
488,2889427,39,730000,1190000,97.0,7,2023-04-17T01:03,-20000,710000
489,595040,40,210000,0,95.0,8752,2023-04-17T01:03,0,210000
490,685185,41,148000,198000,95.0,12511,2023-04-17T01:03,-22200,125800
491,1419869,42,70300,74000,95.0,10587,2023-04-17T01:03,-10545,59755
492,1815709,43,138000,168000,96.0,7155,2023-04-17T01:03,-13800,124200
493,2210201,44,268000,299000,94.0,198,2023-04-17T01:03,-13400,254600
494,2940848,45,776000,1190000,100.0,2,2023-04-17T01:03,-20000,756000
495,3132471,46,79000,0,97.0,41,2023-04-17T01:03,0,79000
496,2910082,47,265500,295000,98.0,507,2023-04-17T01:03,0,265500
497,2440524,48,69000,0,97.0,1596,2023-04-17T01:03,0,69000
498,1815692,49,137000,167000,95.0,1000,2023-04-17T01:03,-13700,123300
499,3171846,50,240000,0,0.0,0,2023-04-17T01:03,0,240000
500,2143833,51,89640,108000,96.0,2449,2023-04-17T01:03,0,89640
501,2071613,52,89100,99000,92.0,1511,2023-04-17T01:03,-17820,71280
502,3001901,53,239000,0,95.0,22,2023-04-17T01:03,0,239000
503,1926895,54,44000,108000,93.0,4307,2023-04-17T01:03,-8800,35200
504,1699941,55,75050,79000,97.0,4910,2023-04-17T01:03,-11258,63792
505,2910086,56,265500,295000,98.0,214,2023-04-17T01:03,0,265500
506,2555366,57,697000,1000000,0.0,0,2023-04-17T01:03,-30000,667000
507,1480943,58,89000,0,96.0,355,2023-04-17T01:03,0,89000
508,3138454,59,159000,0,84.0,5,2023-04-17T01:03,-31800,127200
509,2624538,60,40900,59000,97.0,1549,2023-04-17T01:03,0,40900
510,3124959,61,52200,58000,98.0,53,2023-04-17T01:03,-2610,49590
511,2032683,62,210000,0,96.0,182,2023-04-17T01:03,0,210000
512,1262089,63,300000,0,97.0,1594,2023-04-17T01:03,0,300000
513,2355318,64,109900,0,96.0,662,2023-04-17T01:03,0,109900
514,3110456,65,660000,0,0.0,0,2023-04-17T01:03,-20000,640000
515,1730340,66,258000,0,97.0,4242,2023-04-17T01:03,0,258000
516,1952910,67,265500,295000,98.0,1746,2023-04-17T01:03,0,265500
517,2664372,68,65000,0,97.0,1107,2023-04-17T01:03,0,65000
518,2036670,69,300000,0,97.0,774,2023-04-17T01:03,0,300000
519,2518112,70,87150,105000,96.0,993,2023-04-17T01:03,0,87150
520,3142574,71,132300,189000,0.0,0,2023-04-17T01:03,0,132300
521,1891202,72,165000,0,98.0,101,2023-04-17T01:03,0,165000
522,1562988,73,260000,0,97.0,1483,2023-04-17T01:03,0,260000
523,2621831,74,71760,92000,95.0,753,2023-04-17T01:03,-10764,60996
524,1754219,75,31200,39000,96.0,2285,2023-04-17T01:03,0,31200
525,324275,76,59000,0,94.0,12918,2023-04-17T01:03,0,59000
526,607298,77,53600,59000,93.0,15603,2023-04-17T01:03,-8040,45560
527,2039312,78,181300,259000,99.0,43,2023-04-17T01:03,-36260,145040
528,2555608,79,268000,299000,93.0,26,2023-04-17T01:03,-13400,254600
529,1128656,80,86800,99000,95.0,21673,2023-04-17T01:03,0,86800
530,1897197,81,53100,59000,96.0,973,2023-04-17T01:03,0,53100
531,3134563,82,88200,98000,91.0,12,2023-04-17T01:03,-4410,83790
532,668697,83,66400,73800,94.0,8466,2023-04-17T01:03,-9960,56440
533,2816816,84,143890,159900,97.0,1888,2023-04-17T01:03,0,143890
534,1562990,85,230000,0,96.0,1287,2023-04-17T01:03,0,230000
535,2931951,86,383000,1327000,0.0,0,2023-04-17T01:03,-20000,363000
536,2875391,87,161000,606000,96.0,20,2023-04-17T01:03,-16100,144900
537,501198,88,139000,0,95.0,2752,2023-04-17T01:03,0,139000
538,1973858,89,143200,179000,98.0,1206,2023-04-17T01:03,-21480,121720
539,1883696,90,239000,0,97.0,73,2023-04-17T01:03,0,239000
540,2356713,1,39000,0,97.0,1506,2023-04-17T01:03,-5850,33150
541,2134140,2,39000,0,97.0,3628,2023-04-17T01:03,-5850,33150
542,1214164,3,36000,0,96.0,25046,2023-04-17T01:03,0,36000
543,1920929,4,39000,0,97.0,4032,2023-04-17T01:03,-5850,33150
544,1822717,5,56050,59000,97.0,4356,2023-04-17T01:03,0,56050
545,2356711,6,39000,0,98.0,1521,2023-04-17T01:03,-5850,33150
546,2280117,7,35100,39000,97.0,6433,2023-04-17T01:03,0,35100
547,2134158,8,39000,0,97.0,2545,2023-04-17T01:03,-5850,33150
548,1214109,9,36000,0,97.0,8180,2023-04-17T01:03,0,36000
549,1214174,10,36000,0,97.0,15097,2023-04-17T01:03,0,36000
550,2879419,11,48900,55000,98.0,796,2023-04-17T01:03,-7335,41565
551,2356693,12,39000,0,97.0,1550,2023-04-17T01:03,-5850,33150
552,2028240,13,39000,0,98.0,3367,2023-04-17T01:03,-5850,33150
553,1272626,14,36000,0,96.0,14205,2023-04-17T01:03,0,36000
554,1022013,15,79000,0,96.0,6289,2023-04-17T01:03,0,79000
555,1022014,16,79000,0,96.0,11472,2023-04-17T01:03,0,79000
556,1771137,17,26100,29000,97.0,12635,2023-04-17T01:03,0,26100
557,1214173,18,36000,0,96.0,5600,2023-04-17T01:03,0,36000
558,2879425,19,48900,55000,97.0,334,2023-04-17T01:03,-7335,41565
559,3012243,20,29900,39900,98.0,73,2023-04-17T01:03,-4485,25415
560,1524720,21,36000,0,96.0,3406,2023-04-17T01:03,0,36000
561,1855444,22,39900,42000,97.0,3053,2023-04-17T01:03,-5985,33915
562,1771132,23,26100,29000,96.0,5313,2023-04-17T01:03,0,26100
563,2859190,24,37000,0,96.0,469,2023-04-17T01:03,-5550,31450
564,2286829,25,37000,0,95.0,5043,2023-04-17T01:03,-5550,31450
565,1214169,26,36000,0,97.0,5361,2023-04-17T01:03,0,36000
566,2107999,27,36000,0,97.0,2701,2023-04-17T01:03,0,36000
567,1771133,28,26100,29000,97.0,5743,2023-04-17T01:03,0,26100
568,3225733,29,49000,0,100.0,3,2023-04-17T01:03,0,49000
569,2287131,30,37000,0,95.0,1710,2023-04-17T01:03,-5550,31450
570,2123132,31,39000,0,97.0,6451,2023-04-17T01:03,-3900,35100
571,1214317,32,36000,0,97.0,11525,2023-04-17T01:03,0,36000
572,2507080,33,39000,0,98.0,425,2023-04-17T01:03,-5850,33150
573,1214316,34,36000,0,97.0,2004,2023-04-17T01:03,0,36000
574,2687157,35,45000,0,97.0,1078,2023-04-17T01:03,-6750,38250
575,1925814,36,35100,39000,96.0,1692,2023-04-17T01:03,0,35100
576,2329375,37,34710,39000,96.0,2119,2023-04-17T01:03,-3471,31239
577,3038180,38,46000,0,98.0,143,2023-04-17T01:03,-4370,41630
578,2280146,39,35100,39000,97.0,948,2023-04-17T01:03,0,35100
579,1452917,40,69000,0,96.0,2428,2023-04-17T01:03,0,69000
580,1335132,41,29000,0,95.0,1127,2023-04-17T01:03,0,29000
581,1214106,42,36000,0,96.0,9767,2023-04-17T01:03,0,36000
582,2672186,43,20900,30000,96.0,617,2023-04-17T01:03,-2299,18601
583,1022012,44,79000,0,94.0,2799,2023-04-17T01:03,0,79000
584,2089719,45,36000,0,97.0,2433,2023-04-17T01:03,0,36000
585,2560668,46,58650,69000,97.0,1265,2023-04-17T01:03,0,58650
586,1907733,47,29900,39000,96.0,3882,2023-04-17T01:03,0,29900
587,2879417,48,48900,55000,98.0,219,2023-04-17T01:03,-7335,41565
588,2221221,49,35100,39000,96.0,1896,2023-04-17T01:03,0,35100
589,1939301,50,39000,0,97.0,822,2023-04-17T01:03,-5850,33150
590,2650964,51,48900,53000,98.0,200,2023-04-17T01:03,-7335,41565
591,2573131,52,39900,42000,98.0,717,2023-04-17T01:03,-5985,33915
592,2864918,53,49000,0,99.0,148,2023-04-17T01:03,0,49000
593,2134295,54,39000,0,97.0,424,2023-04-17T01:03,0,39000
594,1214171,55,36000,0,97.0,1726,2023-04-17T01:03,0,36000
595,2998516,56,29000,0,96.0,175,2023-04-17T01:03,0,29000
596,1214193,57,39000,0,97.0,15377,2023-04-17T01:03,0,39000
597,2164773,58,69000,0,97.0,523,2023-04-17T01:03,0,69000
598,2683883,59,69000,0,97.0,135,2023-04-17T01:03,0,69000
599,2356714,60,39000,0,97.0,486,2023-04-17T01:03,-5850,33150
600,2690211,61,371000,600000,100.0,2,2023-04-17T01:03,-30000,341000
601,3039055,62,43000,0,95.0,50,2023-04-17T01:03,-6450,36550
602,2812150,63,144000,238000,96.0,13,2023-04-17T01:03,-14400,129600
603,3087776,64,33900,39000,96.0,16,2023-04-17T01:03,0,33900
604,3039061,65,39000,0,95.0,40,2023-04-17T01:03,-5850,33150
605,2591291,66,39200,49000,97.0,1039,2023-04-17T01:03,0,39200
606,2287158,67,37000,0,95.0,1248,2023-04-17T01:03,-5550,31450
607,2381807,68,58650,69000,98.0,1158,2023-04-17T01:03,0,58650
608,2051581,69,33000,0,96.0,876,2023-04-17T01:03,0,33000
609,1907732,70,27900,39000,95.0,808,2023-04-17T01:03,0,27900
610,2699678,71,36000,0,98.0,271,2023-04-17T01:03,0,36000
611,2707659,72,42000,0,97.0,540,2023-04-17T01:03,0,42000
612,1906772,73,39900,42000,97.0,3096,2023-04-17T01:03,-5985,33915
613,1920840,74,39000,0,98.0,1386,2023-04-17T01:03,-5850,33150
614,1063518,75,79000,0,96.0,958,2023-04-17T01:03,0,79000
615,1771121,76,26100,29000,96.0,2296,2023-04-17T01:03,0,26100
616,2962388,77,31200,39000,96.0,136,2023-04-17T01:03,0,31200
617,1632175,78,39000,0,97.0,2723,2023-04-17T01:03,-3900,35100
618,1906773,79,39900,42000,97.0,671,2023-04-17T01:03,-5985,33915
619,2053753,80,42000,0,98.0,4156,2023-04-17T01:03,-6300,35700
620,1497550,81,29600,37000,95.0,5716,2023-04-17T01:03,0,29600
621,2879422,82,48900,55000,97.0,33,2023-04-17T01:03,-7335,41565
622,2650965,83,48900,53000,98.0,389,2023-04-17T01:03,-7335,41565
623,2356668,84,39000,0,98.0,287,2023-04-17T01:03,-5850,33150
624,3099126,85,54000,0,100.0,9,2023-04-17T01:03,0,54000
625,1760824,86,49700,59000,97.0,322,2023-04-17T01:03,0,49700
626,1755276,87,49000,0,97.0,2424,2023-04-17T01:03,0,49000
627,1086824,88,29600,37000,95.0,18647,2023-04-17T01:03,0,29600
628,2280141,89,35100,39000,96.0,1133,2023-04-17T01:03,0,35100
629,2531210,90,26300,35000,97.0,662,2023-04-17T01:03,-3945,22355
630,3059119,1,161100,179000,91.0,26,2023-04-17T01:03,-28998,132102
631,3031171,2,68000,0,98.0,58,2023-04-17T01:03,0,68000
632,3073259,3,196200,218000,100.0,5,2023-04-17T01:03,-35316,160884
633,2153636,4,173600,248000,98.0,31,2023-04-17T01:03,0,173600
634,2457512,5,237300,339000,98.0,37,2023-04-17T01:03,0,237300
635,2605850,6,94000,0,97.0,171,2023-04-17T01:03,0,94000
636,3106487,7,133200,148000,99.0,29,2023-04-17T01:03,0,133200
637,2798634,8,616000,1470000,0.0,0,2023-04-17T01:03,-20000,596000
638,1779568,9,54400,64000,95.0,294,2023-04-17T01:03,-10880,43520
639,2478652,10,56500,68000,94.0,336,2023-04-17T01:03,-11300,45200
640,2827957,11,568100,1579000,100.0,2,2023-04-17T01:03,-30000,538100
641,2371579,12,540500,1170000,100.0,1,2023-04-17T01:03,-30000,510500
642,3190614,13,348000,498000,0.0,0,2023-04-17T01:03,-62640,285360
643,2388209,14,94000,0,96.0,158,2023-04-17T01:03,0,94000
644,3215687,15,342000,0,0.0,0,2023-04-17T01:03,0,342000
645,3190603,16,292000,418000,0.0,0,2023-04-17T01:03,-52560,239440
646,2933270,17,130800,218000,100.0,1,2023-04-17T01:03,-26160,104640
647,3225126,18,129000,0,0.0,0,2023-04-17T01:03,-19350,109650
648,2512635,19,35400,59000,96.0,220,2023-04-17T01:03,0,35400
649,3196948,20,129000,0,100.0,3,2023-04-17T01:03,0,129000
650,2956708,21,289000,0,0.0,0,2023-04-17T01:03,0,289000
651,2943600,22,280800,468000,0.0,0,2023-04-17T01:03,0,280800
652,2933268,23,130800,218000,0.0,0,2023-04-17T01:03,-26160,104640
653,3125342,24,319000,0,0.0,0,2023-04-17T01:03,0,319000
654,3074707,25,119000,0,100.0,4,2023-04-17T01:03,0,119000
655,3134492,26,71100,79000,96.0,6,2023-04-17T01:03,0,71100
656,3050173,27,166600,238000,100.0,4,2023-04-17T01:03,0,166600
657,3203077,28,168000,0,0.0,0,2023-04-17T01:03,-25200,142800
658,3068167,29,119000,0,100.0,1,2023-04-17T01:03,0,119000
659,3205817,30,229900,242000,0.0,0,2023-04-17T01:03,-34485,195415
660,2489894,31,150100,158000,98.0,109,2023-04-17T01:03,0,150100
661,3030948,32,68000,0,99.0,37,2023-04-17T01:03,0,68000
662,3213350,33,94050,99000,0.0,0,2023-04-17T01:03,-18810,75240
663,3171883,34,149000,0,100.0,3,2023-04-17T01:03,0,149000
664,3082471,35,151200,189000,100.0,3,2023-04-17T01:03,0,151200
665,2393504,36,94000,0,99.0,54,2023-04-17T01:03,0,94000
666,2756408,37,218500,230000,90.0,2,2023-04-17T01:03,0,218500
667,3041848,38,168000,0,0.0,0,2023-04-17T01:03,0,168000
668,3174221,39,188100,209000,0.0,0,2023-04-17T01:03,-33858,154242
669,3171882,40,149000,0,100.0,2,2023-04-17T01:03,0,149000
670,3041837,41,168000,0,0.0,0,2023-04-17T01:03,0,168000
671,3096975,42,199000,0,0.0,0,2023-04-17T01:03,0,199000
672,1779566,43,54400,64000,94.0,52,2023-04-17T01:03,-10880,43520
673,3196932,44,159000,0,0.0,0,2023-04-17T01:03,0,159000
674,2621814,45,208000,0,0.0,0,2023-04-17T01:03,0,208000
675,3205629,46,186000,219000,0.0,0,2023-04-17T01:03,0,186000
676,2742939,47,189000,0,100.0,2,2023-04-17T01:03,0,189000
677,3124599,48,198000,0,0.0,0,2023-04-17T01:03,-29700,168300
678,3146734,49,188100,209000,0.0,0,2023-04-17T01:03,-33858,154242
679,987352,50,49000,59000,93.0,590,2023-04-17T01:03,-7350,41650
680,3083239,51,143100,159000,0.0,0,2023-04-17T01:03,-28620,114480
681,3092024,52,228000,0,0.0,0,2023-04-17T01:03,0,228000
682,3187364,53,59900,0,0.0,0,2023-04-17T01:03,-8985,50915
683,3131557,54,104000,0,0.0,0,2023-04-17T01:03,0,104000
684,3232210,55,179000,219000,0.0,0,2023-04-17T01:03,0,179000
685,3146767,56,161100,179000,0.0,0,2023-04-17T01:03,-28998,132102
686,3174225,57,161100,179000,0.0,0,2023-04-17T01:03,-28998,132102
687,3221668,58,87000,0,0.0,0,2023-04-17T01:03,0,87000
688,3174230,59,161100,179000,0.0,0,2023-04-17T01:03,-28998,132102
689,2963911,60,158400,198000,0.0,0,2023-04-17T01:03,-23760,134640
690,3055337,61,159000,0,100.0,1,2023-04-17T01:03,0,159000
691,3138202,62,139500,155000,0.0,0,2023-04-17T01:03,-6975,132525
692,2799334,63,159600,228000,0.0,0,2023-04-17T01:03,0,159600
693,2585187,64,148000,0,95.0,13,2023-04-17T01:03,0,148000
694,2717734,65,79000,0,97.0,59,2023-04-17T01:03,0,79000
695,3099416,66,44910,49900,100.0,3,2023-04-17T01:03,0,44910
696,2620217,67,159600,228000,97.0,7,2023-04-17T01:03,0,159600
697,3155822,68,161100,179000,0.0,0,2023-04-17T01:03,0,161100
698,3066926,69,94400,118000,100.0,2,2023-04-17T01:03,-18880,75520
699,1487154,70,89100,99000,96.0,6,2023-04-17T01:03,0,89100
700,2212062,71,158000,0,0.0,0,2023-04-17T01:03,0,158000
701,3206552,72,106400,112000,0.0,0,2023-04-17T01:03,0,106400
702,1579103,73,126400,158000,96.0,101,2023-04-17T01:03,-18960,107440
703,3223214,74,129000,0,0.0,0,2023-04-17T01:03,0,129000
704,3192300,75,129000,0,0.0,0,2023-04-17T01:03,0,129000
705,2578828,76,144500,170000,0.0,0,2023-04-17T01:03,0,144500
706,3196289,77,128800,159000,0.0,0,2023-04-17T01:03,0,128800
707,1341924,78,98800,152000,96.0,84,2023-04-17T01:03,-14820,83980
708,3150257,79,116100,129000,100.0,1,2023-04-17T01:03,0,116100
709,3133067,80,113000,0,100.0,1,2023-04-17T01:03,0,113000
710,1622447,81,59000,69000,90.0,186,2023-04-17T01:03,-11800,47200
711,3182232,82,132000,0,0.0,0,2023-04-17T01:03,0,132000
712,2388775,83,124000,0,100.0,2,2023-04-17T01:03,0,124000
713,2590042,84,129000,0,100.0,1,2023-04-17T01:03,0,129000
714,2583233,85,125600,157000,100.0,3,2023-04-17T01:03,-22608,102992
715,3062910,86,122400,136000,0.0,0,2023-04-17T01:03,0,122400
716,2877419,87,71100,79000,0.0,0,2023-04-17T01:03,-3555,67545
717,3133164,88,113000,0,0.0,0,2023-04-17T01:03,0,113000
718,3059069,89,116100,129000,100.0,2,2023-04-17T01:03,-20898,95202
719,2755207,90,125300,179000,0.0,0,2023-04-17T01:03,-18795,106505
720,2978105,1,49900,0,97.0,18,2023-04-17T01:03,-4990,44910
721,3040758,2,82000,111000,94.0,14,2023-04-17T01:03,-16400,65600
722,3040745,3,88000,110000,94.0,17,2023-04-17T01:03,-17600,70400
723,2864414,4,69300,99000,95.0,98,2023-04-17T01:03,-10395,58905
724,2978106,5,49900,0,100.0,4,2023-04-17T01:03,-4990,44910
725,3083216,6,133200,148000,100.0,1,2023-04-17T01:03,-26640,106560
726,2377814,7,198000,0,96.0,78,2023-04-17T01:03,-32076,165924
727,3049781,8,76000,95000,100.0,2,2023-04-17T01:03,-15200,60800
728,2535468,9,202800,338000,100.0,6,2023-04-17T01:03,-26364,176436
729,3212855,10,378000,0,0.0,0,2023-04-17T01:03,-68040,309960
730,2377805,11,198000,0,94.0,22,2023-04-17T01:03,-32076,165924
731,2377804,12,198000,0,93.0,38,2023-04-17T01:03,-32076,165924
732,3212866,13,358000,0,0.0,0,2023-04-17T01:03,-64440,293560
733,2771725,14,166600,238000,94.0,15,2023-04-17T01:03,-29988,136612
734,3118979,15,318000,0,100.0,1,2023-04-17T01:03,-57240,260760
735,3212799,16,338000,0,0.0,0,2023-04-17T01:03,-60840,277160
736,1788995,17,55500,65000,94.0,565,2023-04-17T01:03,-11100,44400
737,3073254,18,160200,178000,93.0,9,2023-04-17T01:03,-28836,131364
738,2891916,19,379000,0,84.0,5,2023-04-17T01:03,0,379000
739,3000422,20,59000,0,96.0,40,2023-04-17T01:03,0,59000
740,2830808,21,139000,0,97.0,15,2023-04-17T01:03,0,139000
741,3058718,22,86400,96000,92.0,19,2023-04-17T01:03,-15552,70848
742,3034043,23,148000,0,100.0,1,2023-04-17T01:03,0,148000
743,3088716,24,290000,0,0.0,0,2023-04-17T01:03,-52200,237800
744,1645760,25,43900,0,96.0,347,2023-04-17T01:03,0,43900
745,3135305,26,49500,55000,100.0,2,2023-04-17T01:03,-7425,42075
746,2816861,27,319000,0,0.0,0,2023-04-17T01:03,0,319000
747,2755918,28,119000,0,100.0,2,2023-04-17T01:03,0,119000
748,2352881,29,39950,79900,98.0,312,2023-04-17T01:03,0,39950
749,2551400,30,39900,0,93.0,146,2023-04-17T01:03,0,39900
750,2408970,31,268000,0,0.0,0,2023-04-17T01:03,0,268000
751,3144417,32,71100,79000,0.0,0,2023-04-17T01:03,0,71100
752,2378594,33,88200,98000,95.0,131,2023-04-17T01:03,0,88200
753,2643318,34,124000,138000,94.0,17,2023-04-17T01:03,-22320,101680
754,3190568,35,278000,398000,0.0,0,2023-04-17T01:03,-50040,227960
755,2933318,36,82800,138000,98.0,12,2023-04-17T01:03,-16560,66240
756,3038047,37,113050,119000,100.0,3,2023-04-17T01:03,0,113050
757,2551401,38,37900,0,94.0,329,2023-04-17T01:03,0,37900
758,2867750,39,135000,0,96.0,48,2023-04-17T01:03,0,135000
759,3116912,40,238000,0,0.0,0,2023-04-17T01:03,0,238000
760,1944554,41,31290,36900,96.0,552,2023-04-17T01:03,0,31290
761,3118298,42,235000,0,0.0,0,2023-04-17T01:03,-42300,192700
762,2377812,43,198000,0,96.0,59,2023-04-17T01:03,-33858,164142
763,2942784,44,189000,0,100.0,3,2023-04-17T01:03,0,189000
764,3030882,45,218000,0,100.0,1,2023-04-17T01:03,-39240,178760
765,3047742,46,75050,79000,94.0,7,2023-04-17T01:03,-15010,60040
766,3174796,47,223200,248000,0.0,0,2023-04-17T01:03,-40176,183024
767,3031104,48,55200,69000,98.0,70,2023-04-17T01:03,-8280,46920
768,2836351,49,49680,72000,96.0,479,2023-04-17T01:03,-7452,42228
769,2551407,50,37900,0,97.0,187,2023-04-17T01:03,0,37900
770,2942764,51,189000,0,98.0,14,2023-04-17T01:03,0,189000
771,3105350,52,48800,65000,97.0,9,2023-04-17T01:03,-7320,41480
772,3117200,53,208600,298000,0.0,0,2023-04-17T01:03,-37548,171052
773,3047737,54,75050,79000,100.0,3,2023-04-17T01:03,-15010,60040
774,3123809,55,206100,229000,0.0,0,2023-04-17T01:03,-37098,169002
775,2836289,56,39530,59000,95.0,221,2023-04-17T01:03,-5930,33600
776,2503707,57,93100,98000,96.0,51,2023-04-17T01:03,0,93100
777,2378593,58,88200,98000,94.0,70,2023-04-17T01:03,0,88200
778,3098636,59,179550,189000,0.0,0,2023-04-17T01:03,-32319,147231
779,2561845,60,178000,0,0.0,0,2023-04-17T01:03,-32040,145960
780,2063992,61,179400,299000,86.0,3,2023-04-17T01:03,-32292,147108
781,3133264,62,159000,0,0.0,0,2023-04-17T01:03,0,159000
782,3105866,63,89000,0,95.0,4,2023-04-17T01:03,-13350,75650
783,3081769,64,169000,0,0.0,0,2023-04-17T01:03,0,169000
784,2448900,65,43900,0,95.0,101,2023-04-17T01:03,0,43900
785,3120581,66,152100,169000,100.0,5,2023-04-17T01:03,-27378,124722
786,2716661,67,168000,0,80.0,2,2023-04-17T01:03,0,168000
787,3107292,68,152100,169000,0.0,0,2023-04-17T01:03,-27378,124722
788,2967094,69,93000,0,96.0,25,2023-04-17T01:03,-13950,79050
789,3119544,70,168300,198000,0.0,0,2023-04-17T01:03,0,168300
790,2571642,71,149000,0,92.0,14,2023-04-17T01:03,0,149000
791,2738716,72,151200,168000,94.0,28,2023-04-17T01:03,0,151200
792,2373068,73,98100,109000,91.0,58,2023-04-17T01:03,-14715,83385
793,3049779,74,76000,95000,0.0,0,2023-04-17T01:03,-15200,60800
794,2882570,75,164000,249000,0.0,0,2023-04-17T01:03,-29520,134480
795,3120598,76,152100,169000,100.0,1,2023-04-17T01:03,-27378,124722
796,3098755,77,153000,0,0.0,0,2023-04-17T01:03,-27540,125460
797,3144257,78,82000,0,100.0,1,2023-04-17T01:03,-12300,69700
798,3076579,79,159000,218000,0.0,0,2023-04-17T01:03,-28620,130380
799,3107287,80,152100,169000,0.0,0,2023-04-17T01:03,-27378,124722
800,2571681,81,149000,0,86.0,9,2023-04-17T01:03,0,149000
801,3083215,82,140400,156000,100.0,3,2023-04-17T01:03,-28080,112320
802,3215982,83,152100,169000,0.0,0,2023-04-17T01:03,-27378,124722
803,3071050,84,93100,98000,98.0,12,2023-04-17T01:03,0,93100
804,2297473,85,155400,259000,100.0,3,2023-04-17T01:03,0,155400
805,1931894,86,37900,0,95.0,525,2023-04-17T01:03,0,37900
806,3062946,87,124200,138000,100.0,8,2023-04-17T01:03,0,124200
807,3111562,88,79200,99000,100.0,5,2023-04-17T01:03,-15840,63360
808,2259157,89,37290,43900,94.0,40,2023-04-17T01:03,0,37290
809,1324370,90,148000,0,100.0,3,2023-04-17T01:03,0,148000
810,991339,1,17890,19900,97.0,53218,2023-04-17T01:03,0,17890
811,998051,2,15900,24000,97.0,163907,2023-04-17T01:03,0,15900
812,1986031,3,24990,27900,97.0,10780,2023-04-17T01:03,0,24990
813,991340,4,17890,19900,97.0,31004,2023-04-17T01:03,0,17890
814,763821,5,16900,22000,96.0,31480,2023-04-17T01:03,0,16900
815,1094748,6,19900,0,97.0,19250,2023-04-17T01:03,0,19900
816,1094835,7,14290,15900,97.0,6262,2023-04-17T01:03,0,14290
817,1477845,8,15400,22000,96.0,9783,2023-04-17T01:03,0,15400
818,1996702,9,23690,27900,97.0,1960,2023-04-17T01:03,0,23690
819,3033249,10,15000,0,96.0,254,2023-04-17T01:03,0,15000
820,2845854,11,13200,18900,97.0,260,2023-04-17T01:03,-2640,10560
821,1986029,12,27900,0,97.0,3981,2023-04-17T01:03,0,27900
822,1342874,13,16900,33000,97.0,12970,2023-04-17T01:03,0,16900
823,792919,14,15190,16900,96.0,17976,2023-04-17T01:03,0,15190
824,991570,15,12900,20000,97.0,19134,2023-04-17T01:03,0,12900
825,1443937,16,12900,24000,97.0,8121,2023-04-17T01:03,0,12900
826,1821485,17,30000,0,96.0,1284,2023-04-17T01:03,0,30000
827,734085,18,13900,19800,96.0,65022,2023-04-17T01:03,0,13900
828,746158,19,22900,0,96.0,20554,2023-04-17T01:03,0,22900
829,1986030,20,23690,27900,97.0,1686,2023-04-17T01:03,0,23690
830,479245,21,15400,22000,93.0,5431,2023-04-17T01:03,0,15400
831,991341,22,16890,19900,96.0,10263,2023-04-17T01:03,0,16890
832,1729576,23,9900,13900,97.0,16242,2023-04-17T01:03,-1485,8415
833,2011852,24,21490,23900,97.0,1319,2023-04-17T01:03,0,21490
834,746154,25,17900,0,96.0,5201,2023-04-17T01:03,0,17900
835,1996705,26,23690,27900,98.0,2718,2023-04-17T01:03,0,23690
836,2832613,27,11900,33000,97.0,743,2023-04-17T01:03,0,11900
837,2960555,28,19000,0,93.0,123,2023-04-17T01:03,0,19000
838,2821598,29,19390,22900,97.0,156,2023-04-17T01:03,0,19390
839,792920,30,15190,16900,96.0,9680,2023-04-17T01:03,0,15190
840,2973952,31,28800,48000,95.0,16,2023-04-17T01:03,-5184,23616
841,2295818,32,19900,22000,95.0,192,2023-04-17T01:03,0,19900
842,1346009,33,9900,12000,97.0,6736,2023-04-17T01:03,-1485,8415
843,2297277,34,19900,22000,95.0,312,2023-04-17T01:03,0,19900
844,1358721,35,14900,22000,96.0,1149,2023-04-17T01:03,-2235,12665
845,3083314,36,34200,38000,93.0,6,2023-04-17T01:03,-6840,27360
846,2347097,37,14900,24000,97.0,1602,2023-04-17T01:03,-2235,12665
847,1094750,38,16890,19900,97.0,3567,2023-04-17T01:03,0,16890
848,1475055,39,16900,22000,96.0,1179,2023-04-17T01:03,-2535,14365
849,1094749,40,19900,0,96.0,4971,2023-04-17T01:03,0,19900
850,2798430,41,29000,0,97.0,46,2023-04-17T01:03,0,29000
851,1260388,42,20900,0,95.0,690,2023-04-17T01:03,0,20900
852,3220488,43,18000,0,86.0,3,2023-04-17T01:03,0,18000
853,1348077,44,10900,16500,97.0,1876,2023-04-17T01:03,0,10900
854,2342849,45,15120,18900,91.0,125,2023-04-17T01:03,0,15120
855,1996704,46,22290,27900,97.0,720,2023-04-17T01:03,0,22290
856,3027137,47,25900,0,94.0,20,2023-04-17T01:03,0,25900
857,746159,48,22900,0,95.0,28750,2023-04-17T01:03,0,22900
858,792921,49,15190,16900,95.0,7812,2023-04-17T01:03,0,15190
859,3009680,50,12590,14900,98.0,132,2023-04-17T01:03,0,12590
860,1260384,51,19900,0,95.0,1806,2023-04-17T01:03,0,19900
861,2993584,52,18900,27000,90.0,2,2023-04-17T01:03,-3402,15498
862,1477846,53,15400,22000,96.0,2687,2023-04-17T01:03,0,15400
863,1387502,54,12690,15900,95.0,518,2023-04-17T01:03,0,12690
864,2477852,55,17890,19900,98.0,692,2023-04-17T01:03,0,17890
865,2929635,56,16800,27000,97.0,555,2023-04-17T01:03,-2520,14280
866,2584266,57,9900,12000,98.0,413,2023-04-17T01:03,-1485,8415
867,2610916,58,17000,0,97.0,116,2023-04-17T01:03,-3060,13940
868,2011851,59,21490,23900,98.0,680,2023-04-17T01:03,0,21490
869,472686,60,9900,14800,94.0,749,2023-04-17T01:03,0,9900
870,2605934,61,16900,25000,98.0,250,2023-04-17T01:03,-2535,14365
871,1094836,62,14290,15900,97.0,1328,2023-04-17T01:03,0,14290
872,2821599,63,22900,0,97.0,123,2023-04-17T01:03,0,22900
873,1974077,64,42090,46900,97.0,908,2023-04-17T01:03,0,42090
874,3047676,65,14250,15000,96.0,26,2023-04-17T01:03,-2850,11400
875,1360044,66,19900,0,97.0,1764,2023-04-17T01:03,0,19900
876,1556774,67,15200,16000,97.0,476,2023-04-17T01:03,0,15200
877,1121544,68,15190,16900,96.0,869,2023-04-17T01:03,0,15190
878,3083312,69,34200,38000,100.0,2,2023-04-17T01:03,-6840,27360
879,2973095,70,20000,25000,98.0,31,2023-04-17T01:03,0,20000
880,1094837,71,13490,15900,96.0,1765,2023-04-17T01:03,0,13490
881,752821,72,9900,0,94.0,23841,2023-04-17T01:03,0,9900
882,2255476,73,15200,19000,98.0,165,2023-04-17T01:03,-2280,12920
883,1346070,74,9900,12000,97.0,1894,2023-04-17T01:03,-1485,8415
884,1777081,75,8000,12800,96.0,1244,2023-04-17T01:03,0,8000
885,2821595,76,19890,24900,95.0,54,2023-04-17T01:03,0,19890
886,2293399,77,19900,22000,95.0,635,2023-04-17T01:03,0,19900
887,1392773,78,16890,19900,95.0,1477,2023-04-17T01:03,0,16890
888,1547562,79,15400,22000,95.0,1372,2023-04-17T01:03,0,15400
889,958997,80,16090,17900,95.0,1419,2023-04-17T01:03,0,16090
890,2477854,81,17890,19900,98.0,1477,2023-04-17T01:03,0,17890
891,1724176,82,15900,22800,98.0,340,2023-04-17T01:03,-2385,13515
892,1286366,83,11900,24000,97.0,9835,2023-04-17T01:03,0,11900
893,2990345,84,27900,0,98.0,53,2023-04-17T01:03,0,27900
894,3129048,85,19000,0,100.0,11,2023-04-17T01:03,-1900,17100
895,2006930,86,9900,10900,97.0,421,2023-04-17T01:03,-1485,8415
896,1776501,87,15000,20000,95.0,129,2023-04-17T01:03,-2250,12750
897,3163609,88,30000,0,0.0,0,2023-04-17T01:03,0,30000
898,2122868,89,9900,13900,97.0,3918,2023-04-17T01:03,-1485,8415
899,1466645,90,14900,21000,96.0,687,2023-04-17T01:03,-2235,12665
