,item_id,rank,price,del_price,rating,rating_count,time,coupon,real_price
0,1848166,1,44100,49000,97.0,40989,2023-04-05T23:43,0,44100
1,2272830,2,35910,39900,97.0,19146,2023-04-05T23:43,-3591,32319
2,3187851,3,49900,110000,99.0,27,2023-04-05T23:43,0,49900
3,2479911,4,49400,76000,97.0,4181,2023-04-05T23:43,0,49400
4,2646350,5,59800,94000,95.0,4098,2023-04-05T23:43,-5980,53820
5,345889,6,29900,47900,95.0,9743,2023-04-05T23:43,0,29900
6,2086653,7,16900,0,97.0,39385,2023-04-05T23:43,0,16900
7,3154713,8,49500,66000,0.0,0,2023-04-05T23:43,-4950,44550
8,2034137,9,31800,0,97.0,17021,2023-04-05T23:43,-4770,27030
9,2442409,10,39000,78000,96.0,8874,2023-04-05T23:43,-3900,35100
10,2377269,11,38250,45000,97.0,3879,2023-04-05T23:43,0,38250
11,2149254,12,37800,0,97.0,33125,2023-04-05T23:43,-5670,32130
12,1828538,13,39900,69900,95.0,2920,2023-04-05T23:43,0,39900
13,2122566,14,33800,0,97.0,15878,2023-04-05T23:43,-6760,27040
14,1921901,15,36900,70500,96.0,7552,2023-04-05T23:43,0,36900
15,1763157,16,49400,52000,95.0,2630,2023-04-05T23:43,0,49400
16,3154715,17,49500,66000,0.0,0,2023-04-05T23:43,-4950,44550
17,3180166,18,31200,39000,0.0,0,2023-04-05T23:43,0,31200
18,1943792,19,34400,43000,96.0,5334,2023-04-05T23:43,0,34400
19,2364807,20,219000,0,96.0,699,2023-04-05T23:43,0,219000
20,2996252,21,67900,117000,100.0,3,2023-04-05T23:43,0,67900
21,1706633,22,199000,0,97.0,2389,2023-04-05T23:43,0,199000
22,1420730,23,35000,58000,95.0,35956,2023-04-05T23:43,-7000,28000
23,1939099,24,34300,49000,97.0,11725,2023-04-05T23:43,0,34300
24,2996536,25,39900,59000,96.0,490,2023-04-05T23:43,-7980,31920
25,3154714,26,49500,66000,0.0,0,2023-04-05T23:43,-4950,44550
26,1884943,27,29900,39000,96.0,18876,2023-04-05T23:43,0,29900
27,1005680,28,17500,35000,95.0,9070,2023-04-05T23:43,0,17500
28,1817394,29,59900,150000,93.0,7174,2023-04-05T23:43,0,59900
29,2409397,30,31500,45000,97.0,2737,2023-04-05T23:43,-3150,28350
30,994588,31,39900,53000,93.0,6010,2023-04-05T23:43,-3990,35910
31,1944612,32,35800,59700,97.0,2856,2023-04-05T23:43,0,35800
32,996177,33,15900,0,95.0,77504,2023-04-05T23:43,0,15900
33,2313388,34,76500,85000,96.0,2114,2023-04-05T23:43,0,76500
34,2038497,35,36000,45000,95.0,16277,2023-04-05T23:43,-3600,32400
35,2065708,36,59000,62000,98.0,6568,2023-04-05T23:43,-8850,50150
36,2376229,37,36000,0,97.0,3830,2023-04-05T23:43,0,36000
37,2403601,38,32500,50000,96.0,2203,2023-04-05T23:43,0,32500
38,2314616,39,39000,43000,97.0,8243,2023-04-05T23:43,0,39000
39,3154716,40,49500,66000,0.0,0,2023-04-05T23:43,-4950,44550
40,2708999,41,49800,62500,96.0,636,2023-04-05T23:43,-4980,44820
41,1763164,42,49400,52000,96.0,2377,2023-04-05T23:43,0,49400
42,1498103,43,199000,0,96.0,858,2023-04-05T23:43,0,199000
43,1763123,44,84550,89000,96.0,1663,2023-04-05T23:43,-4228,80322
44,1336398,45,40200,67000,96.0,19054,2023-04-05T23:43,0,40200
45,1498105,46,189000,0,97.0,1989,2023-04-05T23:43,0,189000
46,2396645,47,39900,59000,96.0,23430,2023-04-05T23:43,-7980,31920
47,1911516,48,48900,81900,95.0,6167,2023-04-05T23:43,0,48900
48,3034895,49,101150,119000,98.0,358,2023-04-05T23:43,0,101150
49,1582356,50,49200,82000,96.0,16112,2023-04-05T23:43,0,49200
50,2375962,51,59000,62000,98.0,5396,2023-04-05T23:43,-8850,50150
51,2368712,52,38700,43000,97.0,5570,2023-04-05T23:43,-1935,36765
52,2392759,53,39900,49600,95.0,3993,2023-04-05T23:43,-3990,35910
53,2687911,54,65600,73000,96.0,135,2023-04-05T23:43,-6560,59040
54,2453556,55,39900,42000,97.0,6258,2023-04-05T23:43,0,39900
55,1706634,56,199000,0,97.0,1538,2023-04-05T23:43,0,199000
56,854337,57,33900,0,95.0,17301,2023-04-05T23:43,0,33900
57,3064420,58,58100,69000,97.0,35,2023-04-05T23:43,-2905,55195
58,3154712,59,49500,66000,0.0,0,2023-04-05T23:43,-4950,44550
59,1417691,60,13900,0,97.0,18498,2023-04-05T23:43,0,13900
60,1005683,61,17500,35000,95.0,10763,2023-04-05T23:43,0,17500
61,2035287,62,39800,0,97.0,8690,2023-04-05T23:43,-5970,33830
62,3180165,63,31200,39000,0.0,0,2023-04-05T23:43,0,31200
63,2967488,64,59800,113900,97.0,164,2023-04-05T23:43,0,59800
64,2877493,65,59800,92000,95.0,1425,2023-04-05T23:43,0,59800
65,3146113,66,19900,49000,0.0,0,2023-04-05T23:43,0,19900
66,3189660,67,59800,94000,100.0,2,2023-04-05T23:43,-5980,53820
67,2065703,68,59000,62000,98.0,5503,2023-04-05T23:43,-8850,50150
68,2359137,69,40200,67000,97.0,1316,2023-04-05T23:43,0,40200
69,3138748,70,69000,98000,89.0,15,2023-04-05T23:43,0,69000
70,1385208,71,33000,37000,97.0,1786,2023-04-05T23:43,0,33000
71,2687910,72,65600,73000,97.0,227,2023-04-05T23:43,-6560,59040
72,2518417,73,27500,55000,93.0,446,2023-04-05T23:43,0,27500
73,903340,74,35000,0,96.0,25139,2023-04-05T23:43,0,35000
74,2409894,75,39000,78000,97.0,5127,2023-04-05T23:43,-3900,35100
75,2780964,76,59000,62000,98.0,1644,2023-04-05T23:43,-5900,53100
76,3165424,77,61000,65000,100.0,3,2023-04-05T23:43,0,61000
77,2851485,78,68900,0,96.0,458,2023-04-05T23:43,0,68900
78,2376233,79,36000,0,97.0,2214,2023-04-05T23:43,0,36000
79,2471760,80,35100,39000,97.0,6503,2023-04-05T23:43,-3510,31590
80,2024232,81,36800,47000,96.0,12078,2023-04-05T23:43,-3680,33120
81,404474,82,27900,47800,94.0,44187,2023-04-05T23:43,0,27900
82,2050094,83,27800,0,97.0,6647,2023-04-05T23:43,-4170,23630
83,1899755,84,29900,39000,96.0,4928,2023-04-05T23:43,0,29900
84,3046771,85,46000,0,98.0,52,2023-04-05T23:43,0,46000
85,2737983,86,119000,0,99.0,48,2023-04-05T23:43,0,119000
86,1031260,87,39900,42000,96.0,13202,2023-04-05T23:43,0,39900
87,2285512,88,44200,52000,96.0,1712,2023-04-05T23:43,0,44200
88,2747025,89,118000,0,98.0,26,2023-04-05T23:43,0,118000
89,1503352,90,39900,42000,97.0,8409,2023-04-05T23:43,0,39900
90,3132559,1,179100,199000,100.0,4,2023-04-05T23:43,0,179100
91,3132593,2,179100,199000,100.0,2,2023-04-05T23:43,0,179100
92,1558197,3,73690,81900,97.0,32279,2023-04-05T23:43,0,73690
93,1856181,4,35910,39900,97.0,7351,2023-04-05T23:43,-3591,32319
94,1778404,5,42000,45000,96.0,67092,2023-04-05T23:43,0,42000
95,2723218,6,69900,109000,97.0,2193,2023-04-05T23:43,0,69900
96,3074540,7,56000,97000,100.0,2,2023-04-05T23:43,0,56000
97,1283757,8,75490,83900,96.0,26599,2023-04-05T23:43,0,75490
98,1571879,9,79900,112900,96.0,7040,2023-04-05T23:43,-15980,63920
99,1790383,10,59000,86000,95.0,5427,2023-04-05T23:43,0,59000
100,1776552,11,59000,69000,94.0,6104,2023-04-05T23:43,0,59000
101,1576700,12,89000,129000,97.0,16700,2023-04-05T23:43,0,89000
102,1530517,13,69900,79000,96.0,2065,2023-04-05T23:43,-13980,55920
103,1195307,14,82400,103000,96.0,12596,2023-04-05T23:43,-8240,74160
104,2061715,15,83900,105000,97.0,2689,2023-04-05T23:43,0,83900
105,1108007,16,79900,0,95.0,47868,2023-04-05T23:43,0,79900
106,3010527,17,237150,279000,98.0,211,2023-04-05T23:43,0,237150
107,2471405,18,89000,138000,97.0,2048,2023-04-05T23:43,0,89000
108,2064545,19,59800,94000,97.0,11071,2023-04-05T23:43,-2990,56810
109,2020732,20,70900,89000,95.0,801,2023-04-05T23:43,0,70900
110,1571878,21,79900,112900,96.0,4660,2023-04-05T23:43,-15980,63920
111,3128145,22,872000,1090000,0.0,0,2023-04-05T23:43,-174400,697600
112,2403367,23,146000,0,97.0,626,2023-04-05T23:43,0,146000
113,2159724,24,29900,32000,95.0,2263,2023-04-05T23:43,0,29900
114,1139192,25,71100,94900,97.0,14390,2023-04-05T23:43,-7110,63990
115,3012082,26,59900,79000,96.0,938,2023-04-05T23:43,-11980,47920
116,3083811,27,76900,139000,98.0,15,2023-04-05T23:43,0,76900
117,2343198,28,119000,129000,97.0,4993,2023-04-05T23:43,0,119000
118,3074541,29,56000,97000,93.0,6,2023-04-05T23:43,0,56000
119,3128134,30,392000,490000,0.0,0,2023-04-05T23:43,-78400,313600
120,3010524,31,237150,279000,98.0,49,2023-04-05T23:43,0,237150
121,1618312,32,83900,0,97.0,7079,2023-04-05T23:43,0,83900
122,1751722,33,53910,59900,97.0,3368,2023-04-05T23:43,-5391,48519
123,2732486,34,109000,179000,98.0,666,2023-04-05T23:43,0,109000
124,2718413,35,126650,149000,97.0,1414,2023-04-05T23:43,0,126650
125,1778408,36,42000,45000,95.0,11668,2023-04-05T23:43,0,42000
126,1817381,37,47900,69000,96.0,1043,2023-04-05T23:43,0,47900
127,1833230,38,108800,136000,97.0,5398,2023-04-05T23:43,0,108800
128,1558683,39,81900,0,97.0,6208,2023-04-05T23:43,0,81900
129,2329532,40,119200,149000,97.0,3941,2023-04-05T23:43,0,119200
130,3078900,41,148000,0,98.0,190,2023-04-05T23:43,-14800,133200
131,2723216,42,69900,109000,97.0,1071,2023-04-05T23:43,0,69900
132,2322836,43,139200,174000,97.0,1002,2023-04-05T23:43,0,139200
133,3055246,44,159000,0,98.0,53,2023-04-05T23:43,0,159000
134,841230,45,154000,172000,96.0,7262,2023-04-05T23:43,0,154000
135,2712632,46,107000,0,97.0,1324,2023-04-05T23:43,0,107000
136,2375909,47,80890,89900,98.0,1532,2023-04-05T23:43,0,80890
137,2284220,48,79900,112900,96.0,1673,2023-04-05T23:43,-15980,63920
138,1737051,49,62300,89000,96.0,5090,2023-04-05T23:43,0,62300
139,3037701,50,215000,239000,98.0,85,2023-04-05T23:43,-43000,172000
140,2668986,51,35910,39900,96.0,3471,2023-04-05T23:43,-3591,32319
141,1558688,52,73690,81900,97.0,5723,2023-04-05T23:43,0,73690
142,2343199,53,119000,129000,98.0,1799,2023-04-05T23:43,0,119000
143,2890926,54,79200,99000,98.0,60,2023-04-05T23:43,0,79200
144,2699160,55,179000,0,96.0,86,2023-04-05T23:43,0,179000
145,2752332,56,94700,105300,95.0,2541,2023-04-05T23:43,0,94700
146,2293391,57,72000,124000,96.0,1818,2023-04-05T23:43,-3600,68400
147,2699189,58,179000,0,99.0,124,2023-04-05T23:43,0,179000
148,1139338,59,71100,94900,97.0,17100,2023-04-05T23:43,-7110,63990
149,1337094,60,69900,0,95.0,5367,2023-04-05T23:43,0,69900
150,3019670,61,188100,209000,100.0,65,2023-04-05T23:43,0,188100
151,2288704,62,121000,132000,97.0,3343,2023-04-05T23:43,0,121000
152,3037473,63,69900,85900,97.0,198,2023-04-05T23:43,0,69900
153,3039879,64,57850,89000,93.0,47,2023-04-05T23:43,0,57850
154,864404,65,108000,135000,95.0,13371,2023-04-05T23:43,0,108000
155,1776365,66,71200,89000,96.0,4607,2023-04-05T23:43,-7120,64080
156,3098417,67,159000,199000,97.0,531,2023-04-05T23:43,0,159000
157,1633664,68,76300,109000,97.0,4181,2023-04-05T23:43,0,76300
158,3033224,69,59900,74000,97.0,614,2023-04-05T23:43,-11980,47920
159,2288426,70,69000,109000,94.0,800,2023-04-05T23:43,0,69000
160,1337096,71,69900,0,97.0,2939,2023-04-05T23:43,0,69900
161,3029811,72,63200,79000,97.0,240,2023-04-05T23:43,0,63200
162,2074862,73,139900,218000,95.0,325,2023-04-05T23:43,-27980,111920
163,1571876,74,79900,112900,96.0,1203,2023-04-05T23:43,-15980,63920
164,401149,75,38500,55000,93.0,24861,2023-04-05T23:43,0,38500
165,3058783,76,179000,209000,95.0,34,2023-04-05T23:43,-35800,143200
166,1873073,77,75490,83900,97.0,4047,2023-04-05T23:43,0,75490
167,1776549,78,59000,69000,94.0,4596,2023-04-05T23:43,0,59000
168,3048143,79,163800,182000,96.0,392,2023-04-05T23:43,0,163800
169,3081572,80,109000,0,97.0,28,2023-04-05T23:43,-10900,98100
170,3058726,81,149000,169000,94.0,39,2023-04-05T23:43,-29800,119200
171,3140186,82,379000,0,95.0,9,2023-04-05T23:43,-18950,360050
172,2995693,83,1562000,2820000,0.0,0,2023-04-05T23:43,0,1562000
173,2122596,84,39800,57000,96.0,2649,2023-04-05T23:43,0,39800
174,3083810,85,76900,139000,80.0,2,2023-04-05T23:43,0,76900
175,2993579,86,189500,249000,98.0,20,2023-04-05T23:43,-37900,151600
176,3037472,87,69900,85900,98.0,116,2023-04-05T23:43,0,69900
177,2053138,88,127000,159000,97.0,665,2023-04-05T23:43,0,127000
178,3047185,89,129000,0,95.0,25,2023-04-05T23:43,0,129000
179,1776550,90,59000,69000,94.0,4141,2023-04-05T23:43,0,59000
180,2112059,1,36400,0,97.0,42809,2023-04-05T23:43,0,36400
181,750908,2,34900,54000,96.0,83977,2023-04-05T23:43,0,34900
182,1149329,3,39900,0,96.0,85914,2023-04-05T23:43,0,39900
183,1551840,4,39000,0,97.0,83533,2023-04-05T23:43,0,39000
184,1168906,5,41900,0,97.0,70967,2023-04-05T23:43,0,41900
185,1149328,6,39900,0,96.0,94453,2023-04-05T23:43,0,39900
186,2092852,7,42000,52800,96.0,11068,2023-04-05T23:43,-2100,39900
187,2060719,8,55200,69000,96.0,5094,2023-04-05T23:43,-2760,52440
188,2351467,9,29000,54000,96.0,6097,2023-04-05T23:43,0,29000
189,2112061,10,36400,52000,97.0,14593,2023-04-05T23:43,0,36400
190,1924274,11,49900,66000,95.0,22471,2023-04-05T23:43,-9980,39920
191,3154689,12,49800,63000,98.0,68,2023-04-05T23:43,-4980,44820
192,3154688,13,49800,63000,99.0,53,2023-04-05T23:43,-4980,44820
193,1370101,14,39000,89000,96.0,22857,2023-04-05T23:43,-1950,37050
194,858911,15,39000,49000,95.0,66847,2023-04-05T23:43,0,39000
195,1568057,16,49600,62000,96.0,22244,2023-04-05T23:43,0,49600
196,2060759,17,59800,74800,97.0,7169,2023-04-05T23:43,-2990,56810
197,2802101,18,49600,62000,94.0,20,2023-04-05T23:43,-9920,39680
198,3154699,19,49800,63000,0.0,0,2023-04-05T23:43,-4980,44820
199,2060717,20,55200,69000,95.0,3764,2023-04-05T23:43,-2760,52440
200,2028327,21,49900,0,97.0,9030,2023-04-05T23:43,0,49900
201,1552753,22,62400,78000,97.0,28156,2023-04-05T23:43,-6240,56160
202,1926048,23,32000,0,97.0,14659,2023-04-05T23:43,0,32000
203,2060720,24,55200,69000,95.0,2548,2023-04-05T23:43,-2760,52440
204,1573215,25,133200,148000,98.0,9271,2023-04-05T23:43,0,133200
205,3154647,26,49800,63000,0.0,0,2023-04-05T23:43,-4980,44820
206,1551839,27,39000,0,97.0,23452,2023-04-05T23:43,0,39000
207,1555407,28,62400,78000,97.0,11532,2023-04-05T23:43,-6240,56160
208,3154697,29,49800,63000,0.0,0,2023-04-05T23:43,-4980,44820
209,2184087,30,49000,89000,96.0,4073,2023-04-05T23:43,-2450,46550
210,2028326,31,49900,0,97.0,6137,2023-04-05T23:43,0,49900
211,3154694,32,49800,63000,0.0,0,2023-04-05T23:43,-4980,44820
212,1222184,33,41900,0,97.0,48342,2023-04-05T23:43,0,41900
213,3154696,34,49800,63000,0.0,0,2023-04-05T23:43,-4980,44820
214,3057113,35,215100,239000,96.0,5,2023-04-05T23:43,0,215100
215,1736085,36,39900,59800,96.0,36645,2023-04-05T23:43,0,39900
216,1224095,37,35890,39900,97.0,24379,2023-04-05T23:43,0,35890
217,1477272,38,44200,68000,96.0,17814,2023-04-05T23:43,0,44200
218,890521,39,39800,63000,94.0,11086,2023-04-05T23:43,0,39800
219,2503133,40,42000,52800,96.0,3081,2023-04-05T23:43,-2100,39900
220,2789091,41,79200,99000,96.0,758,2023-04-05T23:43,-3960,75240
221,1666442,42,49900,0,97.0,10899,2023-04-05T23:43,0,49900
222,3154691,43,49800,63000,0.0,0,2023-04-05T23:43,-4980,44820
223,2060743,44,33000,55000,95.0,3531,2023-04-05T23:43,0,33000
224,2706287,45,39800,54000,95.0,3730,2023-04-05T23:43,0,39800
225,2827702,46,69800,87500,96.0,436,2023-04-05T23:43,-3490,66310
226,890338,47,39000,49000,95.0,47675,2023-04-05T23:43,0,39000
227,3154651,48,49800,63000,0.0,0,2023-04-05T23:43,-4980,44820
228,3127781,49,216000,270000,100.0,2,2023-04-05T23:43,-43200,172800
229,3091296,50,129000,0,93.0,47,2023-04-05T23:43,0,129000
230,3120758,51,107100,119000,99.0,25,2023-04-05T23:43,0,107100
231,3154690,52,49800,63000,0.0,0,2023-04-05T23:43,-4980,44820
232,1440874,53,39900,0,95.0,15131,2023-04-05T23:43,0,39900
233,883004,54,69900,89000,94.0,9458,2023-04-05T23:43,0,69900
234,2723714,55,52000,58000,96.0,1516,2023-04-05T23:43,0,52000
235,3154648,56,49800,63000,0.0,0,2023-04-05T23:43,-4980,44820
236,1168922,57,43900,0,96.0,18169,2023-04-05T23:43,0,43900
237,1885631,58,39000,49000,96.0,23713,2023-04-05T23:43,0,39000
238,3154695,59,49800,63000,0.0,0,2023-04-05T23:43,-4980,44820
239,2749153,60,66600,74000,97.0,548,2023-04-05T23:43,0,66600
240,1212776,61,28690,31900,96.0,23336,2023-04-05T23:43,0,28690
241,2032901,62,39900,0,97.0,6793,2023-04-05T23:43,0,39900
242,2381406,63,124200,138000,98.0,2291,2023-04-05T23:43,0,124200
243,2084435,64,109000,0,97.0,1323,2023-04-05T23:43,0,109000
244,2028329,65,49900,0,96.0,6504,2023-04-05T23:43,0,49900
245,1568032,66,49600,62000,96.0,6115,2023-04-05T23:43,0,49600
246,2720333,67,63200,79000,97.0,588,2023-04-05T23:43,0,63200
247,2092849,68,42000,52800,96.0,9738,2023-04-05T23:43,-2100,39900
248,3188768,69,156000,0,100.0,7,2023-04-05T23:43,0,156000
249,3188776,70,156000,0,100.0,5,2023-04-05T23:43,0,156000
250,1495284,71,34900,54000,95.0,10669,2023-04-05T23:43,0,34900
251,3154692,72,49800,63000,0.0,0,2023-04-05T23:43,-4980,44820
252,1985223,73,39000,89000,96.0,1631,2023-04-05T23:43,-1950,37050
253,2562527,74,29400,42000,97.0,3972,2023-04-05T23:43,0,29400
254,1595607,75,57900,89000,97.0,5693,2023-04-05T23:43,0,57900
255,1985224,76,39000,89000,96.0,1815,2023-04-05T23:43,-1950,37050
256,2708877,77,39800,49800,95.0,1006,2023-04-05T23:43,-1990,37810
257,2578996,78,39900,59000,95.0,4660,2023-04-05T23:43,0,39900
258,2569078,79,79000,0,96.0,2428,2023-04-05T23:43,0,79000
259,1867371,80,39900,49000,96.0,2050,2023-04-05T23:43,0,39900
260,2131950,81,39000,49000,96.0,3852,2023-04-05T23:43,0,39000
261,1403480,82,77000,98000,97.0,7728,2023-04-05T23:43,0,77000
262,2877984,83,59000,0,97.0,413,2023-04-05T23:43,0,59000
263,2789111,84,79200,99000,97.0,810,2023-04-05T23:43,-3960,75240
264,3188763,85,156000,0,95.0,4,2023-04-05T23:43,0,156000
265,1246215,86,52000,65000,96.0,6298,2023-04-05T23:43,0,52000
266,3154649,87,49800,63000,0.0,0,2023-04-05T23:43,-4980,44820
267,1100326,88,57900,89000,95.0,36988,2023-04-05T23:43,0,57900
268,2391746,89,49900,0,95.0,1781,2023-04-05T23:43,0,49900
269,1736562,90,39000,0,97.0,6003,2023-04-05T23:43,0,39000
270,1789507,1,69900,79000,98.0,25813,2023-04-05T23:43,-6990,62910
271,1034480,2,135000,150000,97.0,18040,2023-04-05T23:43,0,135000
272,3038000,3,74700,83000,96.0,345,2023-04-05T23:43,-14940,59760
273,1969507,4,88000,0,98.0,5373,2023-04-05T23:43,0,88000
274,2558648,5,119000,0,98.0,1254,2023-04-05T23:43,0,119000
275,2344538,6,119000,0,98.0,6357,2023-04-05T23:43,0,119000
276,2849891,7,3100000,4490000,0.0,0,2023-04-05T23:43,0,3100000
277,1264107,8,65000,90000,97.0,6349,2023-04-05T23:43,0,65000
278,2992127,9,2835000,3550000,100.0,2,2023-04-05T23:43,0,2835000
279,2066837,10,79000,119000,97.0,6470,2023-04-05T23:43,-7900,71100
280,2702033,11,127200,159000,97.0,394,2023-04-05T23:43,0,127200
281,2235274,12,145000,0,97.0,688,2023-04-05T23:43,0,145000
282,1581689,13,75600,89000,97.0,3969,2023-04-05T23:43,-3780,71820
283,1964770,14,59400,66000,97.0,2485,2023-04-05T23:43,-11880,47520
284,2584181,15,57600,72000,99.0,1029,2023-04-05T23:43,0,57600
285,1456515,16,49500,55000,97.0,8712,2023-04-05T23:43,-9900,39600
286,2771875,17,349000,0,96.0,101,2023-04-05T23:43,0,349000
287,342189,18,39500,52000,95.0,15718,2023-04-05T23:43,0,39500
288,2770508,19,138000,0,97.0,328,2023-04-05T23:43,0,138000
289,1835080,20,98000,0,97.0,2779,2023-04-05T23:43,0,98000
290,2408317,21,145800,162000,96.0,371,2023-04-05T23:43,-14580,131220
291,2343665,22,89000,0,97.0,4590,2023-04-05T23:43,0,89000
292,3050557,23,2027000,3290000,0.0,0,2023-04-05T23:43,0,2027000
293,3047568,24,129000,0,95.0,43,2023-04-05T23:43,0,129000
294,2979849,25,1944000,2370000,100.0,4,2023-04-05T23:43,0,1944000
295,2271789,26,71100,79000,97.0,2505,2023-04-05T23:43,0,71100
296,1969488,27,88000,0,98.0,1741,2023-04-05T23:43,0,88000
297,2344540,28,96000,0,98.0,9196,2023-04-05T23:43,0,96000
298,3020963,29,379000,0,100.0,6,2023-04-05T23:43,0,379000
299,2849886,30,1881000,2430000,93.0,6,2023-04-05T23:43,0,1881000
300,2422175,31,137700,162000,98.0,197,2023-04-05T23:43,0,137700
301,1842449,32,84000,99000,97.0,5364,2023-04-05T23:43,0,84000
302,2320927,33,39000,51000,97.0,2121,2023-04-05T23:43,-3900,35100
303,2657250,34,125400,149000,98.0,115,2023-04-05T23:43,0,125400
304,1910358,35,89100,99000,98.0,2467,2023-04-05T23:43,0,89100
305,1528287,36,49000,0,96.0,4592,2023-04-05T23:43,0,49000
306,3034751,37,64800,72000,96.0,446,2023-04-05T23:43,0,64800
307,1790465,38,141000,188000,98.0,610,2023-04-05T23:43,-28200,112800
308,1736022,39,169200,188000,95.0,429,2023-04-05T23:43,-16920,152280
309,2754080,40,88000,0,97.0,476,2023-04-05T23:43,0,88000
310,2514819,41,55000,66000,97.0,827,2023-04-05T23:43,-2750,52250
311,3142123,42,290000,0,100.0,14,2023-04-05T23:43,0,290000
312,913402,43,83000,98000,95.0,8037,2023-04-05T23:43,0,83000
313,693318,44,79000,110000,96.0,13158,2023-04-05T23:43,0,79000
314,2688604,45,139000,159000,97.0,855,2023-04-05T23:43,-13900,125100
315,1564343,46,92800,119000,98.0,8088,2023-04-05T23:43,-6496,86304
316,3034743,47,84000,0,96.0,201,2023-04-05T23:43,0,84000
317,2745310,48,299000,0,96.0,23,2023-04-05T23:43,0,299000
318,2874755,49,289000,0,97.0,62,2023-04-05T23:43,0,289000
319,3034749,50,64800,72000,97.0,418,2023-04-05T23:43,0,64800
320,2789785,51,140600,148000,97.0,585,2023-04-05T23:43,0,140600
321,2235273,52,145000,0,97.0,179,2023-04-05T23:43,0,145000
322,1744101,53,103500,109000,98.0,2904,2023-04-05T23:43,0,103500
323,3161077,54,169200,188000,100.0,1,2023-04-05T23:43,0,169200
324,1263004,55,159000,0,97.0,5249,2023-04-05T23:43,0,159000
325,3045584,56,130500,145000,97.0,3773,2023-04-05T23:43,0,130500
326,2975285,57,55250,65000,98.0,305,2023-04-05T23:43,0,55250
327,2325729,58,87200,109000,97.0,788,2023-04-05T23:43,-17440,69760
328,1745100,59,103500,109000,97.0,987,2023-04-05T23:43,0,103500
329,2630526,60,100000,0,96.0,625,2023-04-05T23:43,0,100000
330,693525,61,46800,65000,96.0,3988,2023-04-05T23:43,0,46800
331,2305287,62,62820,69800,98.0,1035,2023-04-05T23:43,0,62820
332,2771965,63,319000,0,89.0,24,2023-04-05T23:43,0,319000
333,1247560,64,69900,79000,96.0,4258,2023-04-05T23:43,-6990,62910
334,1576725,65,137000,197000,97.0,5234,2023-04-05T23:43,0,137000
335,1534526,66,55000,0,97.0,2438,2023-04-05T23:43,0,55000
336,2306062,67,89000,139000,97.0,1176,2023-04-05T23:43,-8900,80100
337,2992164,68,1277000,2671000,0.0,0,2023-04-05T23:43,0,1277000
338,2319154,69,78000,120000,100.0,41,2023-04-05T23:43,-7800,70200
339,2888946,70,79000,0,98.0,150,2023-04-05T23:43,-7900,71100
340,2967928,71,299000,0,100.0,6,2023-04-05T23:43,0,299000
341,2059540,72,87200,109000,97.0,549,2023-04-05T23:43,-6104,81096
342,2112607,73,178000,0,97.0,350,2023-04-05T23:43,0,178000
343,1320752,74,67800,135000,97.0,4729,2023-04-05T23:43,-3390,64410
344,2976989,75,169000,0,96.0,13,2023-04-05T23:43,0,169000
345,2688927,76,65600,82000,97.0,645,2023-04-05T23:43,-13120,52480
346,3054230,77,62100,69000,100.0,11,2023-04-05T23:43,-6210,55890
347,1884626,78,36800,46000,97.0,4918,2023-04-05T23:43,0,36800
348,1758217,79,43900,56000,97.0,13125,2023-04-05T23:43,-2195,41705
349,2973716,80,815000,1160000,93.0,6,2023-04-05T23:43,0,815000
350,2002697,81,67900,76000,97.0,3461,2023-04-05T23:43,-6790,61110
351,3070516,82,138000,0,98.0,23,2023-04-05T23:43,0,138000
352,2245910,83,46000,69000,95.0,726,2023-04-05T23:43,-4600,41400
353,1256451,84,49700,89000,97.0,4306,2023-04-05T23:43,0,49700
354,1766527,85,136000,169000,97.0,1352,2023-04-05T23:43,-13600,122400
355,1749492,86,89100,99000,98.0,3858,2023-04-05T23:43,0,89100
356,2930265,87,91000,0,98.0,551,2023-04-05T23:43,0,91000
357,2982246,88,43000,0,96.0,179,2023-04-05T23:43,0,43000
358,1466741,89,85500,145000,97.0,1508,2023-04-05T23:43,-4275,81225
359,2502709,90,800000,871000,100.0,2,2023-04-05T23:43,0,800000
360,2545799,1,149000,0,98.0,2080,2023-04-05T23:43,0,149000
361,1762407,2,260000,0,97.0,3216,2023-04-05T23:43,0,260000
362,1622069,3,119000,0,98.0,5714,2023-04-05T23:43,0,119000
363,969541,4,69000,0,97.0,29478,2023-04-05T23:43,0,69000
364,1762406,5,260000,0,98.0,3304,2023-04-05T23:43,0,260000
365,2638067,6,99000,139000,97.0,3055,2023-04-05T23:43,0,99000
366,3172975,7,260000,0,0.0,0,2023-04-05T23:43,0,260000
367,311052,8,53100,59000,97.0,41131,2023-04-05T23:43,0,53100
368,810034,9,85500,95000,97.0,45171,2023-04-05T23:43,0,85500
369,490091,10,36900,69000,97.0,952,2023-04-05T23:43,0,36900
370,2293400,11,129000,0,96.0,963,2023-04-05T23:43,0,129000
371,3172974,12,260000,0,100.0,3,2023-04-05T23:43,0,260000
372,1900410,13,129000,0,97.0,4873,2023-04-05T23:43,0,129000
373,695334,14,78900,99000,96.0,9360,2023-04-05T23:43,0,78900
374,2320478,15,129000,0,97.0,497,2023-04-05T23:43,0,129000
375,810033,16,89100,99000,97.0,34233,2023-04-05T23:43,0,89100
376,1990244,17,129000,0,98.0,1068,2023-04-05T23:43,0,129000
377,1622068,18,119000,0,97.0,6605,2023-04-05T23:43,0,119000
378,716244,19,54900,95000,98.0,1175,2023-04-05T23:43,0,54900
379,1792640,20,99000,0,98.0,3521,2023-04-05T23:43,0,99000
380,1296778,21,99000,0,98.0,2093,2023-04-05T23:43,0,99000
381,3033248,22,109000,0,97.0,630,2023-04-05T23:43,0,109000
382,181907,23,89900,119000,97.0,7121,2023-04-05T23:43,0,89900
383,2050300,24,39900,129000,96.0,630,2023-04-05T23:43,0,39900
384,577636,25,99900,139000,95.0,31168,2023-04-05T23:43,0,99900
385,490136,26,76000,95000,98.0,2261,2023-04-05T23:43,0,76000
386,2778805,27,99000,0,97.0,981,2023-04-05T23:43,0,99000
387,2161992,28,69900,95000,98.0,3291,2023-04-05T23:43,0,69900
388,810032,29,85500,95000,97.0,13737,2023-04-05T23:43,0,85500
389,2139107,30,44900,89000,95.0,370,2023-04-05T23:43,0,44900
390,1494180,31,71100,79000,95.0,5239,2023-04-05T23:43,0,71100
391,2741233,32,109000,0,97.0,2709,2023-04-05T23:43,0,109000
392,186610,33,75900,85000,97.0,16522,2023-04-05T23:43,0,75900
393,2233180,34,75900,109000,97.0,14175,2023-04-05T23:43,0,75900
394,2737457,35,230000,0,98.0,455,2023-04-05T23:43,0,230000
395,1478592,36,75900,95000,97.0,2997,2023-04-05T23:43,0,75900
396,1296776,37,99000,0,98.0,2936,2023-04-05T23:43,0,99000
397,3096431,38,139000,0,99.0,39,2023-04-05T23:43,0,139000
398,816033,39,70900,89000,96.0,13269,2023-04-05T23:43,0,70900
399,102620,40,69000,0,97.0,17849,2023-04-05T23:43,0,69000
400,2268512,41,109000,0,97.0,433,2023-04-05T23:43,0,109000
401,3023097,42,230000,0,98.0,93,2023-04-05T23:43,0,230000
402,2469965,43,94900,149000,96.0,1086,2023-04-05T23:43,0,94900
403,1493265,44,85500,95000,98.0,4900,2023-04-05T23:43,0,85500
404,1900420,45,129000,0,96.0,1495,2023-04-05T23:43,0,129000
405,311050,46,53100,59000,97.0,9024,2023-04-05T23:43,0,53100
406,3030422,47,139000,0,96.0,833,2023-04-05T23:43,0,139000
407,1853613,48,130000,0,96.0,100,2023-04-05T23:43,0,130000
408,1798273,49,63070,119000,96.0,1171,2023-04-05T23:43,0,63070
409,490135,50,75900,95000,97.0,3268,2023-04-05T23:43,0,75900
410,3023103,51,260000,0,97.0,78,2023-04-05T23:43,0,260000
411,3024528,52,132050,139000,96.0,105,2023-04-05T23:43,0,132050
412,2737458,53,230000,0,98.0,664,2023-04-05T23:43,0,230000
413,1231944,54,119000,0,97.0,1298,2023-04-05T23:43,0,119000
414,2207771,55,44900,89000,95.0,450,2023-04-05T23:43,0,44900
415,311051,56,58500,65000,97.0,19560,2023-04-05T23:43,0,58500
416,3172970,57,148000,0,99.0,22,2023-04-05T23:43,0,148000
417,3079037,58,195000,0,97.0,235,2023-04-05T23:43,0,195000
418,1635193,59,69900,0,96.0,3680,2023-04-05T23:43,0,69900
419,1729744,60,76500,85000,97.0,3343,2023-04-05T23:43,0,76500
420,1473136,61,119900,149000,97.0,10778,2023-04-05T23:43,0,119900
421,2786814,62,149000,0,98.0,183,2023-04-05T23:43,0,149000
422,3091287,63,119000,0,98.0,283,2023-04-05T23:43,0,119000
423,1868015,64,129000,0,97.0,1931,2023-04-05T23:43,0,129000
424,2631192,65,98100,109000,98.0,374,2023-04-05T23:43,0,98100
425,102618,66,69000,0,97.0,6057,2023-04-05T23:43,0,69000
426,2909715,67,119000,0,96.0,85,2023-04-05T23:43,0,119000
427,587568,68,48900,99000,97.0,1247,2023-04-05T23:43,0,48900
428,2909716,69,119000,0,96.0,90,2023-04-05T23:43,0,119000
429,2851292,70,49900,89000,96.0,264,2023-04-05T23:43,0,49900
430,1493263,71,89100,99000,98.0,4222,2023-04-05T23:43,0,89100
431,2032854,72,99000,0,95.0,85,2023-04-05T23:43,0,99000
432,2673444,73,89900,149000,96.0,301,2023-04-05T23:43,0,89900
433,2731878,74,67900,79000,97.0,1642,2023-04-05T23:43,0,67900
434,3115168,75,169000,0,93.0,9,2023-04-05T23:43,0,169000
435,2819014,76,49900,79000,95.0,165,2023-04-05T23:43,0,49900
436,1130307,77,109000,0,97.0,6048,2023-04-05T23:43,0,109000
437,2233178,78,75900,109000,97.0,4940,2023-04-05T23:43,0,75900
438,2945833,79,119900,169000,97.0,569,2023-04-05T23:43,0,119900
439,3172982,80,230000,0,100.0,3,2023-04-05T23:43,0,230000
440,1744960,81,119900,149000,97.0,8228,2023-04-05T23:43,0,119900
441,2229208,82,109000,0,97.0,1605,2023-04-05T23:43,0,109000
442,1718449,83,85500,95000,97.0,2091,2023-04-05T23:43,0,85500
443,104240,84,69000,0,96.0,3860,2023-04-05T23:43,0,69000
444,1354129,85,67000,99000,95.0,8699,2023-04-05T23:43,-13400,53600
445,2899664,86,78900,159000,96.0,116,2023-04-05T23:43,0,78900
446,2899656,87,78900,159000,96.0,98,2023-04-05T23:43,0,78900
447,2691016,88,306000,0,98.0,192,2023-04-05T23:43,-45900,260100
448,1492897,89,75000,0,96.0,3104,2023-04-05T23:43,0,75000
449,1527073,90,69000,0,97.0,4619,2023-04-05T23:43,0,69000
450,1092992,1,69000,0,97.0,37809,2023-04-05T23:43,0,69000
451,1720813,2,149000,0,97.0,413,2023-04-05T23:43,-7450,141550
452,2091749,3,75650,89000,95.0,6217,2023-04-05T23:43,0,75650
453,3124961,4,62100,69000,97.0,71,2023-04-05T23:43,-3105,58995
454,3062046,5,78300,87000,96.0,97,2023-04-05T23:43,-3915,74385
455,2816812,6,119900,0,92.0,1521,2023-04-05T23:43,0,119900
456,1339622,7,42900,59000,97.0,16266,2023-04-05T23:43,0,42900
457,2101924,8,99900,0,96.0,1363,2023-04-05T23:43,0,99900
458,1129750,9,69000,0,97.0,3921,2023-04-05T23:43,0,69000
459,3156683,10,259000,299000,100.0,6,2023-04-05T23:43,-12950,246050
460,2816816,11,159900,0,97.0,1851,2023-04-05T23:43,0,159900
461,1568047,12,159000,0,95.0,12005,2023-04-05T23:43,0,159000
462,3061996,13,88200,98000,98.0,72,2023-04-05T23:43,-4410,83790
463,1334438,14,170000,0,96.0,4396,2023-04-05T23:43,0,170000
464,3161736,15,67900,158000,0.0,0,2023-04-05T23:43,0,67900
465,2624538,16,40900,59000,97.0,1441,2023-04-05T23:43,0,40900
466,2430426,17,169000,0,98.0,726,2023-04-05T23:43,0,169000
467,1810760,18,90000,150000,96.0,159,2023-04-05T23:43,0,90000
468,2433538,19,86700,102000,96.0,2382,2023-04-05T23:43,0,86700
469,451851,20,268000,0,97.0,1947,2023-04-05T23:43,0,268000
470,2355318,21,109900,0,96.0,642,2023-04-05T23:43,0,109900
471,3049313,22,57100,64900,97.0,539,2023-04-05T23:43,0,57100
472,1439535,23,49000,0,96.0,16307,2023-04-05T23:43,0,49000
473,1890398,24,138000,168000,96.0,2723,2023-04-05T23:43,0,138000
474,2432733,25,44900,59000,97.0,2779,2023-04-05T23:43,0,44900
475,2555608,26,259000,299000,93.0,24,2023-04-05T23:43,-12950,246050
476,2664373,27,65000,0,97.0,999,2023-04-05T23:43,0,65000
477,2440524,28,69000,0,97.0,1525,2023-04-05T23:43,-6900,62100
478,3130686,29,169000,0,0.0,0,2023-04-05T23:43,0,169000
479,2363570,30,39900,55000,97.0,986,2023-04-05T23:43,0,39900
480,2395327,31,149000,0,97.0,543,2023-04-05T23:43,0,149000
481,1262092,32,250000,0,96.0,772,2023-04-05T23:43,0,250000
482,2664372,33,65000,0,97.0,1037,2023-04-05T23:43,0,65000
483,2143833,34,91800,108000,96.0,2414,2023-04-05T23:43,0,91800
484,3128322,35,76300,109000,97.0,28,2023-04-05T23:43,0,76300
485,2621831,36,59800,85000,95.0,711,2023-04-05T23:43,-5980,53820
486,2735953,37,207000,230000,98.0,405,2023-04-05T23:43,0,207000
487,1438359,38,98000,0,97.0,1174,2023-04-05T23:43,0,98000
488,595039,39,210000,0,97.0,3506,2023-04-05T23:43,0,210000
489,1419869,40,70300,74000,95.0,10558,2023-04-05T23:43,0,70300
490,2435822,41,94500,99000,97.0,230,2023-04-05T23:43,0,94500
491,1720822,42,209000,0,97.0,294,2023-04-05T23:43,-10450,198550
492,2880951,43,980000,0,0.0,0,2023-04-05T23:43,0,980000
493,2518112,44,89250,105000,96.0,961,2023-04-05T23:43,0,89250
494,2434795,45,39900,59000,97.0,1474,2023-04-05T23:43,0,39900
495,2340324,46,179100,199000,97.0,181,2023-04-05T23:43,0,179100
496,3124959,47,52200,58000,98.0,35,2023-04-05T23:43,-2610,49590
497,1548618,48,152000,198000,96.0,3286,2023-04-05T23:43,0,152000
498,3052437,49,139500,155000,97.0,42,2023-04-05T23:43,-27900,111600
499,1815709,50,138000,168000,96.0,7130,2023-04-05T23:43,0,138000
500,2736011,51,193200,276000,98.0,169,2023-04-05T23:43,0,193200
501,3172972,52,138000,0,100.0,6,2023-04-05T23:43,0,138000
502,2305529,53,138000,168000,97.0,91,2023-04-05T23:43,0,138000
503,1699941,54,67150,79000,97.0,4831,2023-04-05T23:43,-3358,63792
504,2814379,55,120000,200000,98.0,20,2023-04-05T23:43,0,120000
505,3097625,56,95000,0,100.0,3,2023-04-05T23:43,0,95000
506,3024585,57,59000,0,97.0,108,2023-04-05T23:43,0,59000
507,3075621,58,339000,0,98.0,63,2023-04-05T23:43,0,339000
508,1439527,59,49000,0,95.0,13429,2023-04-05T23:43,0,49000
509,1754219,60,31200,39000,96.0,2247,2023-04-05T23:43,0,31200
510,1021359,61,76000,100000,94.0,5376,2023-04-05T23:43,0,76000
511,1562990,62,230000,0,96.0,1274,2023-04-05T23:43,0,230000
512,3097632,63,95000,0,0.0,0,2023-04-05T23:43,0,95000
513,1730340,64,258000,0,97.0,4175,2023-04-05T23:43,0,258000
514,3062069,65,67150,79000,98.0,27,2023-04-05T23:43,-3358,63792
515,2379000,66,151500,159000,97.0,113,2023-04-05T23:43,0,151500
516,2650879,67,169000,0,100.0,19,2023-04-05T23:43,0,169000
517,2306631,68,24900,0,96.0,2077,2023-04-05T23:43,0,24900
518,2098793,69,79200,99000,96.0,1592,2023-04-05T23:43,0,79200
519,668697,70,66400,73800,94.0,8451,2023-04-05T23:43,0,66400
520,1262089,71,300000,0,97.0,1589,2023-04-05T23:43,0,300000
521,595040,72,210000,0,95.0,8738,2023-04-05T23:43,0,210000
522,1215246,73,54300,110000,95.0,360,2023-04-05T23:43,0,54300
523,2419871,74,44900,59000,97.0,903,2023-04-05T23:43,0,44900
524,2383245,75,99000,0,98.0,823,2023-04-05T23:43,0,99000
525,2032683,76,210000,0,96.0,170,2023-04-05T23:43,0,210000
526,607298,77,53600,59000,93.0,15571,2023-04-05T23:43,0,53600
527,2791587,78,150000,300000,90.0,13,2023-04-05T23:43,0,150000
528,2257886,79,119000,0,95.0,1439,2023-04-05T23:43,0,119000
529,1897197,80,53100,59000,96.0,947,2023-04-05T23:43,0,53100
530,501198,81,129000,139000,95.0,2739,2023-04-05T23:43,0,129000
531,3156676,82,259000,299000,99.0,22,2023-04-05T23:43,-12950,246050
532,2243103,83,114500,135000,97.0,54,2023-04-05T23:43,0,114500
533,2736221,84,99000,110000,96.0,245,2023-04-05T23:43,0,99000
534,2091779,85,75600,89000,97.0,991,2023-04-05T23:43,0,75600
535,2463768,86,49000,0,96.0,352,2023-04-05T23:43,0,49000
536,2330198,87,59000,0,97.0,395,2023-04-05T23:43,0,59000
537,2589483,88,65000,0,97.0,1301,2023-04-05T23:43,0,65000
538,1720817,89,175000,0,98.0,187,2023-04-05T23:43,-8750,166250
539,2910086,90,265500,295000,98.0,189,2023-04-05T23:43,0,265500
540,2280117,1,35100,39000,97.0,6225,2023-04-05T23:43,0,35100
541,1214164,2,36000,0,96.0,24891,2023-04-05T23:43,0,36000
542,1272626,3,36000,0,96.0,14113,2023-04-05T23:43,0,36000
543,1771137,4,29000,0,97.0,12474,2023-04-05T23:43,0,29000
544,1214174,5,36000,0,97.0,15007,2023-04-05T23:43,0,36000
545,2879419,6,46900,55000,98.0,687,2023-04-05T23:43,0,46900
546,2134140,7,39000,0,97.0,3493,2023-04-05T23:43,0,39000
547,2286829,8,37000,0,95.0,4914,2023-04-05T23:43,0,37000
548,1214173,9,36000,0,96.0,5551,2023-04-05T23:43,0,36000
549,1022013,10,79000,0,96.0,6257,2023-04-05T23:43,0,79000
550,1022014,11,79000,0,96.0,11424,2023-04-05T23:43,0,79000
551,1822717,12,56050,59000,97.0,4292,2023-04-05T23:43,-2803,53247
552,2356713,13,39000,0,97.0,1450,2023-04-05T23:43,0,39000
553,2879425,14,46900,55000,98.0,264,2023-04-05T23:43,0,46900
554,2123132,15,39000,0,97.0,6379,2023-04-05T23:43,-3900,35100
555,1771132,16,29000,0,96.0,5230,2023-04-05T23:43,0,29000
556,1855444,17,39900,42000,97.0,3005,2023-04-05T23:43,0,39900
557,2384630,18,42000,0,98.0,748,2023-04-05T23:43,0,42000
558,1214109,19,36000,0,97.0,8099,2023-04-05T23:43,0,36000
559,1920929,20,39000,0,97.0,3965,2023-04-05T23:43,0,39000
560,2464070,21,44000,55000,96.0,341,2023-04-05T23:43,-2200,41800
561,1214317,22,36000,0,97.0,11470,2023-04-05T23:43,0,36000
562,2134158,23,39000,0,97.0,2489,2023-04-05T23:43,0,39000
563,2028240,24,39000,0,98.0,3341,2023-04-05T23:43,0,39000
564,1497550,25,29600,37000,95.0,5675,2023-04-05T23:43,0,29600
565,2356711,26,39000,0,98.0,1480,2023-04-05T23:43,0,39000
566,1452917,27,69000,0,96.0,2410,2023-04-05T23:43,0,69000
567,1907733,28,29900,39000,96.0,3819,2023-04-05T23:43,0,29900
568,1771133,29,29000,0,97.0,5690,2023-04-05T23:43,0,29000
569,2591291,30,39200,49000,97.0,1019,2023-04-05T23:43,0,39200
570,1906772,31,39900,42000,97.0,3056,2023-04-05T23:43,0,39900
571,3142349,32,49000,0,100.0,1,2023-04-05T23:43,-4900,44100
572,2221221,33,35100,39000,96.0,1853,2023-04-05T23:43,0,35100
573,2280146,34,35100,39000,97.0,923,2023-04-05T23:43,0,35100
574,3129450,35,44100,49000,0.0,0,2023-04-05T23:43,0,44100
575,2922336,36,52000,0,97.0,143,2023-04-05T23:43,0,52000
576,2707659,37,42000,0,97.0,511,2023-04-05T23:43,0,42000
577,2287131,38,37000,0,95.0,1621,2023-04-05T23:43,0,37000
578,2356693,39,39000,0,97.0,1516,2023-04-05T23:43,0,39000
579,1086824,40,29600,37000,95.0,18618,2023-04-05T23:43,0,29600
580,3039055,41,34400,43000,93.0,32,2023-04-05T23:43,0,34400
581,3125906,42,80100,89000,100.0,7,2023-04-05T23:43,0,80100
582,3142351,43,49000,0,100.0,13,2023-04-05T23:43,-4900,44100
583,1214169,44,36000,0,97.0,5317,2023-04-05T23:43,0,36000
584,1939301,45,39000,0,97.0,802,2023-04-05T23:43,0,39000
585,1335132,46,29000,0,95.0,1100,2023-04-05T23:43,0,29000
586,3012243,47,29900,39900,98.0,61,2023-04-05T23:43,0,29900
587,2778148,48,415000,735000,0.0,0,2023-04-05T23:43,0,415000
588,1925814,49,35100,39000,96.0,1642,2023-04-05T23:43,0,35100
589,2329375,50,34710,39000,96.0,2078,2023-04-05T23:43,0,34710
590,1022012,51,79000,0,94.0,2788,2023-04-05T23:43,0,79000
591,3142350,52,49000,0,100.0,6,2023-04-05T23:43,-4900,44100
592,2672186,53,20900,30000,96.0,564,2023-04-05T23:43,-2090,18810
593,2879417,54,46900,55000,98.0,190,2023-04-05T23:43,0,46900
594,1214171,55,36000,0,97.0,1702,2023-04-05T23:43,0,36000
595,2573131,56,39900,42000,98.0,691,2023-04-05T23:43,0,39900
596,2089719,57,36000,0,97.0,2404,2023-04-05T23:43,0,36000
597,2560668,58,58650,69000,97.0,1241,2023-04-05T23:43,0,58650
598,1524720,59,36000,0,96.0,3369,2023-04-05T23:43,0,36000
599,2687157,60,45000,0,97.0,1033,2023-04-05T23:43,0,45000
600,2364344,61,26600,38000,97.0,1684,2023-04-05T23:43,0,26600
601,2148582,62,42000,0,97.0,1423,2023-04-05T23:43,0,42000
602,1214106,63,36000,0,96.0,9725,2023-04-05T23:43,0,36000
603,2864918,64,49000,0,99.0,119,2023-04-05T23:43,0,49000
604,3153581,65,45000,0,100.0,13,2023-04-05T23:43,-2250,42750
605,2134295,66,39000,0,97.0,401,2023-04-05T23:43,0,39000
606,2650964,67,46900,53000,98.0,185,2023-04-05T23:43,0,46900
607,2107999,68,36000,0,97.0,2657,2023-04-05T23:43,0,36000
608,1022015,69,79000,0,96.0,1945,2023-04-05T23:43,0,79000
609,1157471,70,41650,49000,96.0,931,2023-04-05T23:43,0,41650
610,2134287,71,39000,0,98.0,699,2023-04-05T23:43,0,39000
611,1906773,72,39900,42000,97.0,655,2023-04-05T23:43,0,39900
612,2957190,73,298000,0,0.0,0,2023-04-05T23:43,0,298000
613,3142357,74,63000,0,97.0,7,2023-04-05T23:43,-6300,56700
614,2683883,75,69000,0,97.0,118,2023-04-05T23:43,0,69000
615,2287158,76,37000,0,95.0,1216,2023-04-05T23:43,0,37000
616,2089720,77,36000,0,97.0,289,2023-04-05T23:43,0,36000
617,3155974,78,37000,0,97.0,7,2023-04-05T23:43,-3700,33300
618,2715553,79,68000,0,95.0,255,2023-04-05T23:43,0,68000
619,2288644,80,42000,0,96.0,1210,2023-04-05T23:43,0,42000
620,2998518,81,29000,0,97.0,56,2023-04-05T23:43,0,29000
621,2234533,82,31200,39000,97.0,509,2023-04-05T23:43,0,31200
622,3119342,83,129000,0,0.0,0,2023-04-05T23:43,0,129000
623,1433913,84,31500,42000,94.0,3589,2023-04-05T23:43,0,31500
624,3099130,85,54000,0,97.0,22,2023-04-05T23:43,0,54000
625,1761934,86,41650,49000,95.0,548,2023-04-05T23:43,0,41650
626,3163695,87,58650,69000,100.0,2,2023-04-05T23:43,0,58650
627,2591279,88,36800,46000,97.0,531,2023-04-05T23:43,0,36800
628,1535402,89,39000,0,97.0,1193,2023-04-05T23:43,0,39000
629,2922090,90,52000,0,96.0,71,2023-04-05T23:43,0,52000
630,3106487,1,148000,0,99.0,25,2023-04-05T23:43,0,148000
631,2489894,2,142200,158000,98.0,102,2023-04-05T23:43,0,142200
632,3148943,3,399000,0,0.0,0,2023-04-05T23:43,0,399000
633,2765755,4,198000,0,100.0,3,2023-04-05T23:43,0,198000
634,3184265,5,359000,0,0.0,0,2023-04-05T23:43,-17950,341050
635,2605850,6,94000,0,97.0,164,2023-04-05T23:43,0,94000
636,3194631,7,328000,0,0.0,0,2023-04-05T23:43,-59040,268960
637,3134492,8,79000,0,100.0,3,2023-04-05T23:43,0,79000
638,1973410,9,107100,119000,100.0,3,2023-04-05T23:43,0,107100
639,2457512,10,237300,339000,98.0,36,2023-04-05T23:43,0,237300
640,3177832,11,298000,0,0.0,0,2023-04-05T23:43,-14900,283100
641,2717734,12,79000,0,97.0,56,2023-04-05T23:43,0,79000
642,3118306,13,298000,0,0.0,0,2023-04-05T23:43,-53640,244360
643,2568529,14,220000,0,100.0,10,2023-04-05T23:43,0,220000
644,3073257,15,196200,218000,94.0,10,2023-04-05T23:43,-35316,160884
645,2485838,16,259000,0,100.0,1,2023-04-05T23:43,0,259000
646,3145625,17,249000,0,0.0,0,2023-04-05T23:43,-12450,236550
647,3111732,18,67200,84000,100.0,3,2023-04-05T23:43,-3360,63840
648,3098628,19,222740,259000,0.0,0,2023-04-05T23:43,-40094,182646
649,2377832,20,195000,0,95.0,174,2023-04-05T23:43,0,195000
650,2388209,21,94000,0,96.0,156,2023-04-05T23:43,0,94000
651,3102311,22,220000,0,100.0,1,2023-04-05T23:43,0,220000
652,3050173,23,166600,238000,100.0,1,2023-04-05T23:43,0,166600
653,3053225,24,159000,0,100.0,2,2023-04-05T23:43,0,159000
654,2153636,25,173600,248000,97.0,29,2023-04-05T23:43,0,173600
655,3073259,26,196200,218000,100.0,5,2023-04-05T23:43,-35316,160884
656,3096975,27,199000,0,0.0,0,2023-04-05T23:43,0,199000
657,3102177,28,230000,0,100.0,1,2023-04-05T23:43,0,230000
658,3135234,29,80100,89000,100.0,2,2023-04-05T23:43,-8010,72090
659,2593633,30,212000,0,100.0,3,2023-04-05T23:43,0,212000
660,2712722,31,46900,79000,97.0,26,2023-04-05T23:43,0,46900
661,3140510,32,198000,0,0.0,0,2023-04-05T23:43,0,198000
662,3196932,33,159000,0,0.0,0,2023-04-05T23:43,0,159000
663,3081771,34,189000,0,100.0,5,2023-04-05T23:43,0,189000
664,3158869,35,105000,0,0.0,0,2023-04-05T23:43,0,105000
665,2714524,36,48300,69000,95.0,397,2023-04-05T23:43,-9660,38640
666,3140515,37,198000,0,0.0,0,2023-04-05T23:43,0,198000
667,2870967,38,189000,0,100.0,1,2023-04-05T23:43,0,189000
668,2714533,39,48300,69000,93.0,232,2023-04-05T23:43,-9660,38640
669,1779568,40,57600,64000,95.0,289,2023-04-05T23:43,0,57600
670,2776621,41,179000,0,100.0,16,2023-04-05T23:43,0,179000
671,3203077,42,168000,0,0.0,0,2023-04-05T23:43,0,168000
672,3130628,43,159000,0,0.0,0,2023-04-05T23:43,0,159000
673,3062223,44,188000,0,0.0,0,2023-04-05T23:43,-28200,159800
674,2027250,45,189000,0,0.0,0,2023-04-05T23:43,0,189000
675,2513400,46,189000,0,0.0,0,2023-04-05T23:43,0,189000
676,3008035,47,65900,75000,97.0,34,2023-04-05T23:43,0,65900
677,3126193,48,63200,79000,100.0,1,2023-04-05T23:43,0,63200
678,2585187,49,148000,0,94.0,11,2023-04-05T23:43,0,148000
679,2512635,50,35400,59000,96.0,205,2023-04-05T23:43,0,35400
680,3053218,51,159000,0,86.0,3,2023-04-05T23:43,0,159000
681,2697766,52,165300,174000,100.0,33,2023-04-05T23:43,0,165300
682,2369630,53,178800,298000,0.0,0,2023-04-05T23:43,0,178800
683,2492543,54,169000,0,95.0,13,2023-04-05T23:43,-30420,138580
684,3146767,55,161100,179000,0.0,0,2023-04-05T23:43,-28998,132102
685,3153593,56,151200,168000,0.0,0,2023-04-05T23:43,-27216,123984
686,1840913,57,143200,179000,92.0,16,2023-04-05T23:43,0,143200
687,3146668,58,159600,168000,100.0,3,2023-04-05T23:43,0,159600
688,2392489,59,31900,0,97.0,730,2023-04-05T23:43,0,31900
689,3153595,60,151200,168000,0.0,0,2023-04-05T23:43,-27216,123984
690,2836338,61,79230,139000,93.0,38,2023-04-05T23:43,0,79230
691,3143940,62,89000,0,0.0,0,2023-04-05T23:43,0,89000
692,2848613,63,86900,0,100.0,3,2023-04-05T23:43,0,86900
693,3124552,64,148000,0,0.0,0,2023-04-05T23:43,-22200,125800
694,3170007,65,160550,169000,0.0,0,2023-04-05T23:43,0,160550
695,2083493,66,159200,199000,0.0,0,2023-04-05T23:43,0,159200
696,3037449,67,139300,199000,80.0,3,2023-04-05T23:43,0,139300
697,2087597,68,153300,219000,100.0,1,2023-04-05T23:43,0,153300
698,1455772,69,94000,0,96.0,208,2023-04-05T23:43,0,94000
699,2239793,70,153000,0,88.0,7,2023-04-05T23:43,0,153000
700,2615415,71,127000,159000,100.0,4,2023-04-05T23:43,0,127000
701,2817718,72,150000,0,0.0,0,2023-04-05T23:43,0,150000
702,2714448,73,49600,62000,91.0,104,2023-04-05T23:43,-9920,39680
703,1103286,74,94000,0,94.0,778,2023-04-05T23:43,0,94000
704,2816848,75,125600,157000,100.0,1,2023-04-05T23:43,-22608,102992
705,2801900,76,59900,79900,95.0,8,2023-04-05T23:43,0,59900
706,2404380,77,139300,199000,100.0,3,2023-04-05T23:43,0,139300
707,2612357,78,69000,139000,96.0,15,2023-04-05T23:43,0,69000
708,3116511,79,128000,0,0.0,0,2023-04-05T23:43,0,128000
709,3136176,80,129000,159000,0.0,0,2023-04-05T23:43,0,129000
710,3059069,81,129000,0,100.0,2,2023-04-05T23:43,-23220,105780
711,2809914,82,126000,0,87.0,11,2023-04-05T23:43,0,126000
712,3169735,83,99900,0,0.0,0,2023-04-05T23:43,0,99900
713,1695518,84,125800,148000,96.0,46,2023-04-05T23:43,0,125800
714,2511338,85,132300,189000,0.0,0,2023-04-05T23:43,0,132300
715,3065781,86,125300,179000,80.0,1,2023-04-05T23:43,0,125300
716,3105861,87,129000,0,0.0,0,2023-04-05T23:43,-12900,116100
717,2590108,88,129000,0,0.0,0,2023-04-05T23:43,0,129000
718,1103287,89,94000,0,95.0,402,2023-04-05T23:43,0,94000
719,2957539,90,126350,133000,0.0,0,2023-04-05T23:43,0,126350
720,2643318,1,124000,138000,95.0,16,2023-04-05T23:43,-22320,101680
721,2756335,2,125400,132000,96.0,59,2023-04-05T23:43,0,125400
722,3051039,3,95200,119000,100.0,18,2023-04-05T23:43,0,95200
723,3034043,4,148000,0,100.0,1,2023-04-05T23:43,0,148000
724,1931894,5,37900,0,95.0,509,2023-04-05T23:43,0,37900
725,3031104,6,55200,69000,98.0,57,2023-04-05T23:43,0,55200
726,2377804,7,188100,198000,93.0,37,2023-04-05T23:43,-33858,154242
727,2551400,8,39900,0,93.0,134,2023-04-05T23:43,0,39900
728,3119334,9,379000,0,0.0,0,2023-04-05T23:43,0,379000
729,2849028,10,77500,0,0.0,0,2023-04-05T23:43,0,77500
730,2448900,11,39490,43900,96.0,94,2023-04-05T23:43,0,39490
731,3118977,12,318000,0,0.0,0,2023-04-05T23:43,-57240,260760
732,3084938,13,339000,0,0.0,0,2023-04-05T23:43,0,339000
733,3111743,14,58650,69000,100.0,2,2023-04-05T23:43,-2933,55717
734,3149629,15,125100,139000,0.0,0,2023-04-05T23:43,-22518,102582
735,1944553,16,36900,0,96.0,215,2023-04-05T23:43,0,36900
736,2588029,17,279300,399000,0.0,0,2023-04-05T23:43,-50274,229026
737,2117249,18,32900,0,94.0,451,2023-04-05T23:43,0,32900
738,2551401,19,37900,0,94.0,304,2023-04-05T23:43,0,37900
739,3103947,20,279000,0,0.0,0,2023-04-05T23:43,0,279000
740,3043138,21,43200,54000,100.0,1,2023-04-05T23:43,-2160,41040
741,2749660,22,129000,0,100.0,3,2023-04-05T23:43,0,129000
742,3121771,23,129000,0,100.0,1,2023-04-05T23:43,-23220,105780
743,2377814,24,188100,198000,96.0,71,2023-04-05T23:43,-33858,154242
744,2925522,25,58500,65000,95.0,102,2023-04-05T23:43,0,58500
745,3051036,26,95200,119000,100.0,5,2023-04-05T23:43,0,95200
746,2836351,27,49680,72000,96.0,449,2023-04-05T23:43,-9936,39744
747,3070528,28,168000,0,93.0,3,2023-04-05T23:43,0,168000
748,2551407,29,37900,0,97.0,161,2023-04-05T23:43,0,37900
749,3140250,30,245000,0,0.0,0,2023-04-05T23:43,0,245000
750,2198438,31,238400,298000,100.0,17,2023-04-05T23:43,-42912,195488
751,2448899,32,39490,43900,95.0,135,2023-04-05T23:43,0,39490
752,1370362,33,228000,0,0.0,0,2023-04-05T23:43,0,228000
753,2063182,34,23000,46000,95.0,19,2023-04-05T23:43,0,23000
754,3089728,35,99750,105000,100.0,9,2023-04-05T23:43,0,99750
755,2117253,36,43900,0,94.0,258,2023-04-05T23:43,0,43900
756,3000422,37,59000,0,97.0,25,2023-04-05T23:43,0,59000
757,3120202,38,110400,138000,0.0,0,2023-04-05T23:43,-19872,90528
758,2504391,39,110600,158000,91.0,20,2023-04-05T23:43,0,110600
759,2760121,40,216000,0,0.0,0,2023-04-05T23:43,-38880,177120
760,2864414,41,69300,99000,94.0,84,2023-04-05T23:43,0,69300
761,2912561,42,207200,259000,100.0,3,2023-04-05T23:43,0,207200
762,2666816,43,203000,290000,80.0,3,2023-04-05T23:43,0,203000
763,3164518,44,208000,0,0.0,0,2023-04-05T23:43,-37440,170560
764,2377812,45,188100,198000,96.0,58,2023-04-05T23:43,-33858,154242
765,2390967,46,39530,59000,93.0,206,2023-04-05T23:43,-7906,31624
766,3144374,47,71100,79000,100.0,3,2023-04-05T23:43,0,71100
767,2257612,48,43900,0,96.0,59,2023-04-05T23:43,0,43900
768,1791574,49,71100,79000,96.0,6,2023-04-05T23:43,0,71100
769,2211519,50,99000,0,97.0,64,2023-04-05T23:43,-17820,81180
770,3140793,51,94400,118000,0.0,0,2023-04-05T23:43,-16992,77408
771,3144417,52,71100,79000,0.0,0,2023-04-05T23:43,0,71100
772,3138140,53,51200,64000,0.0,0,2023-04-05T23:43,-2560,48640
773,3098635,54,179550,189000,100.0,1,2023-04-05T23:43,-32319,147231
774,2664573,55,178000,0,92.0,5,2023-04-05T23:43,0,178000
775,3040573,56,169100,178000,100.0,5,2023-04-05T23:43,0,169100
776,2985279,57,198000,0,100.0,1,2023-04-05T23:43,0,198000
777,3073242,58,169200,188000,100.0,4,2023-04-05T23:43,-30456,138744
778,2378594,59,88200,98000,95.0,126,2023-04-05T23:43,0,88200
779,2714832,60,95200,119000,96.0,6,2023-04-05T23:43,0,95200
780,1645762,61,39390,43900,94.0,336,2023-04-05T23:43,0,39390
781,2352881,62,63920,79900,98.0,306,2023-04-05T23:43,0,63920
782,3170471,63,139000,0,0.0,0,2023-04-05T23:43,0,139000
783,3033937,64,89900,0,0.0,0,2023-04-05T23:43,0,89900
784,3073229,65,151200,168000,100.0,1,2023-04-05T23:43,-27216,123984
785,3149612,66,125100,139000,0.0,0,2023-04-05T23:43,-22518,102582
786,3073258,67,160200,178000,97.0,7,2023-04-05T23:43,-28836,131364
787,3154851,68,42000,56000,100.0,2,2023-04-05T23:43,-8400,33600
788,2063240,69,55200,69000,93.0,73,2023-04-05T23:43,0,55200
789,3073252,70,160200,178000,100.0,4,2023-04-05T23:43,-28836,131364
790,2551402,71,37900,0,96.0,96,2023-04-05T23:43,0,37900
791,3159199,72,152000,0,0.0,0,2023-04-05T23:43,0,152000
792,3154861,73,42000,56000,100.0,2,2023-04-05T23:43,-8400,33600
793,3062800,74,154800,172000,100.0,3,2023-04-05T23:43,0,154800
794,2644801,75,142400,178000,100.0,1,2023-04-05T23:43,-25632,116768
795,3120257,76,149000,0,100.0,1,2023-04-05T23:43,0,149000
796,3202347,77,139000,0,0.0,0,2023-04-05T23:43,0,139000
797,1931895,78,37900,0,95.0,138,2023-04-05T23:43,0,37900
798,3153228,79,129000,0,100.0,1,2023-04-05T23:43,0,129000
799,3120778,80,152100,169000,0.0,0,2023-04-05T23:43,0,152100
800,3004783,81,154000,0,95.0,4,2023-04-05T23:43,0,154000
801,1324169,82,29900,0,95.0,1330,2023-04-05T23:43,0,29900
802,3178510,83,148800,186000,0.0,0,2023-04-05T23:43,-26784,122016
803,3190786,84,148000,0,0.0,0,2023-04-05T23:43,-4440,143560
804,2300718,85,39390,43900,95.0,238,2023-04-05T23:43,0,39390
805,3102291,86,148000,0,0.0,0,2023-04-05T23:43,0,148000
806,3037452,87,126650,149000,100.0,3,2023-04-05T23:43,0,126650
807,2933318,88,138000,0,98.0,12,2023-04-05T23:43,0,138000
808,2792603,89,43900,0,100.0,50,2023-04-05T23:43,0,43900
809,3049792,90,71100,79000,100.0,6,2023-04-05T23:43,0,71100
810,991339,1,17890,19900,97.0,52600,2023-04-05T23:43,0,17890
811,1986031,2,24990,27900,97.0,10527,2023-04-05T23:43,0,24990
812,1094748,3,19900,0,97.0,19077,2023-04-05T23:43,0,19900
813,998051,4,12900,24000,97.0,162390,2023-04-05T23:43,0,12900
814,763821,5,13900,22000,96.0,31328,2023-04-05T23:43,0,13900
815,991340,6,17890,19900,97.0,30799,2023-04-05T23:43,0,17890
816,1477845,7,15400,22000,96.0,9626,2023-04-05T23:43,0,15400
817,1094835,8,14290,15900,97.0,6190,2023-04-05T23:43,0,14290
818,1342874,9,16900,33000,97.0,12727,2023-04-05T23:43,0,16900
819,1443937,10,24000,0,97.0,7883,2023-04-05T23:43,0,24000
820,792919,11,15190,16900,96.0,17912,2023-04-05T23:43,0,15190
821,1996702,12,23690,27900,97.0,1923,2023-04-05T23:43,0,23690
822,1094749,13,19900,0,96.0,4952,2023-04-05T23:43,0,19900
823,991570,14,12900,20000,97.0,19033,2023-04-05T23:43,0,12900
824,746154,15,17900,0,96.0,5161,2023-04-05T23:43,0,17900
825,1986030,16,23690,27900,97.0,1665,2023-04-05T23:43,0,23690
826,746158,17,22900,0,96.0,20511,2023-04-05T23:43,0,22900
827,479245,18,15400,22000,93.0,5388,2023-04-05T23:43,0,15400
828,2845854,19,13200,18900,97.0,209,2023-04-05T23:43,0,13200
829,1986029,20,27900,0,97.0,3928,2023-04-05T23:43,0,27900
830,734085,21,10900,19800,96.0,64690,2023-04-05T23:43,0,10900
831,1974077,22,42090,46900,97.0,896,2023-04-05T23:43,0,42090
832,1729576,23,9500,13900,97.0,16019,2023-04-05T23:43,0,9500
833,991341,24,16890,19900,96.0,10200,2023-04-05T23:43,0,16890
834,1821485,25,30000,0,96.0,1250,2023-04-05T23:43,0,30000
835,1996705,26,23690,27900,98.0,2679,2023-04-05T23:43,0,23690
836,2959925,27,22000,27500,99.0,90,2023-04-05T23:43,-2200,19800
837,792920,28,15190,16900,96.0,9659,2023-04-05T23:43,0,15190
838,2011852,29,21490,23900,97.0,1301,2023-04-05T23:43,0,21490
839,2798430,30,24000,29000,97.0,42,2023-04-05T23:43,-3600,20400
840,2297277,31,19900,22000,95.0,282,2023-04-05T23:43,0,19900
841,1348077,32,10900,16500,97.0,1857,2023-04-05T23:43,0,10900
842,1346009,33,9900,12000,97.0,6680,2023-04-05T23:43,0,9900
843,2832613,34,11200,33000,97.0,653,2023-04-05T23:43,0,11200
844,2960555,35,19000,0,94.0,98,2023-04-05T23:43,0,19000
845,2821588,36,19690,21900,97.0,52,2023-04-05T23:43,0,19690
846,746159,37,22900,0,95.0,28719,2023-04-05T23:43,0,22900
847,1094750,38,16890,19900,97.0,3547,2023-04-05T23:43,0,16890
848,1477846,39,15400,22000,96.0,2669,2023-04-05T23:43,0,15400
849,1475055,40,16200,22000,96.0,1169,2023-04-05T23:43,0,16200
850,1260388,41,20900,0,95.0,671,2023-04-05T23:43,0,20900
851,2347097,42,14900,24000,98.0,1545,2023-04-05T23:43,0,14900
852,1094834,43,21490,23900,96.0,2457,2023-04-05T23:43,0,21490
853,752821,44,9900,0,94.0,23742,2023-04-05T23:43,0,9900
854,1647682,45,14900,23600,97.0,948,2023-04-05T23:43,0,14900
855,792921,46,15190,16900,95.0,7807,2023-04-05T23:43,0,15190
856,2973095,47,20000,25000,100.0,24,2023-04-05T23:43,-2000,18000
857,3065854,48,21250,25000,97.0,14,2023-04-05T23:43,0,21250
858,1121544,49,15190,16900,96.0,863,2023-04-05T23:43,0,15190
859,2509300,50,19900,0,96.0,391,2023-04-05T23:43,0,19900
860,2011850,51,21490,23900,98.0,860,2023-04-05T23:43,0,21490
861,2835702,52,13900,15800,97.0,68,2023-04-05T23:43,-1390,12510
862,2821589,53,19690,21900,96.0,36,2023-04-05T23:43,0,19690
863,3009680,54,12590,14900,98.0,101,2023-04-05T23:43,0,12590
864,2011851,55,21490,23900,98.0,676,2023-04-05T23:43,0,21490
865,2711708,56,26100,29000,98.0,67,2023-04-05T23:43,-5220,20880
866,2667555,57,23000,27000,100.0,11,2023-04-05T23:43,-3450,19550
867,2346958,58,18200,24000,98.0,513,2023-04-05T23:43,0,18200
868,2738095,59,19900,0,96.0,103,2023-04-05T23:43,0,19900
869,1996704,60,22290,27900,97.0,697,2023-04-05T23:43,0,22290
870,2973894,61,22000,27500,99.0,21,2023-04-05T23:43,-2200,19800
871,1360043,62,17890,19900,97.0,787,2023-04-05T23:43,0,17890
872,1777081,63,8000,12800,96.0,1169,2023-04-05T23:43,0,8000
873,2122868,64,9500,13900,97.0,3837,2023-04-05T23:43,0,9500
874,1547562,65,15400,22000,95.0,1361,2023-04-05T23:43,0,15400
875,1094836,66,14290,15900,97.0,1311,2023-04-05T23:43,0,14290
876,3150590,67,28800,32000,0.0,0,2023-04-05T23:43,0,28800
877,2929635,68,15900,27000,97.0,508,2023-04-05T23:43,0,15900
878,2738096,69,19900,0,97.0,99,2023-04-05T23:43,0,19900
879,3118094,70,28800,32000,95.0,4,2023-04-05T23:43,0,28800
880,2993584,71,18900,27000,100.0,1,2023-04-05T23:43,-3402,15498
881,1358721,72,14200,22000,96.0,1115,2023-04-05T23:43,0,14200
882,924947,73,14900,19800,96.0,3607,2023-04-05T23:43,0,14900
883,2649999,74,12800,16000,94.0,78,2023-04-05T23:43,0,12800
884,3113489,75,32000,0,100.0,1,2023-04-05T23:43,0,32000
885,2652498,76,9500,12000,97.0,109,2023-04-05T23:43,0,9500
886,1092995,77,20590,22900,96.0,1591,2023-04-05T23:43,0,20590
887,2020825,78,17200,26000,97.0,959,2023-04-05T23:43,0,17200
888,1092994,79,22900,0,96.0,2647,2023-04-05T23:43,0,22900
889,1286366,80,11900,24000,97.0,9790,2023-04-05T23:43,0,11900
890,2245497,81,9500,14900,97.0,475,2023-04-05T23:43,0,9500
891,2477854,82,17890,19900,98.0,1458,2023-04-05T23:43,0,17890
892,1392772,83,16890,19900,96.0,1137,2023-04-05T23:43,0,16890
893,1392773,84,16890,19900,95.0,1470,2023-04-05T23:43,0,16890
894,1062063,85,9490,15900,96.0,2138,2023-04-05T23:43,0,9490
895,3106972,86,19900,0,93.0,9,2023-04-05T23:43,0,19900
896,2821598,87,19390,22900,97.0,141,2023-04-05T23:43,0,19390
897,1346070,88,9900,12000,97.0,1868,2023-04-05T23:43,0,9900
898,1260387,89,18790,20900,96.0,161,2023-04-05T23:43,0,18790
899,2652523,90,9500,12000,98.0,111,2023-04-05T23:43,0,9500
