,item_id,rank,price,del_price,rating,rating_count,time,coupon,real_price
0,2272830,1,35910,39900,97.0,20173,2023-04-18T17:59,-5387,30523
1,1848166,2,44100,49000,97.0,41370,2023-04-18T17:59,0,44100
2,1763157,3,49400,52000,95.0,2781,2023-04-18T17:59,0,49400
3,345889,4,29900,47900,95.0,10159,2023-04-18T17:59,0,29900
4,2479911,5,49400,76000,97.0,4454,2023-04-18T17:59,0,49400
5,2086653,6,16900,0,97.0,40358,2023-04-18T17:59,0,16900
6,2646350,7,59800,94000,95.0,4705,2023-04-18T17:59,-5980,53820
7,2313388,8,68000,85000,96.0,2232,2023-04-18T17:59,0,68000
8,2456003,9,54900,82900,95.0,2276,2023-04-18T17:59,-5490,49410
9,1944612,10,35800,59700,97.0,3008,2023-04-18T17:59,0,35800
10,2442409,11,39000,78000,96.0,9156,2023-04-18T17:59,0,39000
11,2034137,12,31800,0,97.0,17848,2023-04-18T17:59,-4770,27030
12,3176118,13,65550,69000,96.0,45,2023-04-18T17:59,-9833,55717
13,1921901,14,36900,70500,96.0,7698,2023-04-18T17:59,0,36900
14,1706633,15,199000,0,97.0,2443,2023-04-18T17:59,0,199000
15,2149254,16,37800,0,97.0,34143,2023-04-18T17:59,-5670,32130
16,2375962,17,59000,62000,98.0,5692,2023-04-18T17:59,0,59000
17,2401885,18,35900,59000,96.0,3560,2023-04-18T17:59,-3590,32310
18,1884943,19,29900,39000,96.0,19023,2023-04-18T17:59,-4485,25415
19,2015684,20,39000,0,94.0,6497,2023-04-18T17:59,0,39000
20,2305840,21,56715,59700,97.0,4063,2023-04-18T17:59,-2836,53879
21,3105468,22,79000,0,98.0,88,2023-04-18T17:59,0,79000
22,2708999,23,49800,62500,96.0,679,2023-04-18T17:59,-4980,44820
23,1779737,24,20800,32000,96.0,7350,2023-04-18T17:59,0,20800
24,2462040,25,40500,45000,95.0,3961,2023-04-18T17:59,0,40500
25,2996536,26,39900,59000,97.0,720,2023-04-18T17:59,0,39900
26,2285512,27,49400,52000,96.0,1782,2023-04-18T17:59,0,49400
27,3034895,28,101150,119000,98.0,434,2023-04-18T17:59,0,101150
28,1939099,29,29400,49000,97.0,11995,2023-04-18T17:59,0,29400
29,1763123,30,84550,89000,96.0,1685,2023-04-18T17:59,0,84550
30,3176119,31,65550,69000,97.0,38,2023-04-18T17:59,-9833,55717
31,2851485,32,66900,68900,96.0,512,2023-04-18T17:59,-10035,56865
32,2038497,33,36000,45000,95.0,16478,2023-04-18T17:59,-3600,32400
33,1882578,34,35910,39900,97.0,10412,2023-04-18T17:59,0,35910
34,3064420,35,61500,69000,97.0,101,2023-04-18T17:59,0,61500
35,2457846,36,54900,82900,95.0,1470,2023-04-18T17:59,-5490,49410
36,3219911,37,69900,118000,94.0,11,2023-04-18T17:59,0,69900
37,2456000,38,54900,82900,95.0,585,2023-04-18T17:59,-5490,49410
38,3043051,39,68000,85000,96.0,104,2023-04-18T17:59,0,68000
39,1582356,40,49200,82000,96.0,16354,2023-04-18T17:59,0,49200
40,2326935,41,47400,79000,96.0,13085,2023-04-18T17:59,-9480,37920
41,3187851,42,49900,110000,97.0,277,2023-04-18T17:59,0,49900
42,2392759,43,39900,49600,95.0,4158,2023-04-18T17:59,-5985,33915
43,1899755,44,29900,39000,96.0,5044,2023-04-18T17:59,-4485,25415
44,2454238,45,97200,108000,97.0,1621,2023-04-18T17:59,-12960,84240
45,1817394,46,59900,150000,93.0,7347,2023-04-18T17:59,0,59900
46,2314616,47,39000,43000,97.0,8457,2023-04-18T17:59,-5850,33150
47,994588,48,39900,53000,93.0,6142,2023-04-18T17:59,0,39900
48,1498105,49,189000,0,97.0,2044,2023-04-18T17:59,0,189000
49,2065712,50,59000,62000,98.0,6835,2023-04-18T17:59,0,59000
50,2722805,51,63200,79000,96.0,960,2023-04-18T17:59,0,63200
51,2453556,52,39900,42000,97.0,6348,2023-04-18T17:59,0,39900
52,2398380,53,31500,45000,96.0,1679,2023-04-18T17:59,-3150,28350
53,1336398,54,40200,67000,96.0,19157,2023-04-18T17:59,-6030,34170
54,1417691,55,13900,0,97.0,18812,2023-04-18T17:59,0,13900
55,3163730,56,79000,0,99.0,24,2023-04-18T17:59,0,79000
56,3067178,57,26250,35000,96.0,169,2023-04-18T17:59,0,26250
57,2377269,58,45000,0,97.0,4168,2023-04-18T17:59,0,45000
58,2445771,59,56715,59700,97.0,933,2023-04-18T17:59,-2836,53879
59,3042516,60,42000,65000,97.0,150,2023-04-18T17:59,0,42000
60,2462039,61,40500,45000,97.0,1502,2023-04-18T17:59,0,40500
61,1503352,62,39900,42000,97.0,8526,2023-04-18T17:59,0,39900
62,2065708,63,59000,62000,98.0,6827,2023-04-18T17:59,0,59000
63,2376229,64,36000,0,97.0,3889,2023-04-18T17:59,0,36000
64,2445758,65,56715,59700,97.0,1318,2023-04-18T17:59,-2836,53879
65,3074122,66,35100,39000,97.0,84,2023-04-18T17:59,-5265,29835
66,1498103,67,199000,0,96.0,898,2023-04-18T17:59,0,199000
67,1608272,68,39800,65590,96.0,4178,2023-04-18T17:59,0,39800
68,3203720,69,40500,45000,100.0,21,2023-04-18T17:59,-8100,32400
69,2305844,70,56715,59700,97.0,1740,2023-04-18T17:59,-2836,53879
70,2955133,71,79000,83000,99.0,559,2023-04-18T17:59,0,79000
71,2364807,72,219000,0,96.0,734,2023-04-18T17:59,0,219000
72,1031260,73,35700,42000,96.0,13242,2023-04-18T17:59,0,35700
73,3043045,74,68000,85000,99.0,62,2023-04-18T17:59,0,68000
74,3012570,75,54900,79000,96.0,323,2023-04-18T17:59,-8235,46665
75,3203147,76,76500,85000,0.0,0,2023-04-18T17:59,0,76500
76,3054344,77,159000,0,98.0,311,2023-04-18T17:59,-7950,151050
77,996177,78,15900,0,95.0,77883,2023-04-18T17:59,0,15900
78,2913656,79,44900,64000,96.0,387,2023-04-18T17:59,-4490,40410
79,1793989,80,199000,0,97.0,948,2023-04-18T17:59,0,199000
80,2562821,81,81900,91000,97.0,120,2023-04-18T17:59,0,81900
81,2122566,82,33800,0,97.0,16767,2023-04-18T17:59,-5070,28730
82,2645415,83,79000,0,98.0,313,2023-04-18T17:59,0,79000
83,3232647,84,25900,0,0.0,0,2023-04-18T17:59,0,25900
84,1005683,85,17500,35000,95.0,10996,2023-04-18T17:59,0,17500
85,2471760,86,35100,39000,97.0,6590,2023-04-18T17:59,-7020,28080
86,2396645,87,34300,59000,96.0,23779,2023-04-18T17:59,0,34300
87,2403601,88,32500,50000,96.0,2319,2023-04-18T17:59,-4875,27625
88,3046818,89,46000,0,98.0,50,2023-04-18T17:59,-4600,41400
89,2065703,90,59000,62000,98.0,5696,2023-04-18T17:59,0,59000
90,1558197,1,69590,81900,97.0,32797,2023-04-18T17:59,0,69590
91,1778404,2,42000,45000,96.0,67925,2023-04-18T17:59,-6300,35700
92,2343198,3,116000,129000,97.0,5175,2023-04-18T17:59,-23200,92800
93,2723218,4,69900,109000,97.0,2690,2023-04-18T17:59,-10485,59415
94,2329532,5,119200,149000,97.0,4057,2023-04-18T17:59,-11920,107280
95,2020732,6,56900,89000,95.0,903,2023-04-18T17:59,0,56900
96,1856181,7,35910,39900,97.0,7969,2023-04-18T17:59,-5387,30523
97,1571879,8,79900,112900,96.0,7204,2023-04-18T17:59,0,79900
98,2343199,9,116000,129000,98.0,1883,2023-04-18T17:59,-23200,92800
99,3012082,10,59900,79000,96.0,1158,2023-04-18T17:59,-5990,53910
100,2788216,11,143000,159000,98.0,159,2023-04-18T17:59,-28600,114400
101,1776552,12,59000,69000,94.0,6214,2023-04-18T17:59,-8850,50150
102,2403367,13,138700,146000,97.0,668,2023-04-18T17:59,-27740,110960
103,1790383,14,54700,86000,95.0,5781,2023-04-18T17:59,-8205,46495
104,2061715,15,79900,105000,97.0,2803,2023-04-18T17:59,0,79900
105,1778408,16,42000,45000,95.0,11850,2023-04-18T17:59,-6300,35700
106,1283757,17,71290,83900,96.0,26833,2023-04-18T17:59,0,71290
107,2064545,18,74900,94000,97.0,11343,2023-04-18T17:59,-3745,71155
108,1530516,19,69900,79000,96.0,2435,2023-04-18T17:59,0,69900
109,1530517,20,69900,79000,96.0,2180,2023-04-18T17:59,0,69900
110,2471405,21,99600,138000,97.0,2173,2023-04-18T17:59,-9960,89640
111,1776365,22,53400,89000,96.0,4665,2023-04-18T17:59,-8010,45390
112,2732486,23,99000,179000,98.0,784,2023-04-18T17:59,-9900,89100
113,1618312,24,83900,0,97.0,7241,2023-04-18T17:59,-8390,75510
114,3029811,25,63200,79000,96.0,289,2023-04-18T17:59,0,63200
115,3010527,26,237150,279000,97.0,259,2023-04-18T17:59,0,237150
116,2375909,27,76390,89900,98.0,1612,2023-04-18T17:59,0,76390
117,1571878,28,79900,112900,96.0,4774,2023-04-18T17:59,0,79900
118,3033224,29,59900,74000,97.0,798,2023-04-18T17:59,-5990,53910
119,2053138,30,135000,159000,97.0,690,2023-04-18T17:59,-27000,108000
120,1576700,31,89000,129000,97.0,17034,2023-04-18T17:59,-13350,75650
121,2288704,32,119000,132000,97.0,3512,2023-04-18T17:59,-23800,95200
122,3025211,33,44900,69000,97.0,273,2023-04-18T17:59,-2245,42655
123,1737051,34,62300,89000,96.0,5160,2023-04-18T17:59,0,62300
124,3055246,35,159000,0,97.0,80,2023-04-18T17:59,0,159000
125,1139192,36,66400,94900,97.0,14493,2023-04-18T17:59,-9960,56440
126,2284220,37,79900,112900,96.0,1737,2023-04-18T17:59,0,79900
127,2718413,38,134100,149000,97.0,1475,2023-04-18T17:59,0,134100
128,1337094,39,69900,0,95.0,5489,2023-04-18T17:59,0,69900
129,2322836,40,139200,174000,97.0,1057,2023-04-18T17:59,-20880,118320
130,3092774,41,139900,0,100.0,3,2023-04-18T17:59,-20985,118915
131,2572705,42,168300,198000,96.0,67,2023-04-18T17:59,-25245,143055
132,1558683,43,69590,81900,97.0,6290,2023-04-18T17:59,0,69590
133,3037473,44,69900,85900,96.0,301,2023-04-18T17:59,-10485,59415
134,2788219,45,143000,159000,96.0,337,2023-04-18T17:59,-28600,114400
135,2723216,46,69900,109000,97.0,1181,2023-04-18T17:59,-10485,59415
136,3094151,47,174800,184000,96.0,116,2023-04-18T17:59,-34960,139840
137,1195307,48,87550,103000,96.0,12741,2023-04-18T17:59,-13133,74417
138,2159724,49,29900,32000,95.0,2410,2023-04-18T17:59,0,29900
139,1108007,50,67890,79900,95.0,47967,2023-04-18T17:59,0,67890
140,1751722,51,53910,59900,97.0,3481,2023-04-18T17:59,-8087,45823
141,1762727,52,142400,178000,97.0,828,2023-04-18T17:59,0,142400
142,3034346,53,155800,164000,98.0,469,2023-04-18T17:59,-31160,124640
143,1567183,54,71175,94900,97.0,7507,2023-04-18T17:59,-10677,60498
144,1969617,55,162000,0,96.0,2701,2023-04-18T17:59,0,162000
145,3094153,56,174800,184000,98.0,124,2023-04-18T17:59,-34960,139840
146,2668986,57,39900,0,96.0,3638,2023-04-18T17:59,-5985,33915
147,1593755,58,89300,111700,97.0,14518,2023-04-18T17:59,-13395,75905
148,2934225,59,1810000,2520000,0.0,0,2023-04-18T17:59,-20000,1790000
149,2752332,60,84200,105300,95.0,2668,2023-04-18T17:59,-12630,71570
150,3100493,61,139000,0,97.0,57,2023-04-18T17:59,0,139000
151,2357957,62,111750,149000,97.0,2232,2023-04-18T17:59,0,111750
152,3030665,63,139200,174000,95.0,282,2023-04-18T17:59,-20880,118320
153,1272812,64,62300,89000,96.0,2826,2023-04-18T17:59,0,62300
154,1291017,65,67900,96000,95.0,13137,2023-04-18T17:59,0,67900
155,1337096,66,69900,0,97.0,3038,2023-04-18T17:59,0,69900
156,1833230,67,95200,136000,97.0,5489,2023-04-18T17:59,-14280,80920
157,2683549,68,111750,149000,97.0,2617,2023-04-18T17:59,0,111750
158,3043311,69,298000,0,97.0,36,2023-04-18T17:59,0,298000
159,2718414,70,134100,149000,97.0,851,2023-04-18T17:59,0,134100
160,1776549,71,59000,69000,94.0,4644,2023-04-18T17:59,-8850,50150
161,3037477,72,69900,109000,97.0,279,2023-04-18T17:59,-10485,59415
162,2995693,73,1562000,2820000,80.0,1,2023-04-18T17:59,-20000,1542000
163,709191,74,127200,159000,95.0,2014,2023-04-18T17:59,-19080,108120
164,3079071,75,64900,87000,93.0,219,2023-04-18T17:59,-6490,58410
165,3082210,76,359000,0,98.0,11,2023-04-18T17:59,0,359000
166,1558688,77,69590,81900,97.0,5798,2023-04-18T17:59,0,69590
167,3039654,78,69700,83000,96.0,311,2023-04-18T17:59,0,69700
168,3078490,79,423300,498000,100.0,4,2023-04-18T17:59,-21165,402135
169,2820619,80,1428000,0,100.0,7,2023-04-18T17:59,-20000,1408000
170,3037472,81,69900,85900,97.0,206,2023-04-18T17:59,-10485,59415
171,2105470,82,75000,125000,97.0,1211,2023-04-18T17:59,0,75000
172,3036129,83,79800,94000,95.0,1845,2023-04-18T17:59,-3990,75810
173,2288426,84,69000,109000,94.0,858,2023-04-18T17:59,-10350,58650
174,3039655,85,69700,83000,96.0,633,2023-04-18T17:59,0,69700
175,3047197,86,98100,109000,97.0,61,2023-04-18T17:59,-19620,78480
176,1139262,87,135000,159000,97.0,1922,2023-04-18T17:59,-27000,108000
177,2962761,88,96850,149000,94.0,252,2023-04-18T17:59,0,96850
178,3046899,89,79900,105000,96.0,139,2023-04-18T17:59,0,79900
179,3142080,90,440000,0,97.0,23,2023-04-18T17:59,0,440000
180,3220911,1,89000,129000,90.0,2,2023-04-18T17:59,0,89000
181,3044076,2,80100,89000,97.0,68,2023-04-18T17:59,-12015,68085
182,2112059,3,36400,52000,97.0,43770,2023-04-18T17:59,-5460,30940
183,1551840,4,35100,39000,97.0,84447,2023-04-18T17:59,0,35100
184,2703608,5,95200,119000,97.0,429,2023-04-18T17:59,-19040,76160
185,1149329,6,39900,0,96.0,86683,2023-04-18T17:59,0,39900
186,750908,7,34900,54000,96.0,84647,2023-04-18T17:59,0,34900
187,3220907,8,99000,149000,0.0,0,2023-04-18T17:59,0,99000
188,3155551,9,65400,109000,100.0,4,2023-04-18T17:59,-3270,62130
189,1168906,10,35590,41900,97.0,71610,2023-04-18T17:59,0,35590
190,1370101,11,39000,89000,96.0,23377,2023-04-18T17:59,-1950,37050
191,2112061,12,36400,52000,97.0,15062,2023-04-18T17:59,-5460,30940
192,1926048,13,32000,0,97.0,14969,2023-04-18T17:59,0,32000
193,2060719,14,55200,69000,96.0,5427,2023-04-18T17:59,0,55200
194,2281982,15,87120,99000,98.0,520,2023-04-18T17:59,-17424,69696
195,1568057,16,49600,62000,96.0,22652,2023-04-18T17:59,-7440,42160
196,2150457,17,119250,159000,97.0,4028,2023-04-18T17:59,-17888,101362
197,2706287,18,39800,54000,95.0,4074,2023-04-18T17:59,-5565,34235
198,2092852,19,42000,52800,96.0,11461,2023-04-18T17:59,0,42000
199,3059709,20,44200,52000,93.0,9,2023-04-18T17:59,-4420,39780
200,1149328,21,35890,39900,96.0,94799,2023-04-18T17:59,0,35890
201,1924274,22,49900,66000,95.0,22706,2023-04-18T17:59,0,49900
202,2060717,23,55200,69000,95.0,3996,2023-04-18T17:59,0,55200
203,1573215,24,111000,148000,98.0,9440,2023-04-18T17:59,-16650,94350
204,2789091,25,79200,99000,97.0,932,2023-04-18T17:59,-11880,67320
205,1551839,26,39000,0,97.0,23913,2023-04-18T17:59,0,39000
206,2060720,27,55200,69000,96.0,2673,2023-04-18T17:59,0,55200
207,1323090,28,64400,92000,96.0,6079,2023-04-18T17:59,-12880,51520
208,858911,29,39000,49000,95.0,67241,2023-04-18T17:59,-5850,33150
209,2723714,30,52000,58000,96.0,1705,2023-04-18T17:59,0,52000
210,2184087,31,47200,89000,96.0,4213,2023-04-18T17:59,-2360,44840
211,1552753,32,70200,78000,97.0,28327,2023-04-18T17:59,-10530,59670
212,2028326,33,49900,0,97.0,6389,2023-04-18T17:59,0,49900
213,1436218,34,39900,68000,95.0,19495,2023-04-18T17:59,-3990,35910
214,2351467,35,39800,54000,96.0,6594,2023-04-18T17:59,-5565,34235
215,2703599,36,95200,119000,97.0,65,2023-04-18T17:59,-19040,76160
216,1595607,37,57900,89000,97.0,5808,2023-04-18T17:59,-8685,49215
217,3049798,38,96800,121000,97.0,106,2023-04-18T17:59,0,96800
218,2084435,39,98000,109000,97.0,1355,2023-04-18T17:59,-19600,78400
219,2503133,40,42000,52800,96.0,3174,2023-04-18T17:59,0,42000
220,2789111,41,79200,99000,97.0,975,2023-04-18T17:59,-11880,67320
221,2712149,42,49920,78000,96.0,509,2023-04-18T17:59,0,49920
222,890521,43,39800,63000,94.0,11323,2023-04-18T17:59,0,39800
223,3043508,44,71200,89000,97.0,212,2023-04-18T17:59,0,71200
224,2495075,45,49800,72000,95.0,12147,2023-04-18T17:59,-4980,44820
225,1627892,46,43900,0,97.0,11306,2023-04-18T17:59,0,43900
226,2503134,47,42000,52800,96.0,5396,2023-04-18T17:59,0,42000
227,2742472,48,121500,135000,99.0,88,2023-04-18T17:59,-18225,103275
228,1477272,49,44200,68000,96.0,18021,2023-04-18T17:59,-2210,41990
229,1436504,50,41900,0,95.0,9289,2023-04-18T17:59,0,41900
230,1222184,51,37690,41900,97.0,48647,2023-04-18T17:59,0,37690
231,2060759,52,59800,74800,97.0,7380,2023-04-18T17:59,0,59800
232,1736085,53,39900,59800,96.0,37230,2023-04-18T17:59,0,39900
233,2562527,54,29400,42000,97.0,4205,2023-04-18T17:59,-4410,24990
234,1246215,55,49000,65000,96.0,6392,2023-04-18T17:59,-9800,39200
235,2578996,56,39900,59000,95.0,4761,2023-04-18T17:59,-5985,33915
236,1568032,57,49600,62000,96.0,6289,2023-04-18T17:59,-7440,42160
237,2060743,58,33000,55000,95.0,3678,2023-04-18T17:59,0,33000
238,1168922,59,39490,43900,96.0,18375,2023-04-18T17:59,0,39490
239,3169828,60,91200,96000,95.0,13,2023-04-18T17:59,-18240,72960
240,3129951,61,39800,49800,100.0,19,2023-04-18T17:59,-3980,35820
241,3031690,62,128000,0,93.0,190,2023-04-18T17:59,0,128000
242,2032901,63,35890,39900,97.0,7007,2023-04-18T17:59,0,35890
243,3022892,64,39000,49000,96.0,497,2023-04-18T17:59,-5850,33150
244,2107115,65,98500,135000,98.0,11769,2023-04-18T17:59,-14775,83725
245,2569078,66,59250,79000,96.0,2490,2023-04-18T17:59,0,59250
246,1350363,67,53600,68000,97.0,1238,2023-04-18T17:59,0,53600
247,1985223,68,39000,89000,96.0,1728,2023-04-18T17:59,-1950,37050
248,1224095,69,35890,39900,97.0,24607,2023-04-18T17:59,0,35890
249,3070909,70,139000,0,98.0,21,2023-04-18T17:59,-27800,111200
250,1368664,71,81800,109000,97.0,5187,2023-04-18T17:59,-15980,65820
251,3134710,72,79900,0,100.0,3,2023-04-18T17:59,-11985,67915
252,1555407,73,70200,78000,97.0,11739,2023-04-18T17:59,-10530,59670
253,883004,74,69900,89000,94.0,9514,2023-04-18T17:59,0,69900
254,2837340,75,47200,59000,96.0,920,2023-04-18T17:59,0,47200
255,2131950,76,39000,49000,97.0,4098,2023-04-18T17:59,-5850,33150
256,1826978,77,79000,0,96.0,7066,2023-04-18T17:59,-7900,71100
257,1212777,78,27090,31900,96.0,21875,2023-04-18T17:59,0,27090
258,2713134,79,59000,0,97.0,2307,2023-04-18T17:59,-8850,50150
259,2192777,80,104250,139000,97.0,2309,2023-04-18T17:59,-15638,88612
260,2028327,81,42390,49900,97.0,9338,2023-04-18T17:59,0,42390
261,2092849,82,42000,52800,96.0,9902,2023-04-18T17:59,0,42000
262,2358429,83,119250,159000,98.0,2680,2023-04-18T17:59,0,119250
263,1867555,84,36000,45000,96.0,3114,2023-04-18T17:59,0,36000
264,1324127,85,30490,33900,96.0,13891,2023-04-18T17:59,0,30490
265,3051674,86,49900,0,100.0,6,2023-04-18T17:59,0,49900
266,2261213,87,98550,135000,98.0,4160,2023-04-18T17:59,-14783,83767
267,1440874,88,39900,0,95.0,15201,2023-04-18T17:59,0,39900
268,3044071,89,80100,89000,98.0,27,2023-04-18T17:59,-12015,68085
269,1778523,90,39000,49000,96.0,3470,2023-04-18T17:59,-5850,33150
270,1034480,1,135000,150000,97.0,18256,2023-04-18T17:59,0,135000
271,1789507,2,71100,79000,98.0,26155,2023-04-18T17:59,0,71100
272,3000157,3,142200,158000,96.0,162,2023-04-18T17:59,-21330,120870
273,2789785,4,140600,148000,97.0,677,2023-04-18T17:59,0,140600
274,2702033,5,127200,159000,97.0,447,2023-04-18T17:59,0,127200
275,2770508,6,138000,0,97.0,363,2023-04-18T17:59,0,138000
276,1969507,7,88000,0,98.0,5520,2023-04-18T17:59,0,88000
277,2245952,8,46000,69000,96.0,199,2023-04-18T17:59,0,46000
278,2235274,9,145000,0,98.0,751,2023-04-18T17:59,0,145000
279,2789787,10,140600,148000,96.0,370,2023-04-18T17:59,0,140600
280,1835080,11,98000,0,97.0,2894,2023-04-18T17:59,0,98000
281,2654166,12,82000,108000,95.0,108,2023-04-18T17:59,-12300,69700
282,3034751,13,64800,72000,97.0,577,2023-04-18T17:59,0,64800
283,3038000,14,74700,83000,96.0,466,2023-04-18T17:59,-11205,63495
284,1744101,15,103500,109000,98.0,3001,2023-04-18T17:59,0,103500
285,2789786,16,150100,158000,98.0,266,2023-04-18T17:59,0,150100
286,1264107,17,62000,90000,97.0,6475,2023-04-18T17:59,-9300,52700
287,2789784,18,150100,158000,97.0,190,2023-04-18T17:59,0,150100
288,3024801,19,138000,0,100.0,28,2023-04-18T17:59,0,138000
289,1564343,20,92800,119000,98.0,8152,2023-04-18T17:59,-13920,78880
290,3192309,21,112100,118000,98.0,111,2023-04-18T17:59,0,112100
291,1969488,22,88000,0,98.0,1799,2023-04-18T17:59,0,88000
292,693318,23,75000,110000,96.0,13246,2023-04-18T17:59,-11250,63750
293,2066837,24,69000,119000,97.0,6600,2023-04-18T17:59,-10350,58650
294,2630526,25,100000,0,96.0,691,2023-04-18T17:59,0,100000
295,2902045,26,298000,485000,98.0,36,2023-04-18T17:59,-20000,278000
296,2980929,27,1958000,3135000,0.0,0,2023-04-18T17:59,-20000,1938000
297,2558648,28,119000,0,98.0,1328,2023-04-18T17:59,0,119000
298,2320927,29,39000,51000,97.0,2300,2023-04-18T17:59,0,39000
299,2849888,30,1887000,2890000,0.0,0,2023-04-18T17:59,-20000,1867000
300,2422175,31,145800,162000,98.0,229,2023-04-18T17:59,-21870,123930
301,1842449,32,84000,99000,97.0,5490,2023-04-18T17:59,-17780,66220
302,1581689,33,75600,89000,97.0,4061,2023-04-18T17:59,0,75600
303,1910358,34,89100,99000,98.0,2528,2023-04-18T17:59,-13365,75735
304,2344538,35,119000,0,98.0,6519,2023-04-18T17:59,0,119000
305,2117344,36,288000,0,97.0,173,2023-04-18T17:59,0,288000
306,342189,37,39500,52000,95.0,15837,2023-04-18T17:59,0,39500
307,3158464,38,113050,119000,100.0,14,2023-04-18T17:59,-5653,107397
308,3034745,39,75600,84000,97.0,200,2023-04-18T17:59,0,75600
309,2344540,40,96000,0,98.0,9375,2023-04-18T17:59,0,96000
310,3161264,41,98100,109000,98.0,62,2023-04-18T17:59,-19620,78480
311,913402,42,83300,98000,95.0,8093,2023-04-18T17:59,-17760,65540
312,1456515,43,49500,55000,97.0,8789,2023-04-18T17:59,-7425,42075
313,1790465,44,159800,188000,98.0,628,2023-04-18T17:59,-23970,135830
314,2343665,45,89000,0,97.0,4707,2023-04-18T17:59,0,89000
315,1745100,46,103500,109000,97.0,1031,2023-04-18T17:59,0,103500
316,2657250,47,125400,149000,97.0,139,2023-04-18T17:59,0,125400
317,3045076,48,54600,84000,97.0,113,2023-04-18T17:59,0,54600
318,2514819,49,54000,66000,97.0,892,2023-04-18T17:59,0,54000
319,2954961,50,95000,0,96.0,390,2023-04-18T17:59,0,95000
320,3082387,51,139000,0,98.0,157,2023-04-18T17:59,-13900,125100
321,2306062,52,79000,139000,97.0,1207,2023-04-18T17:59,-11850,67150
322,2105328,53,79000,0,97.0,549,2023-04-18T17:59,-11850,67150
323,3070516,54,138000,0,96.0,37,2023-04-18T17:59,0,138000
324,1964770,55,59400,66000,97.0,2548,2023-04-18T17:59,0,59400
325,3028885,56,159000,0,97.0,27,2023-04-18T17:59,0,159000
326,1090160,57,99000,0,97.0,1338,2023-04-18T17:59,0,99000
327,3011494,58,69900,79000,96.0,278,2023-04-18T17:59,-6990,62910
328,2754080,59,88000,0,97.0,519,2023-04-18T17:59,0,88000
329,938746,60,80100,89000,95.0,12583,2023-04-18T17:59,0,80100
330,3029905,61,395000,0,99.0,48,2023-04-18T17:59,0,395000
331,3047568,62,109650,129000,96.0,93,2023-04-18T17:59,-10965,98685
332,1969479,63,88000,0,98.0,1157,2023-04-18T17:59,0,88000
333,3164733,64,377000,450000,100.0,2,2023-04-18T17:59,-20000,357000
334,3034749,65,64800,72000,97.0,512,2023-04-18T17:59,0,64800
335,3174245,66,391000,599000,0.0,0,2023-04-18T17:59,-20000,371000
336,1010750,67,279000,310000,92.0,13,2023-04-18T17:59,0,279000
337,2930265,68,91000,0,97.0,628,2023-04-18T17:59,0,91000
338,3045584,69,130500,145000,97.0,3799,2023-04-18T17:59,0,130500
339,2967335,70,1395000,2605000,90.0,6,2023-04-18T17:59,-20000,1375000
340,3161263,71,98100,109000,100.0,31,2023-04-18T17:59,-19620,78480
341,2271789,72,71100,79000,97.0,2582,2023-04-18T17:59,0,71100
342,2408317,73,145800,162000,96.0,412,2023-04-18T17:59,0,145800
343,3029316,74,99500,0,99.0,26,2023-04-18T17:59,0,99500
344,1597319,75,89100,99000,97.0,619,2023-04-18T17:59,-4455,84645
345,1528287,76,46500,49000,96.0,4694,2023-04-18T17:59,0,46500
346,3034743,77,75600,84000,96.0,241,2023-04-18T17:59,0,75600
347,2998775,78,142200,158000,96.0,541,2023-04-18T17:59,0,142200
348,1447194,79,59900,230000,96.0,2922,2023-04-18T17:59,0,59900
349,2245910,80,46000,69000,95.0,790,2023-04-18T17:59,0,46000
350,2928845,81,995000,1450000,0.0,0,2023-04-18T17:59,-20000,975000
351,3149665,82,98000,0,100.0,12,2023-04-18T17:59,-14700,83300
352,3216143,83,39900,49600,100.0,11,2023-04-18T17:59,-5985,33915
353,3029922,84,295000,0,96.0,101,2023-04-18T17:59,0,295000
354,1744100,85,103500,109000,98.0,1043,2023-04-18T17:59,0,103500
355,3206841,86,142200,158000,0.0,0,2023-04-18T17:59,-21330,120870
356,3142249,87,80000,0,96.0,46,2023-04-18T17:59,-4000,76000
357,3166292,88,161000,280000,0.0,0,2023-04-18T17:59,-16100,144900
358,3143998,89,1435000,4100000,0.0,0,2023-04-18T17:59,-20000,1415000
359,1758217,90,43900,56000,97.0,13220,2023-04-18T17:59,-2195,41705
360,1762406,1,260000,0,98.0,3461,2023-04-18T17:59,0,260000
361,2233180,2,64900,109000,97.0,14337,2023-04-18T17:59,0,64900
362,969541,3,69000,0,97.0,30047,2023-04-18T17:59,0,69000
363,2545799,4,149000,0,98.0,2286,2023-04-18T17:59,0,149000
364,2809006,5,728000,1130000,99.0,35,2023-04-18T17:59,0,728000
365,2638067,6,99000,139000,97.0,3249,2023-04-18T17:59,0,99000
366,2293400,7,129000,0,96.0,1064,2023-04-18T17:59,0,129000
367,1762407,8,260000,0,97.0,3424,2023-04-18T17:59,0,260000
368,810034,9,85500,95000,97.0,45402,2023-04-18T17:59,0,85500
369,1622069,10,119000,0,98.0,5944,2023-04-18T17:59,0,119000
370,3026310,11,99000,0,99.0,842,2023-04-18T17:59,0,99000
371,490136,12,76000,95000,98.0,2586,2023-04-18T17:59,0,76000
372,2565212,13,119000,0,99.0,445,2023-04-18T17:59,0,119000
373,3033248,14,109000,0,97.0,692,2023-04-18T17:59,-10900,98100
374,311052,15,53100,59000,97.0,41397,2023-04-18T17:59,0,53100
375,181907,16,79900,119000,97.0,7211,2023-04-18T17:59,0,79900
376,1622068,17,119000,0,97.0,6802,2023-04-18T17:59,0,119000
377,186610,18,59900,85000,97.0,16686,2023-04-18T17:59,0,59900
378,1900410,19,129000,0,97.0,4957,2023-04-18T17:59,0,129000
379,2731878,20,67900,79000,97.0,1861,2023-04-18T17:59,0,67900
380,695334,21,78900,99000,96.0,9529,2023-04-18T17:59,0,78900
381,2233178,22,64900,109000,97.0,5034,2023-04-18T17:59,0,64900
382,2622254,23,109000,0,98.0,963,2023-04-18T17:59,0,109000
383,2801305,24,369000,700000,99.0,202,2023-04-18T17:59,0,369000
384,1955217,25,69000,109000,96.0,5262,2023-04-18T17:59,-10350,58650
385,2741233,26,109000,0,97.0,2809,2023-04-18T17:59,-10900,98100
386,2785168,27,179000,0,98.0,58,2023-04-18T17:59,0,179000
387,3172975,28,260000,0,96.0,10,2023-04-18T17:59,0,260000
388,2320478,29,129000,0,97.0,561,2023-04-18T17:59,0,129000
389,810033,30,89100,99000,97.0,34343,2023-04-18T17:59,0,89100
390,577636,31,99900,139000,95.0,31304,2023-04-18T17:59,0,99900
391,810032,32,85500,95000,97.0,13805,2023-04-18T17:59,0,85500
392,2440110,33,56900,59900,97.0,1189,2023-04-18T17:59,-8535,48365
393,2524840,34,139000,0,97.0,894,2023-04-18T17:59,0,139000
394,1231944,35,119000,0,97.0,1398,2023-04-18T17:59,0,119000
395,3091287,36,119000,0,98.0,371,2023-04-18T17:59,0,119000
396,2855992,37,159000,0,97.0,619,2023-04-18T17:59,0,159000
397,3079037,38,195000,0,98.0,309,2023-04-18T17:59,0,195000
398,1296778,39,99000,0,98.0,2189,2023-04-18T17:59,0,99000
399,2670201,40,59900,109000,97.0,976,2023-04-18T17:59,0,59900
400,3156630,41,500000,815000,0.0,0,2023-04-18T17:59,-20000,480000
401,3164852,42,499000,810000,0.0,0,2023-04-18T17:59,-20000,479000
402,2161992,43,69900,95000,97.0,3460,2023-04-18T17:59,0,69900
403,3200836,44,179000,0,96.0,52,2023-04-18T17:59,0,179000
404,1493265,45,85500,95000,98.0,4989,2023-04-18T17:59,0,85500
405,816033,46,70900,89000,96.0,13422,2023-04-18T17:59,0,70900
406,2737457,47,230000,0,98.0,488,2023-04-18T17:59,0,230000
407,311051,48,58500,65000,97.0,19631,2023-04-18T17:59,0,58500
408,1744960,49,79900,149000,97.0,8272,2023-04-18T17:59,0,79900
409,490135,50,75900,95000,98.0,3429,2023-04-18T17:59,0,75900
410,1478592,51,75900,95000,97.0,3112,2023-04-18T17:59,0,75900
411,1494180,52,71100,79000,95.0,5299,2023-04-18T17:59,0,71100
412,3086998,53,169000,0,96.0,13,2023-04-18T17:59,0,169000
413,3030422,54,117900,139000,96.0,918,2023-04-18T17:59,0,117900
414,1354129,55,69000,99000,95.0,8751,2023-04-18T17:59,-10350,58650
415,2777005,56,477000,815000,94.0,34,2023-04-18T17:59,-20000,457000
416,2909715,57,119000,0,97.0,113,2023-04-18T17:59,0,119000
417,2312772,58,64900,139800,96.0,1433,2023-04-18T17:59,-9735,55165
418,2899656,59,69900,159000,96.0,129,2023-04-18T17:59,0,69900
419,1376278,60,59200,74000,95.0,1976,2023-04-18T17:59,-8880,50320
420,2631192,61,98100,109000,98.0,425,2023-04-18T17:59,0,98100
421,1798273,62,65000,119000,96.0,1215,2023-04-18T17:59,-6500,58500
422,2229208,63,109000,0,97.0,1631,2023-04-18T17:59,0,109000
423,1729744,64,76500,85000,97.0,3394,2023-04-18T17:59,0,76500
424,2832218,65,109900,129000,97.0,75,2023-04-18T17:59,0,109900
425,2778805,66,99000,0,97.0,1062,2023-04-18T17:59,0,99000
426,2639221,67,99000,0,96.0,81,2023-04-18T17:59,0,99000
427,102620,68,69000,0,97.0,18005,2023-04-18T17:59,0,69000
428,2266983,69,85500,95000,98.0,484,2023-04-18T17:59,0,85500
429,1990244,70,129000,0,98.0,1143,2023-04-18T17:59,0,129000
430,1493263,71,89100,99000,98.0,4282,2023-04-18T17:59,0,89100
431,311050,72,53100,59000,97.0,9109,2023-04-18T17:59,0,53100
432,3024528,73,132050,139000,96.0,115,2023-04-18T17:59,0,132050
433,3167965,74,119000,0,96.0,5,2023-04-18T17:59,0,119000
434,2691016,75,306000,0,98.0,203,2023-04-18T17:59,0,306000
435,1473136,76,119900,149000,97.0,10816,2023-04-18T17:59,0,119900
436,3023097,77,230000,0,98.0,124,2023-04-18T17:59,0,230000
437,3023095,78,230000,0,96.0,91,2023-04-18T17:59,0,230000
438,3178209,79,129000,0,100.0,6,2023-04-18T17:59,0,129000
439,1900420,80,129000,0,96.0,1520,2023-04-18T17:59,0,129000
440,2355071,81,265000,0,98.0,532,2023-04-18T17:59,0,265000
441,1739446,82,109900,129000,97.0,835,2023-04-18T17:59,0,109900
442,3109771,83,133900,149000,98.0,55,2023-04-18T17:59,0,133900
443,3188621,84,119000,0,100.0,2,2023-04-18T17:59,0,119000
444,3048675,85,64000,89000,98.0,42,2023-04-18T17:59,0,64000
445,1812266,86,89000,0,98.0,1473,2023-04-18T17:59,-13350,75650
446,3157671,87,89000,0,98.0,46,2023-04-18T17:59,-8900,80100
447,3119610,88,129000,0,97.0,16,2023-04-18T17:59,0,129000
448,1130307,89,109000,0,97.0,6090,2023-04-18T17:59,0,109000
449,3034470,90,115000,129000,98.0,72,2023-04-18T17:59,0,115000
450,1092992,1,69000,0,97.0,38245,2023-04-18T17:59,0,69000
451,3134606,2,125100,139000,97.0,27,2023-04-18T17:59,-6255,118845
452,3062046,3,78300,87000,97.0,217,2023-04-18T17:59,-3915,74385
453,2383245,4,99000,0,98.0,867,2023-04-18T17:59,0,99000
454,2378989,5,159000,0,96.0,35,2023-04-18T17:59,0,159000
455,3061996,6,88200,98000,98.0,153,2023-04-18T17:59,-4410,83790
456,3161736,7,67900,158000,98.0,261,2023-04-18T17:59,-13485,54415
457,1568047,8,159000,0,95.0,12045,2023-04-18T17:59,-23850,135150
458,2091749,9,75650,89000,95.0,6326,2023-04-18T17:59,0,75650
459,3134621,10,136800,152000,96.0,22,2023-04-18T17:59,-6840,129960
460,3124961,11,62100,69000,97.0,243,2023-04-18T17:59,-3105,58995
461,1334438,12,170000,0,96.0,4443,2023-04-18T17:59,0,170000
462,1129750,13,69000,0,97.0,3970,2023-04-18T17:59,0,69000
463,595040,14,210000,0,95.0,8753,2023-04-18T17:59,0,210000
464,1730341,15,180600,258000,96.0,447,2023-04-18T17:59,0,180600
465,2101924,16,99900,0,97.0,1411,2023-04-18T17:59,0,99900
466,1720822,17,209000,0,97.0,311,2023-04-18T17:59,0,209000
467,451851,18,268000,0,97.0,1959,2023-04-18T17:59,0,268000
468,2919223,19,826000,1470000,0.0,0,2023-04-18T17:59,-20000,806000
469,2433538,20,84660,102000,96.0,2458,2023-04-18T17:59,0,84660
470,1021359,21,61000,100000,94.0,5394,2023-04-18T17:59,-9150,51850
471,2993229,22,1457000,2503000,100.0,1,2023-04-18T17:59,-20000,1437000
472,2910082,23,265500,295000,98.0,508,2023-04-18T17:59,0,265500
473,1720813,24,149000,0,97.0,500,2023-04-18T17:59,0,149000
474,2432733,25,44900,59000,97.0,2925,2023-04-18T17:59,0,44900
475,1339622,26,42900,59000,97.0,16437,2023-04-18T17:59,0,42900
476,3223241,27,119000,0,100.0,2,2023-04-18T17:59,0,119000
477,1262092,28,250000,0,96.0,781,2023-04-18T17:59,0,250000
478,595039,29,210000,0,97.0,3549,2023-04-18T17:59,0,210000
479,3142573,30,132300,189000,0.0,0,2023-04-18T17:59,0,132300
480,1562990,31,230000,0,96.0,1289,2023-04-18T17:59,0,230000
481,2816812,32,119900,0,93.0,1563,2023-04-18T17:59,0,119900
482,1480943,33,89000,0,96.0,359,2023-04-18T17:59,0,89000
483,3134563,34,88200,98000,94.0,18,2023-04-18T17:59,-4410,83790
484,3142574,35,132300,189000,100.0,4,2023-04-18T17:59,0,132300
485,1439535,36,49000,0,96.0,16376,2023-04-18T17:59,0,49000
486,3062069,37,71100,79000,97.0,86,2023-04-18T17:59,-3555,67545
487,2816816,38,143890,159900,97.0,1892,2023-04-18T17:59,0,143890
488,1438359,39,99000,0,97.0,1206,2023-04-18T17:59,0,99000
489,1730340,40,232200,258000,97.0,4255,2023-04-18T17:59,0,232200
490,2624538,41,40900,59000,97.0,1562,2023-04-18T17:59,0,40900
491,2518112,42,87150,105000,96.0,996,2023-04-18T17:59,0,87150
492,607298,43,44700,59000,93.0,15609,2023-04-18T17:59,-6705,37995
493,2378986,44,159000,0,93.0,21,2023-04-18T17:59,0,159000
494,3049313,45,57100,64900,97.0,734,2023-04-18T17:59,0,57100
495,1548618,46,152000,198000,96.0,3309,2023-04-18T17:59,-22800,129200
496,2143833,47,89640,108000,96.0,2453,2023-04-18T17:59,0,89640
497,2355318,48,98890,109900,96.0,664,2023-04-18T17:59,0,98890
498,2379000,49,151500,159000,97.0,119,2023-04-18T17:59,0,151500
499,1262089,50,300000,0,97.0,1594,2023-04-18T17:59,0,300000
500,3223186,51,119000,0,100.0,3,2023-04-18T17:59,0,119000
501,3142568,52,132300,189000,100.0,2,2023-04-18T17:59,0,132300
502,499300,53,220000,0,96.0,879,2023-04-18T17:59,0,220000
503,1439527,54,49000,0,95.0,13452,2023-04-18T17:59,0,49000
504,1562988,55,260000,0,97.0,1487,2023-04-18T17:59,0,260000
505,2736221,56,110000,0,96.0,295,2023-04-18T17:59,0,110000
506,3030191,57,890000,1390000,100.0,1,2023-04-18T17:59,-20000,870000
507,3156676,58,268000,299000,98.0,27,2023-04-18T17:59,-13400,254600
508,2664373,59,65000,0,96.0,1073,2023-04-18T17:59,0,65000
509,2363570,60,39900,55000,97.0,1128,2023-04-18T17:59,0,39900
510,2902207,61,894000,1663000,0.0,0,2023-04-18T17:59,-20000,874000
511,2614276,62,69000,0,97.0,562,2023-04-18T17:59,0,69000
512,3124959,63,52200,58000,97.0,55,2023-04-18T17:59,-2610,49590
513,2210201,64,268000,299000,94.0,198,2023-04-18T17:59,-13400,254600
514,2621831,65,64400,92000,95.0,756,2023-04-18T17:59,-9660,54740
515,2741208,66,98890,109900,96.0,187,2023-04-18T17:59,0,98890
516,2931951,67,734000,1327000,0.0,0,2023-04-18T17:59,-20000,714000
517,1973858,68,125300,179000,98.0,1209,2023-04-18T17:59,-18795,106505
518,2340324,69,179100,199000,98.0,196,2023-04-18T17:59,0,179100
519,1891201,70,155000,0,98.0,222,2023-04-18T17:59,0,155000
520,2735953,71,230000,0,98.0,450,2023-04-18T17:59,0,230000
521,1699941,72,67150,79000,97.0,4919,2023-04-18T17:59,-10073,57077
522,3138454,73,159000,0,86.0,6,2023-04-18T17:59,0,159000
523,2378994,74,151500,159000,95.0,16,2023-04-18T17:59,0,151500
524,2919224,75,670000,1000000,0.0,0,2023-04-18T17:59,-20000,650000
525,595038,76,210000,0,96.0,1336,2023-04-18T17:59,0,210000
526,2664372,77,65000,0,97.0,1116,2023-04-18T17:59,0,65000
527,3143035,78,47500,79000,95.0,44,2023-04-18T17:59,-7485,40015
528,2435822,79,94500,99000,97.0,280,2023-04-18T17:59,0,94500
529,2901247,80,636000,1150000,0.0,0,2023-04-18T17:59,-20000,616000
530,1020993,81,61000,100000,95.0,2862,2023-04-18T17:59,-9150,51850
531,1815709,82,132000,168000,96.0,7162,2023-04-18T17:59,-13200,118800
532,2330196,83,59000,0,97.0,641,2023-04-18T17:59,0,59000
533,3143034,84,47500,79000,97.0,50,2023-04-18T17:59,-7485,40015
534,3172972,85,138000,0,100.0,9,2023-04-18T17:59,0,138000
535,2957149,86,34900,59000,99.0,48,2023-04-18T17:59,0,34900
536,3166437,87,308000,0,0.0,0,2023-04-18T17:59,0,308000
537,3024585,88,59000,0,97.0,161,2023-04-18T17:59,-8850,50150
538,2795526,89,71900,79900,98.0,31,2023-04-18T17:59,-10785,61115
539,2650879,90,169000,0,100.0,23,2023-04-18T17:59,0,169000
540,2356713,1,39000,0,97.0,1520,2023-04-18T17:59,-5850,33150
541,1920929,2,39000,0,97.0,4042,2023-04-18T17:59,-5850,33150
542,2134140,3,39000,0,97.0,3638,2023-04-18T17:59,-5850,33150
543,1822717,4,56050,59000,97.0,4361,2023-04-18T17:59,0,56050
544,1214164,5,36000,0,96.0,25061,2023-04-18T17:59,0,36000
545,2280117,6,35100,39000,97.0,6451,2023-04-18T17:59,0,35100
546,2134158,7,39000,0,97.0,2547,2023-04-18T17:59,-5850,33150
547,2879419,8,48900,55000,98.0,804,2023-04-18T17:59,-7335,41565
548,1771137,9,26100,29000,97.0,12640,2023-04-18T17:59,0,26100
549,1022014,10,79000,0,96.0,11481,2023-04-18T17:59,0,79000
550,1272626,11,36000,0,96.0,14220,2023-04-18T17:59,0,36000
551,1214109,12,36000,0,97.0,8184,2023-04-18T17:59,0,36000
552,2356711,13,39000,0,98.0,1526,2023-04-18T17:59,-5850,33150
553,1771132,14,26100,29000,96.0,5326,2023-04-18T17:59,0,26100
554,1214174,15,36000,0,97.0,15101,2023-04-18T17:59,0,36000
555,2028240,16,39000,0,98.0,3368,2023-04-18T17:59,-5850,33150
556,1214317,17,36000,0,97.0,11536,2023-04-18T17:59,0,36000
557,1855444,18,39900,42000,97.0,3060,2023-04-18T17:59,-5985,33915
558,2859190,19,33300,37000,96.0,474,2023-04-18T17:59,-4995,28305
559,2123132,20,36900,39000,97.0,6456,2023-04-18T17:59,-3690,33210
560,2286829,21,31450,37000,95.0,5056,2023-04-18T17:59,-4718,26732
561,2356693,22,39000,0,97.0,1557,2023-04-18T17:59,-5850,33150
562,1022013,23,79000,0,96.0,6295,2023-04-18T17:59,0,79000
563,1524720,24,36000,0,96.0,3412,2023-04-18T17:59,0,36000
564,2329375,25,34710,39000,96.0,2119,2023-04-18T17:59,-3471,31239
565,1214173,26,36000,0,96.0,5607,2023-04-18T17:59,0,36000
566,1771133,27,26100,29000,97.0,5746,2023-04-18T17:59,0,26100
567,3164855,28,315000,510000,0.0,0,2023-04-18T17:59,-20000,295000
568,3012243,29,29900,39900,98.0,77,2023-04-18T17:59,-4485,25415
569,2280146,30,35100,39000,97.0,953,2023-04-18T17:59,0,35100
570,2107999,31,36000,0,97.0,2704,2023-04-18T17:59,0,36000
571,1907733,32,29900,39000,96.0,3891,2023-04-18T17:59,0,29900
572,2221221,33,35100,39000,96.0,1905,2023-04-18T17:59,0,35100
573,2879425,34,48900,55000,97.0,345,2023-04-18T17:59,-7335,41565
574,2672186,35,20900,30000,96.0,617,2023-04-18T17:59,-2090,18810
575,1755276,36,46550,49000,97.0,2428,2023-04-18T17:59,-9310,37240
576,2560668,37,48300,69000,97.0,1265,2023-04-18T17:59,0,48300
577,1920840,38,39000,0,98.0,1389,2023-04-18T17:59,-5850,33150
578,2812150,39,144000,238000,96.0,13,2023-04-18T17:59,-14400,129600
579,1939301,40,39000,0,97.0,822,2023-04-18T17:59,-5850,33150
580,1022012,41,79000,0,94.0,2801,2023-04-18T17:59,0,79000
581,1214106,42,36000,0,96.0,9769,2023-04-18T17:59,0,36000
582,2507021,43,42000,0,96.0,414,2023-04-18T17:59,-6300,35700
583,2287131,44,31450,37000,95.0,1725,2023-04-18T17:59,-4718,26732
584,1214169,45,36000,0,97.0,5371,2023-04-18T17:59,0,36000
585,2102887,46,45000,0,96.0,165,2023-04-18T17:59,-6750,38250
586,2591291,47,39200,49000,97.0,1040,2023-04-18T17:59,0,39200
587,2879417,48,48900,55000,98.0,221,2023-04-18T17:59,-7335,41565
588,2507080,49,39000,0,98.0,428,2023-04-18T17:59,-5850,33150
589,2134295,50,39000,0,97.0,423,2023-04-18T17:59,0,39000
590,2198830,51,14700,21000,95.0,1499,2023-04-18T17:59,0,14700
591,3038180,52,41400,46000,98.0,151,2023-04-18T17:59,-4140,37260
592,3225733,53,49000,0,100.0,5,2023-04-18T17:59,0,49000
593,2929129,54,384000,475000,100.0,1,2023-04-18T17:59,-20000,364000
594,470355,55,16900,19000,95.0,5382,2023-04-18T17:59,0,16900
595,1214171,56,36000,0,97.0,1729,2023-04-18T17:59,0,36000
596,2650964,57,48900,53000,98.0,201,2023-04-18T17:59,-7335,41565
597,2864918,58,49000,0,99.0,149,2023-04-18T17:59,0,49000
598,3232889,59,38900,0,0.0,0,2023-04-18T17:59,0,38900
599,3164854,60,357000,510000,0.0,0,2023-04-18T17:59,-20000,337000
600,2288650,61,35700,42000,96.0,1532,2023-04-18T17:59,-7140,28560
601,3099388,62,99000,0,100.0,4,2023-04-18T17:59,0,99000
602,1906772,63,39900,42000,97.0,3101,2023-04-18T17:59,-5985,33915
603,2980928,64,308000,490000,91.0,19,2023-04-18T17:59,-20000,288000
604,2716310,65,33300,37000,96.0,176,2023-04-18T17:59,-4995,28305
605,2922336,66,52000,0,97.0,155,2023-04-18T17:59,0,52000
606,1126959,67,29250,39000,91.0,2588,2023-04-18T17:59,0,29250
607,3185585,68,42000,0,0.0,0,2023-04-18T17:59,-4200,37800
608,1535402,69,39000,0,97.0,1213,2023-04-18T17:59,0,39000
609,1335132,70,29000,0,95.0,1129,2023-04-18T17:59,0,29000
610,2435766,71,37900,39900,97.0,216,2023-04-18T17:59,-5685,32215
611,2288644,72,35700,42000,96.0,1226,2023-04-18T17:59,-7140,28560
612,3039055,73,36550,43000,95.0,52,2023-04-18T17:59,-5483,31067
613,2358733,74,35100,39000,97.0,448,2023-04-18T17:59,-5265,29835
614,2650965,75,48900,53000,98.0,391,2023-04-18T17:59,-7335,41565
615,1925814,76,35100,39000,96.0,1692,2023-04-18T17:59,0,35100
616,3166273,77,141000,233000,0.0,0,2023-04-18T17:59,-14100,126900
617,1452917,78,69000,0,96.0,2430,2023-04-18T17:59,0,69000
618,3098590,79,49500,55000,0.0,0,2023-04-18T17:59,-7425,42075
619,3099784,80,57000,0,100.0,16,2023-04-18T17:59,0,57000
620,2356692,81,39000,0,97.0,497,2023-04-18T17:59,-5850,33150
621,3142347,82,49000,0,100.0,7,2023-04-18T17:59,0,49000
622,3142358,83,63000,0,94.0,10,2023-04-18T17:59,0,63000
623,1497550,84,29600,37000,95.0,5718,2023-04-18T17:59,0,29600
624,2998516,85,27550,29000,96.0,176,2023-04-18T17:59,0,27550
625,3143992,86,292000,495000,0.0,0,2023-04-18T17:59,-20000,272000
626,3050702,87,79000,0,100.0,6,2023-04-18T17:59,0,79000
627,1214316,88,36000,0,97.0,2007,2023-04-18T17:59,0,36000
628,2089720,89,36000,0,96.0,315,2023-04-18T17:59,0,36000
629,2289281,90,28500,38000,96.0,900,2023-04-18T17:59,0,28500
630,3031171,1,68000,0,98.0,60,2023-04-18T17:59,0,68000
631,2490339,2,1466000,1930000,0.0,0,2023-04-18T17:59,-20000,1446000
632,3225045,3,390000,0,0.0,0,2023-04-18T17:59,0,390000
633,3030948,4,68000,0,99.0,37,2023-04-18T17:59,0,68000
634,3182420,5,368000,0,0.0,0,2023-04-18T17:59,0,368000
635,3055337,6,159000,0,100.0,1,2023-04-18T17:59,0,159000
636,1779568,7,57600,64000,95.0,294,2023-04-18T17:59,0,57600
637,3138205,8,139500,155000,0.0,0,2023-04-18T17:59,-6975,132525
638,3161937,9,279000,0,0.0,0,2023-04-18T17:59,-13950,265050
639,2478652,10,57800,68000,94.0,336,2023-04-18T17:59,0,57800
640,1871030,11,133600,167000,95.0,102,2023-04-18T17:59,0,133600
641,3137987,12,259000,0,0.0,0,2023-04-18T17:59,0,259000
642,3145625,13,249000,0,0.0,0,2023-04-18T17:59,-12450,236550
643,2377832,14,195000,0,95.0,175,2023-04-18T17:59,0,195000
644,3168767,15,244000,0,0.0,0,2023-04-18T17:59,0,244000
645,2388209,16,94000,0,96.0,158,2023-04-18T17:59,0,94000
646,3203077,17,168000,0,0.0,0,2023-04-18T17:59,-25200,142800
647,3074707,18,119000,0,100.0,4,2023-04-18T17:59,0,119000
648,3102188,19,230000,0,0.0,0,2023-04-18T17:59,0,230000
649,3126194,20,63200,79000,100.0,1,2023-04-18T17:59,-9480,53720
650,2612357,21,69000,139000,96.0,17,2023-04-18T17:59,-10350,58650
651,2424645,22,80000,179000,95.0,13,2023-04-18T17:59,-10400,69600
652,2512635,23,35400,59000,96.0,220,2023-04-18T17:59,0,35400
653,3050856,24,189000,0,93.0,12,2023-04-18T17:59,0,189000
654,2489894,25,150100,158000,98.0,109,2023-04-18T17:59,0,150100
655,1464033,26,175200,219000,80.0,1,2023-04-18T17:59,0,175200
656,3130729,27,209000,0,0.0,0,2023-04-18T17:59,0,209000
657,3053796,28,198000,0,80.0,1,2023-04-18T17:59,-29700,168300
658,2455890,29,205200,228000,100.0,1,2023-04-18T17:59,0,205200
659,3120621,30,197100,219000,100.0,1,2023-04-18T17:59,-29565,167535
660,2169585,31,198000,0,100.0,4,2023-04-18T17:59,0,198000
661,3053223,32,179000,0,100.0,4,2023-04-18T17:59,0,179000
662,2801900,33,59900,79900,95.0,8,2023-04-18T17:59,0,59900
663,3119153,34,160600,169000,0.0,0,2023-04-18T17:59,0,160600
664,3041837,35,168000,0,0.0,0,2023-04-18T17:59,0,168000
665,2930805,36,208000,0,80.0,1,2023-04-18T17:59,0,208000
666,3119265,37,111200,139000,0.0,0,2023-04-18T17:59,0,111200
667,2648003,38,96000,120000,100.0,2,2023-04-18T17:59,0,96000
668,3113104,39,170000,0,0.0,0,2023-04-18T17:59,0,170000
669,3146761,40,179100,199000,0.0,0,2023-04-18T17:59,-26865,152235
670,2836338,41,69500,139000,93.0,38,2023-04-18T17:59,0,69500
671,3156837,42,179000,0,0.0,0,2023-04-18T17:59,0,179000
672,3174230,43,161100,179000,0.0,0,2023-04-18T17:59,-24165,136935
673,2799265,44,173600,248000,0.0,0,2023-04-18T17:59,0,173600
674,2712722,45,46900,79000,96.0,31,2023-04-18T17:59,0,46900
675,3099772,46,89000,0,100.0,2,2023-04-18T17:59,0,89000
676,2424647,47,80000,179000,0.0,0,2023-04-18T17:59,-10400,69600
677,2506458,48,160000,229000,100.0,1,2023-04-18T17:59,0,160000
678,3135234,49,80100,89000,93.0,6,2023-04-18T17:59,-12015,68085
679,1537416,50,57800,68000,90.0,133,2023-04-18T17:59,0,57800
680,3138201,51,139500,155000,0.0,0,2023-04-18T17:59,-6975,132525
681,3196948,52,129000,0,100.0,3,2023-04-18T17:59,0,129000
682,2605850,53,94000,0,97.0,171,2023-04-18T17:59,0,94000
683,3040732,54,71100,79000,94.0,7,2023-04-18T17:59,0,71100
684,3149937,55,149000,0,0.0,0,2023-04-18T17:59,0,149000
685,3049066,56,66750,89000,100.0,1,2023-04-18T17:59,-13350,53400
686,3189839,57,148000,0,0.0,0,2023-04-18T17:59,0,148000
687,3126193,58,63200,79000,95.0,8,2023-04-18T17:59,-9480,53720
688,3166872,59,129000,0,0.0,0,2023-04-18T17:59,-12900,116100
689,3084760,60,119000,0,100.0,1,2023-04-18T17:59,0,119000
690,2531195,61,42000,56000,92.0,28,2023-04-18T17:59,-6300,35700
691,2407030,62,219000,0,0.0,0,2023-04-18T17:59,-7665,211335
692,3144508,63,129000,0,0.0,0,2023-04-18T17:59,0,129000
693,3100428,64,149000,0,0.0,0,2023-04-18T17:59,0,149000
694,3074709,65,119000,0,100.0,3,2023-04-18T17:59,0,119000
695,1341924,66,98800,152000,96.0,86,2023-04-18T17:59,-14820,83980
696,2114402,67,139000,0,100.0,3,2023-04-18T17:59,-20850,118150
697,3217851,68,75600,84000,0.0,0,2023-04-18T17:59,0,75600
698,3041479,69,118000,0,100.0,1,2023-04-18T17:59,0,118000
699,3080502,70,69900,0,91.0,9,2023-04-18T17:59,-10485,59415
700,3134490,71,75050,79000,0.0,0,2023-04-18T17:59,0,75050
701,2328774,72,128700,198000,97.0,41,2023-04-18T17:59,0,128700
702,1941152,73,69300,77000,95.0,56,2023-04-18T17:59,0,69300
703,3104789,74,119000,0,0.0,0,2023-04-18T17:59,-17850,101150
704,3105864,75,129000,0,0.0,0,2023-04-18T17:59,-19350,109650
705,3084762,76,119000,0,100.0,2,2023-04-18T17:59,0,119000
706,2957672,77,131600,188000,0.0,0,2023-04-18T17:59,0,131600
707,3099416,78,44910,49900,100.0,3,2023-04-18T17:59,0,44910
708,3136177,79,132990,143000,0.0,0,2023-04-18T17:59,-19949,113041
709,1156787,80,116000,145000,94.0,85,2023-04-18T17:59,0,116000
710,3196291,81,128800,159000,0.0,0,2023-04-18T17:59,0,128800
711,2499196,82,125300,179000,100.0,7,2023-04-18T17:59,0,125300
712,2044442,83,70000,0,96.0,171,2023-04-18T17:59,0,70000
713,2402520,84,128000,0,100.0,3,2023-04-18T17:59,-19200,108800
714,3198386,85,108000,118000,0.0,0,2023-04-18T17:59,0,108000
715,2500573,86,34300,49000,96.0,45,2023-04-18T17:59,0,34300
716,3134244,87,125000,0,0.0,0,2023-04-18T17:59,0,125000
717,3132771,88,94000,0,93.0,3,2023-04-18T17:59,0,94000
718,3153273,89,118000,0,0.0,0,2023-04-18T17:59,-23600,94400
719,3138111,90,63000,84000,0.0,0,2023-04-18T17:59,0,63000
720,3081767,1,169000,0,90.0,8,2023-04-18T17:59,0,169000
721,3170471,2,139000,0,100.0,1,2023-04-18T17:59,0,139000
722,3099402,3,439000,0,0.0,0,2023-04-18T17:59,0,439000
723,2864414,4,69300,99000,95.0,98,2023-04-18T17:59,-10395,58905
724,3044176,5,378000,0,100.0,1,2023-04-18T17:59,-56700,321300
725,3040745,6,88000,110000,94.0,17,2023-04-18T17:59,0,88000
726,3212864,7,358000,0,0.0,0,2023-04-18T17:59,-53700,304300
727,3096075,8,359000,0,0.0,0,2023-04-18T17:59,-53850,305150
728,3212799,9,338000,0,0.0,0,2023-04-18T17:59,-50700,287300
729,2978106,10,49900,0,100.0,5,2023-04-18T17:59,-4990,44910
730,1944554,11,36900,0,96.0,555,2023-04-18T17:59,-3690,33210
731,3071814,12,73600,92000,100.0,2,2023-04-18T17:59,-11040,62560
732,2756335,13,125400,132000,97.0,68,2023-04-18T17:59,0,125400
733,3112819,14,304000,320000,0.0,0,2023-04-18T17:59,-45600,258400
734,2551401,15,37900,0,94.0,332,2023-04-18T17:59,0,37900
735,3083215,16,140400,156000,100.0,3,2023-04-18T17:59,-28080,112320
736,3067949,17,142000,158000,100.0,1,2023-04-18T17:59,-28400,113600
737,3190573,18,264000,378000,0.0,0,2023-04-18T17:59,-34320,229680
738,1788995,19,58500,65000,94.0,566,2023-04-18T17:59,0,58500
739,3122265,20,124200,138000,88.0,5,2023-04-18T17:59,-18630,105570
740,3040758,21,94400,111000,94.0,15,2023-04-18T17:59,0,94400
741,3103902,22,284050,299000,0.0,0,2023-04-18T17:59,-42608,241442
742,3144894,23,93000,0,0.0,0,2023-04-18T17:59,0,93000
743,2716675,24,39900,59000,96.0,179,2023-04-18T17:59,-5985,33915
744,3049781,25,76000,95000,100.0,2,2023-04-18T17:59,0,76000
745,3146678,26,129000,0,0.0,0,2023-04-18T17:59,0,129000
746,2551400,27,39900,0,93.0,149,2023-04-18T17:59,0,39900
747,3038047,28,107100,119000,100.0,3,2023-04-18T17:59,0,107100
748,3144417,29,71100,79000,100.0,1,2023-04-18T17:59,0,71100
749,2610241,30,245000,350000,0.0,0,2023-04-18T17:59,0,245000
750,1324169,31,25390,29900,95.0,1352,2023-04-18T17:59,0,25390
751,1931894,32,37900,0,95.0,529,2023-04-18T17:59,0,37900
752,2535468,33,236600,338000,100.0,6,2023-04-18T17:59,-30758,205842
753,2942764,34,189000,0,98.0,14,2023-04-18T17:59,0,189000
754,3219713,35,98000,0,0.0,0,2023-04-18T17:59,0,98000
755,2377812,36,198000,0,96.0,59,2023-04-18T17:59,-29700,168300
756,2378594,37,88200,98000,95.0,132,2023-04-18T17:59,0,88200
757,3126113,38,55300,79000,87.0,14,2023-04-18T17:59,-8295,47005
758,3051036,39,83300,119000,100.0,15,2023-04-18T17:59,0,83300
759,2811560,40,179000,0,100.0,4,2023-04-18T17:59,-26850,152150
760,3000422,41,59000,0,96.0,40,2023-04-18T17:59,0,59000
761,2666819,42,203000,290000,100.0,1,2023-04-18T17:59,0,203000
762,3135305,43,49500,55000,100.0,2,2023-04-18T17:59,-7425,42075
763,2849622,44,198000,0,0.0,0,2023-04-18T17:59,-39600,158400
764,2377804,45,198000,0,93.0,38,2023-04-18T17:59,-29700,168300
765,3108716,46,184500,205000,0.0,0,2023-04-18T17:59,-27675,156825
766,3049792,47,71100,79000,100.0,15,2023-04-18T17:59,0,71100
767,2738716,48,151200,168000,94.0,29,2023-04-18T17:59,0,151200
768,3133082,49,171000,0,90.0,6,2023-04-18T17:59,0,171000
769,3105866,50,89000,0,95.0,4,2023-04-18T17:59,-13350,75650
770,3105568,51,159000,0,0.0,0,2023-04-18T17:59,0,159000
771,2423986,52,179000,0,0.0,0,2023-04-18T17:59,-26850,152150
772,2664567,53,173000,0,100.0,4,2023-04-18T17:59,0,173000
773,3101970,54,158000,0,76.0,5,2023-04-18T17:59,0,158000
774,3139853,55,178000,0,0.0,0,2023-04-18T17:59,-26700,151300
775,3069542,56,152100,169000,0.0,0,2023-04-18T17:59,-22815,129285
776,3215947,57,169000,0,0.0,0,2023-04-18T17:59,-25350,143650
777,3074718,58,89000,0,0.0,0,2023-04-18T17:59,0,89000
778,3144374,59,71100,79000,100.0,7,2023-04-18T17:59,0,71100
779,2867750,60,135000,0,96.0,47,2023-04-18T17:59,0,135000
780,3119570,61,168300,198000,100.0,1,2023-04-18T17:59,0,168300
781,3154653,62,143100,159000,0.0,0,2023-04-18T17:59,-21465,121635
782,3206525,63,84550,89000,20.0,1,2023-04-18T17:59,0,84550
783,3120257,64,134100,149000,100.0,1,2023-04-18T17:59,0,134100
784,2416846,65,54000,67900,92.0,95,2023-04-18T17:59,0,54000
785,3092933,66,139000,0,80.0,1,2023-04-18T17:59,0,139000
786,2830808,67,139000,0,97.0,15,2023-04-18T17:59,0,139000
787,3216015,68,149000,0,0.0,0,2023-04-18T17:59,-22350,126650
788,2830762,69,139000,0,99.0,48,2023-04-18T17:59,0,139000
789,2684685,70,163000,0,100.0,1,2023-04-18T17:59,0,163000
790,3120581,71,152100,169000,100.0,5,2023-04-18T17:59,-22815,129285
791,2533486,72,37400,44000,96.0,78,2023-04-18T17:59,-3740,33660
792,2352881,73,39950,79900,98.0,314,2023-04-18T17:59,0,39950
793,2571671,74,149000,0,100.0,10,2023-04-18T17:59,0,149000
794,2643318,75,138000,0,94.0,17,2023-04-18T17:59,-20700,117300
795,2297694,76,155400,259000,0.0,0,2023-04-18T17:59,0,155400
796,3009236,77,55800,62000,100.0,6,2023-04-18T17:59,0,55800
797,3051039,78,83300,119000,100.0,40,2023-04-18T17:59,0,83300
798,3200164,79,125100,139000,0.0,0,2023-04-18T17:59,-18765,106335
799,3055929,80,57600,72000,100.0,10,2023-04-18T17:59,-11520,46080
800,3198566,81,39000,59000,80.0,4,2023-04-18T17:59,-5850,33150
801,3105350,82,52000,65000,96.0,10,2023-04-18T17:59,0,52000
802,1554351,83,129000,0,96.0,135,2023-04-18T17:59,0,129000
803,3154644,84,143100,159000,100.0,1,2023-04-18T17:59,-21465,121635
804,3115907,85,138000,0,100.0,3,2023-04-18T17:59,0,138000
805,3149629,86,139000,0,80.0,1,2023-04-18T17:59,-20850,118150
806,3153423,87,139000,0,100.0,1,2023-04-18T17:59,0,139000
807,2444229,88,55800,62000,100.0,29,2023-04-18T17:59,-8370,47430
808,3201984,89,63200,79000,0.0,0,2023-04-18T17:59,-12640,50560
809,2925522,90,65000,0,96.0,127,2023-04-18T17:59,0,65000
810,991339,1,17890,19900,97.0,53304,2023-04-18T17:59,0,17890
811,1986031,2,27900,0,97.0,10803,2023-04-18T17:59,0,27900
812,998051,3,15900,24000,97.0,164040,2023-04-18T17:59,0,15900
813,991340,4,17890,19900,97.0,31038,2023-04-18T17:59,0,17890
814,763821,5,16900,22000,96.0,31495,2023-04-18T17:59,0,16900
815,1477845,6,15400,22000,96.0,9796,2023-04-18T17:59,0,15400
816,1094748,7,19900,0,97.0,19277,2023-04-18T17:59,0,19900
817,1996702,8,25090,27900,97.0,1959,2023-04-18T17:59,0,25090
818,1094835,9,15900,0,97.0,6273,2023-04-18T17:59,0,15900
819,1342874,10,16900,33000,97.0,13001,2023-04-18T17:59,0,16900
820,792919,11,15190,16900,96.0,17984,2023-04-18T17:59,0,15190
821,746158,12,19390,22900,96.0,20565,2023-04-18T17:59,0,19390
822,3033249,13,15000,0,95.0,259,2023-04-18T17:59,0,15000
823,2845854,14,13000,18900,97.0,264,2023-04-18T17:59,-2600,10400
824,1092994,15,19390,22900,96.0,2664,2023-04-18T17:59,0,19390
825,1986029,16,25090,27900,97.0,3992,2023-04-18T17:59,0,25090
826,1443937,17,12900,24000,97.0,8147,2023-04-18T17:59,0,12900
827,1996705,18,23690,27900,98.0,2724,2023-04-18T17:59,0,23690
828,746154,19,17900,0,96.0,5209,2023-04-18T17:59,0,17900
829,734085,20,13900,19800,96.0,65069,2023-04-18T17:59,0,13900
830,991570,21,12900,20000,97.0,19138,2023-04-18T17:59,0,12900
831,1346009,22,9900,12000,97.0,6740,2023-04-18T17:59,-1485,8415
832,1986030,23,25090,27900,97.0,1698,2023-04-18T17:59,0,25090
833,1821485,24,30000,0,96.0,1288,2023-04-18T17:59,0,30000
834,1260383,25,19900,0,95.0,1466,2023-04-18T17:59,0,19900
835,746159,26,19390,22900,95.0,28752,2023-04-18T17:59,0,19390
836,2297277,27,19900,22000,95.0,314,2023-04-18T17:59,0,19900
837,2832613,28,11900,33000,97.0,759,2023-04-18T17:59,0,11900
838,991341,29,16890,19900,96.0,10267,2023-04-18T17:59,0,16890
839,792920,30,15190,16900,96.0,9687,2023-04-18T17:59,0,15190
840,2960555,31,19000,0,93.0,125,2023-04-18T17:59,0,19000
841,1094749,32,19900,0,96.0,4976,2023-04-18T17:59,0,19900
842,2821598,33,19390,22900,97.0,163,2023-04-18T17:59,0,19390
843,1358721,34,14900,22000,96.0,1151,2023-04-18T17:59,-2235,12665
844,479245,35,15400,22000,93.0,5435,2023-04-18T17:59,0,15400
845,1729576,36,9900,13900,97.0,16268,2023-04-18T17:59,-1485,8415
846,1094834,37,20290,23900,96.0,2467,2023-04-18T17:59,0,20290
847,1996704,38,22290,27900,97.0,721,2023-04-18T17:59,0,22290
848,1348077,39,10900,16500,97.0,1881,2023-04-18T17:59,0,10900
849,2011850,40,21490,23900,98.0,873,2023-04-18T17:59,0,21490
850,1260385,41,16890,19900,95.0,798,2023-04-18T17:59,0,16890
851,2346958,42,18900,24000,98.0,526,2023-04-18T17:59,-2835,16065
852,3083312,43,34200,38000,90.0,4,2023-04-18T17:59,-6840,27360
853,1974077,44,37490,46900,97.0,906,2023-04-18T17:59,0,37490
854,3083314,45,34200,38000,93.0,6,2023-04-18T17:59,-6840,27360
855,1475055,46,16900,22000,96.0,1183,2023-04-18T17:59,-2535,14365
856,2821588,47,19690,21900,97.0,56,2023-04-18T17:59,0,19690
857,2821597,48,22900,0,98.0,110,2023-04-18T17:59,0,22900
858,1475031,49,17900,27000,96.0,1744,2023-04-18T17:59,-2685,15215
859,1821487,50,30000,0,97.0,683,2023-04-18T17:59,0,30000
860,2477852,51,16890,19900,98.0,689,2023-04-18T17:59,0,16890
861,2509300,52,19900,0,96.0,401,2023-04-18T17:59,0,19900
862,2821589,53,19690,21900,96.0,41,2023-04-18T17:59,0,19690
863,1092996,54,19390,22900,95.0,767,2023-04-18T17:59,0,19390
864,1121544,55,15190,16900,96.0,870,2023-04-18T17:59,0,15190
865,2821599,56,20590,22900,97.0,123,2023-04-18T17:59,0,20590
866,472686,57,9900,14800,94.0,752,2023-04-18T17:59,0,9900
867,2870865,58,15900,19900,95.0,71,2023-04-18T17:59,-3180,12720
868,2347097,59,14900,24000,97.0,1605,2023-04-18T17:59,-2235,12665
869,2973409,60,28000,35000,100.0,21,2023-04-18T17:59,-1400,26600
870,2295818,61,19900,22000,95.0,190,2023-04-18T17:59,0,19900
871,2929635,62,16800,27000,97.0,555,2023-04-18T17:59,-2520,14280
872,1094836,63,15900,0,97.0,1329,2023-04-18T17:59,0,15900
873,1094837,64,13490,15900,96.0,1768,2023-04-18T17:59,0,13490
874,3106972,65,19900,0,94.0,10,2023-04-18T17:59,0,19900
875,2821590,66,19690,21900,98.0,49,2023-04-18T17:59,0,19690
876,3009680,67,12590,14900,98.0,134,2023-04-18T17:59,0,12590
877,1346070,68,9900,12000,97.0,1895,2023-04-18T17:59,-1485,8415
878,3197136,69,79000,0,0.0,0,2023-04-18T17:59,0,79000
879,2711708,70,29000,0,98.0,70,2023-04-18T17:59,0,29000
880,2584266,71,9900,12000,98.0,417,2023-04-18T17:59,-1485,8415
881,3230808,72,37800,42000,0.0,0,2023-04-18T17:59,0,37800
882,2255476,73,15200,19000,98.0,163,2023-04-18T17:59,-2280,12920
883,1062062,74,16890,19900,96.0,1457,2023-04-18T17:59,0,16890
884,2618262,75,39200,49000,97.0,27,2023-04-18T17:59,-1960,37240
885,2006930,76,9900,10900,97.0,423,2023-04-18T17:59,-1485,8415
886,2959925,77,22000,27500,98.0,128,2023-04-18T17:59,-1100,20900
887,752821,78,9900,0,94.0,23842,2023-04-18T17:59,0,9900
888,1260384,79,19900,0,95.0,1806,2023-04-18T17:59,0,19900
889,1547562,80,15400,22000,95.0,1371,2023-04-18T17:59,0,15400
890,1517383,81,25000,0,93.0,132,2023-04-18T17:59,0,25000
891,1777081,82,8000,12800,96.0,1245,2023-04-18T17:59,0,8000
892,2011852,83,21490,23900,97.0,1321,2023-04-18T17:59,0,21490
893,3065854,84,25000,0,97.0,22,2023-04-18T17:59,0,25000
894,3220488,85,18000,0,86.0,3,2023-04-18T17:59,0,18000
895,3118094,86,28800,32000,97.0,9,2023-04-18T17:59,0,28800
896,2973915,87,14850,16500,99.0,57,2023-04-18T17:59,-743,14107
897,1360043,88,17890,19900,97.0,792,2023-04-18T17:59,0,17890
898,2990345,89,27900,0,98.0,55,2023-04-18T17:59,0,27900
899,2959926,90,14850,16500,98.0,160,2023-04-18T17:59,-743,14107
