,item_id,rank,price,del_price,rating,rating_count,time,coupon,real_price
0,2272830,1,35910,39900,97.0,18583,2023-03-30T20:59,-3591,32319
1,2086653,2,16900,0,97.0,38794,2023-03-30T20:59,0,16900
2,2479911,3,49400,76000,97.0,4035,2023-03-30T20:59,0,49400
3,1848166,4,44100,49000,97.0,40797,2023-03-30T20:59,0,44100
4,2396645,5,39900,59000,96.0,23193,2023-03-30T20:59,0,39900
5,3165512,6,59000,62000,100.0,16,2023-03-30T20:59,0,59000
6,3071087,7,84550,89000,95.0,298,2023-03-30T20:59,0,84550
7,2149254,8,37800,0,97.0,32424,2023-03-30T20:59,-5670,32130
8,2996536,9,39900,59000,96.0,416,2023-03-30T20:59,0,39900
9,3034895,10,101150,119000,98.0,333,2023-03-30T20:59,0,101150
10,345889,11,29900,47900,95.0,9575,2023-03-30T20:59,0,29900
11,2314616,12,39000,43000,97.0,8083,2023-03-30T20:59,0,39000
12,1939099,13,34300,49000,97.0,11623,2023-03-30T20:59,0,34300
13,1582356,14,49200,82000,96.0,15996,2023-03-30T20:59,-2460,46740
14,2313388,15,76500,85000,96.0,2077,2023-03-30T20:59,0,76500
15,2375962,16,59000,62000,98.0,5213,2023-03-30T20:59,-8850,50150
16,3088318,17,113000,133000,100.0,4,2023-03-30T20:59,-16950,96050
17,3165437,18,59000,62000,100.0,6,2023-03-30T20:59,0,59000
18,1817394,19,59900,150000,93.0,7067,2023-03-30T20:59,0,59900
19,2684358,20,109000,0,97.0,3183,2023-03-30T20:59,0,109000
20,2442409,21,39000,78000,96.0,8733,2023-03-30T20:59,-7800,31200
21,2038497,22,36000,45000,95.0,16175,2023-03-30T20:59,-3600,32400
22,1706633,23,199000,0,97.0,2369,2023-03-30T20:59,0,199000
23,854337,24,33900,0,95.0,17179,2023-03-30T20:59,-3390,30510
24,996177,25,15900,0,95.0,77281,2023-03-30T20:59,0,15900
25,3034894,26,87200,109000,97.0,92,2023-03-30T20:59,0,87200
26,2326935,27,63200,79000,96.0,12839,2023-03-30T20:59,-12640,50560
27,3153427,28,48000,0,100.0,4,2023-03-30T20:59,-2400,45600
28,1763157,29,49400,52000,95.0,2596,2023-03-30T20:59,0,49400
29,2364807,30,219000,0,96.0,691,2023-03-30T20:59,0,219000
30,2122566,31,33800,0,97.0,15439,2023-03-30T20:59,-6760,27040
31,1498105,32,189000,0,97.0,1961,2023-03-30T20:59,0,189000
32,1828538,33,39900,69900,95.0,2879,2023-03-30T20:59,0,39900
33,1265162,34,39800,78000,95.0,11086,2023-03-30T20:59,-3980,35820
34,994588,35,39900,53000,93.0,5953,2023-03-30T20:59,0,39900
35,2877493,36,59800,92000,95.0,1348,2023-03-30T20:59,0,59800
36,3032250,37,44800,64000,96.0,758,2023-03-30T20:59,-8960,35840
37,2775713,38,39800,49000,93.0,2868,2023-03-30T20:59,-3980,35820
38,3165482,39,59000,62000,100.0,5,2023-03-30T20:59,0,59000
39,2851485,40,55300,68900,96.0,437,2023-03-30T20:59,0,55300
40,2453556,41,39900,42000,97.0,6192,2023-03-30T20:59,0,39900
41,2065708,42,59000,62000,98.0,6480,2023-03-30T20:59,-8850,50150
42,1943792,43,34400,43000,96.0,5237,2023-03-30T20:59,0,34400
43,1336398,44,40200,67000,96.0,18992,2023-03-30T20:59,0,40200
44,1608272,45,39800,65590,96.0,4034,2023-03-30T20:59,0,39800
45,2995119,46,39800,49800,96.0,490,2023-03-30T20:59,0,39800
46,1382658,47,16900,0,94.0,47179,2023-03-30T20:59,0,16900
47,956939,48,61750,65000,95.0,13476,2023-03-30T20:59,-12350,49400
48,2377269,49,45000,0,97.0,3782,2023-03-30T20:59,0,45000
49,2708999,50,49800,62500,96.0,603,2023-03-30T20:59,-7470,42330
50,1557508,51,27600,69000,96.0,14984,2023-03-30T20:59,0,27600
51,2065703,52,59000,62000,98.0,5403,2023-03-30T20:59,-8850,50150
52,2099802,53,62300,89000,97.0,3892,2023-03-30T20:59,0,62300
53,3065991,54,69000,0,0.0,0,2023-03-30T20:59,0,69000
54,2660716,55,50400,72000,96.0,2230,2023-03-30T20:59,0,50400
55,2913656,56,44900,64000,95.0,249,2023-03-30T20:59,-4490,40410
56,1417691,57,13900,0,97.0,18332,2023-03-30T20:59,0,13900
57,2374814,58,62400,104000,98.0,1168,2023-03-30T20:59,-3120,59280
58,3002774,59,62100,69000,97.0,232,2023-03-30T20:59,-6210,55890
59,404474,60,27900,47800,94.0,44037,2023-03-30T20:59,0,27900
60,3153428,61,48000,0,0.0,0,2023-03-30T20:59,-2400,45600
61,2226767,62,68400,76000,97.0,7144,2023-03-30T20:59,0,68400
62,2392759,63,39900,49600,95.0,3917,2023-03-30T20:59,-7980,31920
63,1884943,64,29900,39000,96.0,18808,2023-03-30T20:59,0,29900
64,2194649,65,63000,79000,96.0,4263,2023-03-30T20:59,-3150,59850
65,407067,66,29250,39000,95.0,21413,2023-03-30T20:59,0,29250
66,1776344,67,34500,69000,96.0,5032,2023-03-30T20:59,0,34500
67,3043740,68,49700,59000,95.0,4,2023-03-30T20:59,0,49700
68,2970541,69,62100,69000,96.0,539,2023-03-30T20:59,0,62100
69,3043051,70,76500,85000,96.0,53,2023-03-30T20:59,0,76500
70,3052036,71,59400,66000,95.0,120,2023-03-30T20:59,0,59400
71,2032985,72,101150,119000,97.0,1797,2023-03-30T20:59,0,101150
72,2171559,73,39900,54000,97.0,4128,2023-03-30T20:59,0,39900
73,1841764,74,31200,39000,96.0,13001,2023-03-30T20:59,-6240,24960
74,2913659,75,44900,64000,96.0,259,2023-03-30T20:59,-4490,40410
75,1685307,76,19900,0,96.0,14015,2023-03-30T20:59,0,19900
76,3106728,77,38700,43000,96.0,6,2023-03-30T20:59,0,38700
77,1503352,78,39900,42000,97.0,8337,2023-03-30T20:59,0,39900
78,3026606,79,44900,64000,96.0,157,2023-03-30T20:59,-4490,40410
79,3150516,80,79800,126000,93.0,16,2023-03-30T20:59,-3990,75810
80,3039672,81,58700,69000,98.0,337,2023-03-30T20:59,0,58700
81,2085005,82,58650,69000,95.0,2037,2023-03-30T20:59,-2933,55717
82,3010631,83,63200,79000,97.0,208,2023-03-30T20:59,-12640,50560
83,3163734,84,67150,79000,100.0,4,2023-03-30T20:59,0,67150
84,3010633,85,71200,89000,97.0,104,2023-03-30T20:59,-14240,56960
85,1574201,86,71100,79000,97.0,4546,2023-03-30T20:59,0,71100
86,1763123,87,84550,89000,96.0,1652,2023-03-30T20:59,-4228,80322
87,1336290,88,40200,67000,96.0,13652,2023-03-30T20:59,0,40200
88,2364804,89,239000,0,97.0,85,2023-03-30T20:59,0,239000
89,2722805,90,71100,79000,96.0,905,2023-03-30T20:59,0,71100
90,1558197,1,73690,81900,97.0,32059,2023-03-30T20:59,-7369,66321
91,1778404,2,42000,45000,96.0,66647,2023-03-30T20:59,0,42000
92,1790383,3,59000,86000,95.0,5248,2023-03-30T20:59,-5900,53100
93,1576700,4,89000,129000,97.0,16489,2023-03-30T20:59,0,89000
94,1283757,5,75490,83900,96.0,26501,2023-03-30T20:59,-7549,67941
95,3058373,6,189000,210000,99.0,62,2023-03-30T20:59,0,189000
96,2723218,7,69900,109000,97.0,2003,2023-03-30T20:59,-6990,62910
97,1530516,8,69900,79000,96.0,2201,2023-03-30T20:59,0,69900
98,2064545,9,79800,94000,97.0,10933,2023-03-30T20:59,-3990,75810
99,3010527,10,237150,279000,98.0,170,2023-03-30T20:59,0,237150
100,2110493,11,389000,0,96.0,613,2023-03-30T20:59,0,389000
101,3012082,12,59900,79000,97.0,829,2023-03-30T20:59,0,59900
102,841230,13,154000,172000,96.0,7212,2023-03-30T20:59,0,154000
103,1337094,14,69900,0,95.0,5284,2023-03-30T20:59,-6990,62910
104,1530517,15,69900,79000,96.0,1990,2023-03-30T20:59,0,69900
105,2403367,16,146000,0,97.0,586,2023-03-30T20:59,0,146000
106,2788216,17,146000,159000,98.0,87,2023-03-30T20:59,0,146000
107,1195307,18,82400,103000,96.0,12512,2023-03-30T20:59,-8240,74160
108,2715055,19,159000,189000,97.0,1935,2023-03-30T20:59,-31800,127200
109,1108007,20,79900,0,95.0,47813,2023-03-30T20:59,-7990,71910
110,1618312,21,83900,0,97.0,7010,2023-03-30T20:59,0,83900
111,1833230,22,95200,136000,97.0,5364,2023-03-30T20:59,0,95200
112,2184463,23,389000,0,98.0,382,2023-03-30T20:59,0,389000
113,1571879,24,79900,112900,96.0,6979,2023-03-30T20:59,0,79900
114,1778408,25,42000,45000,95.0,11537,2023-03-30T20:59,0,42000
115,2375909,26,80890,89900,97.0,1489,2023-03-30T20:59,0,80890
116,1280576,27,37200,62000,96.0,25065,2023-03-30T20:59,-7440,29760
117,1856181,28,35910,39900,97.0,7061,2023-03-30T20:59,-3591,32319
118,2712632,29,107000,0,97.0,1295,2023-03-30T20:59,0,107000
119,3010524,30,237150,279000,100.0,31,2023-03-30T20:59,0,237150
120,1571878,31,79900,112900,96.0,4603,2023-03-30T20:59,0,79900
121,1337096,32,69900,0,96.0,2866,2023-03-30T20:59,-6990,62910
122,2343199,33,119000,129000,98.0,1752,2023-03-30T20:59,0,119000
123,2297046,34,159200,199000,97.0,1650,2023-03-30T20:59,-31840,127360
124,1576682,35,245000,339000,97.0,8522,2023-03-30T20:59,0,245000
125,3033224,36,59900,74000,96.0,531,2023-03-30T20:59,0,59900
126,3054929,37,99900,0,97.0,35,2023-03-30T20:59,-9990,89910
127,1731130,38,143200,179000,96.0,1755,2023-03-30T20:59,-28640,114560
128,2704962,39,69300,99000,97.0,8361,2023-03-30T20:59,-13860,55440
129,1558683,40,81900,0,97.0,6151,2023-03-30T20:59,-8190,73710
130,3131837,41,74000,95000,97.0,16,2023-03-30T20:59,-7400,66600
131,2732486,42,109000,179000,98.0,594,2023-03-30T20:59,0,109000
132,1737051,43,62300,89000,96.0,5050,2023-03-30T20:59,0,62300
133,3039655,44,69700,83000,96.0,467,2023-03-30T20:59,0,69700
134,3030665,45,139200,174000,96.0,180,2023-03-30T20:59,0,139200
135,3042936,46,90900,105000,97.0,289,2023-03-30T20:59,0,90900
136,2723216,47,69900,109000,97.0,993,2023-03-30T20:59,-6990,62910
137,3030734,48,149600,187000,97.0,140,2023-03-30T20:59,0,149600
138,2322836,49,139200,174000,97.0,976,2023-03-30T20:59,0,139200
139,1790382,50,59000,86000,94.0,1526,2023-03-30T20:59,-5900,53100
140,2471405,51,89000,138000,97.0,1978,2023-03-30T20:59,0,89000
141,1873073,52,75490,83900,97.0,4028,2023-03-30T20:59,-7549,67941
142,2752332,53,94700,105300,95.0,2443,2023-03-30T20:59,0,94700
143,2159724,54,29900,32000,95.0,2171,2023-03-30T20:59,0,29900
144,2381781,55,211650,249000,98.0,822,2023-03-30T20:59,0,211650
145,3061176,56,799000,0,96.0,20,2023-03-30T20:59,0,799000
146,1593755,57,89360,111700,97.0,14404,2023-03-30T20:59,-17872,71488
147,1567183,58,75900,94900,97.0,7377,2023-03-30T20:59,-7590,68310
148,2343198,59,119000,129000,97.0,4931,2023-03-30T20:59,0,119000
149,2407203,60,148500,165000,97.0,281,2023-03-30T20:59,0,148500
150,1751722,61,53910,59900,97.0,3305,2023-03-30T20:59,-5391,48519
151,3048143,62,163800,182000,96.0,338,2023-03-30T20:59,0,163800
152,1291017,63,67900,96000,95.0,12875,2023-03-30T20:59,0,67900
153,2683529,64,69300,99000,97.0,3879,2023-03-30T20:59,-13860,55440
154,3055246,65,159000,0,98.0,35,2023-03-30T20:59,0,159000
155,3054930,66,99900,0,97.0,23,2023-03-30T20:59,-9990,89910
156,2086731,67,95000,129000,97.0,2170,2023-03-30T20:59,0,95000
157,2100438,68,63890,79900,97.0,3676,2023-03-30T20:59,-6389,57501
158,1558688,69,73690,81900,97.0,5676,2023-03-30T20:59,-7369,66321
159,2329532,70,119200,149000,97.0,3900,2023-03-30T20:59,0,119200
160,2718413,71,126650,149000,97.0,1360,2023-03-30T20:59,0,126650
161,2732408,72,207200,259000,97.0,67,2023-03-30T20:59,-41440,165760
162,3042244,73,159200,199000,97.0,56,2023-03-30T20:59,-31840,127360
163,1873074,74,75490,83900,97.0,3068,2023-03-30T20:59,-7549,67941
164,2286964,75,66300,110500,97.0,4791,2023-03-30T20:59,-9945,56355
165,3029811,76,63200,79000,97.0,194,2023-03-30T20:59,0,63200
166,3054935,77,89900,0,100.0,7,2023-03-30T20:59,0,89900
167,3046035,78,125100,139000,97.0,60,2023-03-30T20:59,-12510,112590
168,3019678,79,223200,248000,96.0,45,2023-03-30T20:59,-22320,200880
169,2284220,80,79900,112900,96.0,1640,2023-03-30T20:59,0,79900
170,2288426,81,79000,109000,94.0,783,2023-03-30T20:59,0,79000
171,3091295,82,169000,0,84.0,9,2023-03-30T20:59,0,169000
172,1139192,83,71100,94900,97.0,14307,2023-03-30T20:59,-7110,63990
173,3019696,84,268200,298000,100.0,78,2023-03-30T20:59,-26820,241380
174,3037477,85,69900,109000,97.0,194,2023-03-30T20:59,-6990,62910
175,2293391,86,98000,124000,96.0,1766,2023-03-30T20:59,-4900,93100
176,2357957,87,126650,149000,97.0,2125,2023-03-30T20:59,0,126650
177,2701889,88,58200,97000,95.0,4121,2023-03-30T20:59,0,58200
178,3098417,89,189000,199000,97.0,483,2023-03-30T20:59,-37800,151200
179,3142080,90,440000,0,100.0,5,2023-03-30T20:59,0,440000
180,1149329,1,39900,0,96.0,85524,2023-03-30T20:59,-3990,35910
181,2112059,2,36400,52000,97.0,42313,2023-03-30T20:59,-3640,32760
182,1551840,3,39000,0,97.0,83043,2023-03-30T20:59,-3900,35100
183,750908,4,34900,54000,96.0,83571,2023-03-30T20:59,0,34900
184,1627892,5,43900,0,97.0,10494,2023-03-30T20:59,0,43900
185,1168906,6,41900,0,97.0,70649,2023-03-30T20:59,-4190,37710
186,2060719,7,55200,69000,96.0,4921,2023-03-30T20:59,-2760,52440
187,1149328,8,39900,0,96.0,94271,2023-03-30T20:59,-3990,35910
188,2092852,9,42000,52800,96.0,10858,2023-03-30T20:59,-2100,39900
189,2028327,10,49900,0,97.0,8851,2023-03-30T20:59,-4990,44910
190,858911,11,44100,49000,95.0,66634,2023-03-30T20:59,0,44100
191,1551839,12,39000,0,97.0,23176,2023-03-30T20:59,-3900,35100
192,1370101,13,37500,89000,96.0,22551,2023-03-30T20:59,-1875,35625
193,1568057,14,43400,62000,96.0,22028,2023-03-30T20:59,0,43400
194,2112061,15,33900,52000,97.0,14361,2023-03-30T20:59,0,33900
195,1552753,16,62400,78000,97.0,28018,2023-03-30T20:59,-6240,56160
196,2060717,17,47800,69000,95.0,3637,2023-03-30T20:59,-2390,45410
197,396185,18,109000,0,95.0,8687,2023-03-30T20:59,-21800,87200
198,3091296,19,129000,0,85.0,19,2023-03-30T20:59,0,129000
199,1222184,20,41900,0,97.0,48157,2023-03-30T20:59,-4190,37710
200,2028326,21,49900,0,97.0,6005,2023-03-30T20:59,-4990,44910
201,1736085,22,39900,59800,96.0,36310,2023-03-30T20:59,0,39900
202,2723714,23,52000,58000,96.0,1419,2023-03-30T20:59,0,52000
203,1573215,24,133200,148000,98.0,9204,2023-03-30T20:59,0,133200
204,2737165,25,69000,79000,96.0,2553,2023-03-30T20:59,-10350,58650
205,1854665,26,139000,0,97.0,1036,2023-03-30T20:59,0,139000
206,2131950,27,44100,49000,96.0,3695,2023-03-30T20:59,0,44100
207,1555407,28,62400,78000,97.0,11415,2023-03-30T20:59,-6240,56160
208,2060720,29,55200,69000,95.0,2468,2023-03-30T20:59,-2760,52440
209,2351467,30,39800,54000,96.0,5942,2023-03-30T20:59,-3980,35820
210,2611226,31,43900,0,98.0,1102,2023-03-30T20:59,0,43900
211,2789091,32,79200,99000,96.0,663,2023-03-30T20:59,-3960,75240
212,1477272,33,44200,68000,96.0,17666,2023-03-30T20:59,0,44200
213,2569078,34,71100,79000,96.0,2383,2023-03-30T20:59,0,71100
214,2706287,35,39800,54000,95.0,3576,2023-03-30T20:59,-3980,35820
215,2107115,36,121500,135000,98.0,11634,2023-03-30T20:59,0,121500
216,2184087,37,44500,89000,96.0,3984,2023-03-30T20:59,-2225,42275
217,1627893,38,43900,0,97.0,1918,2023-03-30T20:59,0,43900
218,890338,39,44100,49000,95.0,47524,2023-03-30T20:59,0,44100
219,2060759,40,59800,74800,97.0,7078,2023-03-30T20:59,-8970,50830
220,2789111,41,79200,99000,97.0,771,2023-03-30T20:59,-3960,75240
221,2032901,42,39900,0,97.0,6698,2023-03-30T20:59,-3990,35910
222,2297033,43,119200,149000,97.0,1800,2023-03-30T20:59,-23840,95360
223,2319844,44,85600,107000,98.0,3812,2023-03-30T20:59,0,85600
224,2749153,45,66600,74000,97.0,514,2023-03-30T20:59,0,66600
225,1731127,46,111200,139000,96.0,2141,2023-03-30T20:59,-22240,88960
226,1568032,47,43400,62000,96.0,6024,2023-03-30T20:59,0,43400
227,1403480,48,77000,98000,97.0,7682,2023-03-30T20:59,-11550,65450
228,241111,49,69000,0,96.0,10515,2023-03-30T20:59,-13800,55200
229,1595607,50,57900,89000,97.0,5638,2023-03-30T20:59,-5790,52110
230,1666442,51,49900,0,97.0,10833,2023-03-30T20:59,0,49900
231,2411327,52,65000,139000,97.0,3991,2023-03-30T20:59,-13000,52000
232,1736562,53,39000,0,97.0,5939,2023-03-30T20:59,-3900,35100
233,3061200,54,115000,0,98.0,382,2023-03-30T20:59,0,115000
234,2028329,55,49900,0,96.0,6430,2023-03-30T20:59,-4990,44910
235,2060743,56,33000,55000,95.0,3457,2023-03-30T20:59,0,33000
236,2069525,57,41900,0,96.0,3669,2023-03-30T20:59,-4190,37710
237,1960424,58,49500,59000,95.0,1105,2023-03-30T20:59,0,49500
238,2392464,59,27090,33900,94.0,3673,2023-03-30T20:59,0,27090
239,2358429,60,159000,0,98.0,2582,2023-03-30T20:59,0,159000
240,1224095,61,35890,39900,97.0,24262,2023-03-30T20:59,-3589,32301
241,3098372,62,109000,139000,97.0,723,2023-03-30T20:59,-21800,87200
242,890521,63,39800,63000,94.0,10952,2023-03-30T20:59,0,39800
243,1168922,64,43900,0,96.0,18066,2023-03-30T20:59,-4390,39510
244,1246215,65,52000,65000,96.0,6264,2023-03-30T20:59,0,52000
245,2744549,66,43400,62000,97.0,4915,2023-03-30T20:59,0,43400
246,2092849,67,42000,52800,96.0,9638,2023-03-30T20:59,-2100,39900
247,2391746,68,49900,0,95.0,1714,2023-03-30T20:59,-4990,44910
248,1924274,69,49900,66000,95.0,22406,2023-03-30T20:59,-4990,44910
249,2827702,70,59800,87500,96.0,414,2023-03-30T20:59,-8970,50830
250,3022892,71,44100,49000,96.0,328,2023-03-30T20:59,0,44100
251,2720861,72,76300,109000,98.0,1217,2023-03-30T20:59,0,76300
252,1926048,73,32000,0,97.0,14533,2023-03-30T20:59,-3200,28800
253,3070909,74,125100,139000,100.0,4,2023-03-30T20:59,0,125100
254,3043287,75,209000,0,100.0,4,2023-03-30T20:59,0,209000
255,2711142,76,39800,54000,96.0,909,2023-03-30T20:59,-3980,35820
256,1212776,77,28690,31900,96.0,23156,2023-03-30T20:59,0,28690
257,1323090,78,73600,92000,96.0,5928,2023-03-30T20:59,-7360,66240
258,3106260,79,43000,59000,97.0,9,2023-03-30T20:59,0,43000
259,3039551,80,68800,86000,98.0,365,2023-03-30T20:59,0,68800
260,2408345,81,76300,109000,97.0,1817,2023-03-30T20:59,0,76300
261,3141395,82,49900,73900,97.0,101,2023-03-30T20:59,-4990,44910
262,3046400,83,91000,99000,100.0,3,2023-03-30T20:59,-9100,81900
263,3188763,84,156000,0,0.0,0,2023-03-30T20:59,0,156000
264,1168907,85,39900,0,96.0,9690,2023-03-30T20:59,-3990,35910
265,3062950,86,125100,139000,99.0,22,2023-03-30T20:59,0,125100
266,2562527,87,29400,42000,97.0,3898,2023-03-30T20:59,-4410,24990
267,3098405,88,119000,149000,97.0,698,2023-03-30T20:59,-23800,95200
268,3043508,89,71200,89000,98.0,77,2023-03-30T20:59,-3560,67640
269,2708877,90,34800,49800,95.0,958,2023-03-30T20:59,0,34800
270,1789507,1,69900,79000,98.0,25644,2023-03-30T20:59,-6990,62910
271,3050557,2,2027000,3290000,0.0,0,2023-03-30T20:59,0,2027000
272,1969507,3,88000,0,98.0,5280,2023-03-30T20:59,0,88000
273,1034480,4,135000,150000,97.0,17925,2023-03-30T20:59,0,135000
274,3034751,5,64800,72000,97.0,364,2023-03-30T20:59,0,64800
275,693318,6,79000,110000,96.0,13111,2023-03-30T20:59,0,79000
276,1835080,7,98000,0,97.0,2718,2023-03-30T20:59,0,98000
277,3038000,8,66400,83000,96.0,293,2023-03-30T20:59,-9960,56440
278,2344538,9,119000,0,98.0,6285,2023-03-30T20:59,0,119000
279,2344540,10,96000,0,98.0,9108,2023-03-30T20:59,0,96000
280,2770508,11,138000,0,97.0,320,2023-03-30T20:59,0,138000
281,3034749,12,64800,72000,97.0,366,2023-03-30T20:59,0,64800
282,2558648,13,119000,0,98.0,1228,2023-03-30T20:59,0,119000
283,1264107,14,65000,90000,97.0,6248,2023-03-30T20:59,0,65000
284,1744101,15,103500,109000,98.0,2856,2023-03-30T20:59,0,103500
285,2702033,16,127200,159000,97.0,376,2023-03-30T20:59,-25440,101760
286,2329567,17,99000,115000,96.0,314,2023-03-30T20:59,0,99000
287,1969488,18,88000,0,98.0,1706,2023-03-30T20:59,0,88000
288,2320927,19,39000,51000,97.0,2041,2023-03-30T20:59,-3900,35100
289,2271789,20,71100,79000,97.0,2459,2023-03-30T20:59,0,71100
290,1581689,21,75600,89000,97.0,3925,2023-03-30T20:59,-3780,71820
291,2584181,22,57600,72000,98.0,855,2023-03-30T20:59,0,57600
292,2235274,23,145000,0,98.0,660,2023-03-30T20:59,0,145000
293,1842449,24,84000,99000,97.0,5324,2023-03-30T20:59,0,84000
294,1528287,25,46500,49000,96.0,4533,2023-03-30T20:59,0,46500
295,2577899,26,138000,0,98.0,290,2023-03-30T20:59,0,138000
296,1564343,27,92800,119000,98.0,8061,2023-03-30T20:59,-6496,86304
297,3110258,28,2492000,4850000,0.0,0,2023-03-30T20:59,0,2492000
298,2993239,29,1870000,2268000,0.0,0,2023-03-30T20:59,0,1870000
299,2066837,30,69000,119000,97.0,6371,2023-03-30T20:59,-13800,55200
300,3029922,31,295000,0,96.0,81,2023-03-30T20:59,0,295000
301,2371564,32,888000,1072000,100.0,3,2023-03-30T20:59,0,888000
302,2744318,33,143100,159000,98.0,272,2023-03-30T20:59,0,143100
303,2657250,34,125400,149000,98.0,103,2023-03-30T20:59,0,125400
304,342189,35,39500,52000,95.0,15656,2023-03-30T20:59,0,39500
305,2777025,36,308000,485000,100.0,46,2023-03-30T20:59,0,308000
306,913402,37,83000,98000,95.0,8012,2023-03-30T20:59,0,83000
307,3045584,38,130500,145000,97.0,3748,2023-03-30T20:59,-13050,117450
308,2514819,39,55000,66000,97.0,779,2023-03-30T20:59,-2750,52250
309,2921768,40,1600000,2268000,0.0,0,2023-03-30T20:59,0,1600000
310,1910358,41,89100,99000,98.0,2438,2023-03-30T20:59,0,89100
311,2954959,42,95000,0,95.0,179,2023-03-30T20:59,0,95000
312,3183300,43,128000,0,0.0,0,2023-03-30T20:59,0,128000
313,1736022,44,169200,188000,95.0,418,2023-03-30T20:59,-16920,152280
314,2930578,45,1508000,2290000,100.0,5,2023-03-30T20:59,0,1508000
315,1597319,46,89100,99000,97.0,566,2023-03-30T20:59,-8910,80190
316,2902214,47,229000,400000,99.0,45,2023-03-30T20:59,0,229000
317,2979853,48,1391000,1670000,0.0,0,2023-03-30T20:59,0,1391000
318,3047568,49,109650,129000,95.0,32,2023-03-30T20:59,0,109650
319,2789785,50,140600,148000,97.0,565,2023-03-30T20:59,0,140600
320,2401552,51,1285000,1900000,100.0,4,2023-03-30T20:59,0,1285000
321,2630526,52,100000,0,96.0,591,2023-03-30T20:59,0,100000
322,1745100,53,103500,109000,97.0,975,2023-03-30T20:59,0,103500
323,3029926,54,285000,0,99.0,42,2023-03-30T20:59,-28500,256500
324,2982246,55,43000,0,95.0,153,2023-03-30T20:59,0,43000
325,2344209,56,109000,0,97.0,581,2023-03-30T20:59,0,109000
326,2668409,57,1220000,1820000,100.0,9,2023-03-30T20:59,0,1220000
327,2902040,58,390000,600000,100.0,35,2023-03-30T20:59,0,390000
328,2688406,59,520000,1137000,96.0,25,2023-03-30T20:59,0,520000
329,3020963,60,379000,0,100.0,4,2023-03-30T20:59,0,379000
330,2377589,61,128000,0,97.0,394,2023-03-30T20:59,0,128000
331,1758217,62,43900,56000,97.0,13068,2023-03-30T20:59,-2195,41705
332,1969479,63,88000,0,98.0,1093,2023-03-30T20:59,0,88000
333,3034745,64,75600,84000,97.0,143,2023-03-30T20:59,0,75600
334,2343665,65,89000,0,97.0,4511,2023-03-30T20:59,0,89000
335,1493177,66,150400,188000,97.0,1873,2023-03-30T20:59,-22560,127840
336,2002697,67,67900,76000,97.0,3428,2023-03-30T20:59,-6790,61110
337,2930265,68,91000,0,98.0,522,2023-03-30T20:59,0,91000
338,1263004,69,159000,0,97.0,5236,2023-03-30T20:59,0,159000
339,2688604,70,139000,159000,97.0,820,2023-03-30T20:59,-13900,125100
340,2954961,71,95000,0,96.0,357,2023-03-30T20:59,0,95000
341,2809008,72,970000,1225000,92.0,13,2023-03-30T20:59,0,970000
342,2408317,73,145800,162000,96.0,350,2023-03-30T20:59,-14580,131220
343,2789784,74,150100,158000,97.0,172,2023-03-30T20:59,0,150100
344,1323612,75,238000,0,97.0,3809,2023-03-30T20:59,-11900,226100
345,2998775,76,142200,158000,96.0,445,2023-03-30T20:59,0,142200
346,1534526,77,52200,55000,97.0,2396,2023-03-30T20:59,0,52200
347,2679537,78,145800,162000,95.0,90,2023-03-30T20:59,-14580,131220
348,1256451,79,49700,89000,97.0,4265,2023-03-30T20:59,0,49700
349,2974396,80,924000,0,0.0,0,2023-03-30T20:59,-20000,904000
350,1766527,81,136000,169000,97.0,1340,2023-03-30T20:59,-13600,122400
351,1884626,82,36800,46000,97.0,4886,2023-03-30T20:59,0,36800
352,2911060,83,413000,650000,100.0,9,2023-03-30T20:59,0,413000
353,1964770,84,59400,66000,97.0,2454,2023-03-30T20:59,0,59400
354,1456515,85,49500,55000,97.0,8683,2023-03-30T20:59,0,49500
355,1247560,86,69900,79000,96.0,4242,2023-03-30T20:59,-6990,62910
356,2422175,87,145800,162000,98.0,192,2023-03-30T20:59,0,145800
357,2973716,88,815000,1160000,93.0,6,2023-03-30T20:59,0,815000
358,2688927,89,65600,82000,97.0,618,2023-03-30T20:59,-9840,55760
359,3038001,90,66400,83000,97.0,57,2023-03-30T20:59,-9960,56440
360,1762407,1,260000,0,97.0,3082,2023-03-30T20:59,0,260000
361,490136,2,56900,95000,98.0,2070,2023-03-30T20:59,0,56900
362,1762406,3,260000,0,98.0,3249,2023-03-30T20:59,0,260000
363,969541,4,69000,0,97.0,29199,2023-03-30T20:59,0,69000
364,810034,5,85500,95000,97.0,45085,2023-03-30T20:59,0,85500
365,2638067,6,99000,139000,97.0,2928,2023-03-30T20:59,0,99000
366,311052,7,53100,59000,97.0,41027,2023-03-30T20:59,0,53100
367,2992063,8,280000,0,98.0,2142,2023-03-30T20:59,0,280000
368,2293400,9,129000,0,96.0,902,2023-03-30T20:59,0,129000
369,695334,10,63900,99000,96.0,9221,2023-03-30T20:59,0,63900
370,2731878,11,44900,79000,97.0,1531,2023-03-30T20:59,0,44900
371,1622068,12,119000,0,97.0,6479,2023-03-30T20:59,0,119000
372,2161992,13,56900,95000,98.0,3189,2023-03-30T20:59,0,56900
373,490135,14,59900,95000,97.0,3162,2023-03-30T20:59,0,59900
374,3033248,15,109000,0,97.0,583,2023-03-30T20:59,0,109000
375,2320478,16,129000,0,97.0,466,2023-03-30T20:59,0,129000
376,186610,17,75900,85000,97.0,16458,2023-03-30T20:59,0,75900
377,181907,18,89900,119000,97.0,7051,2023-03-30T20:59,0,89900
378,810033,19,89100,99000,97.0,34193,2023-03-30T20:59,0,89100
379,1990244,20,129000,0,98.0,1039,2023-03-30T20:59,0,129000
380,3005191,21,169000,0,96.0,155,2023-03-30T20:59,0,169000
381,2622254,22,109000,0,98.0,858,2023-03-30T20:59,0,109000
382,1792640,23,99000,0,98.0,3453,2023-03-30T20:59,0,99000
383,102620,24,69000,0,97.0,17743,2023-03-30T20:59,0,69000
384,1478592,25,59900,95000,97.0,2923,2023-03-30T20:59,0,59900
385,2741233,26,109000,0,97.0,2628,2023-03-30T20:59,0,109000
386,816033,27,70900,89000,96.0,13211,2023-03-30T20:59,0,70900
387,1686571,28,76900,129000,97.0,5361,2023-03-30T20:59,0,76900
388,810032,29,85500,95000,97.0,13700,2023-03-30T20:59,0,85500
389,3030422,30,139000,0,96.0,779,2023-03-30T20:59,0,139000
390,490134,31,54900,95000,97.0,1946,2023-03-30T20:59,0,54900
391,1900410,32,129000,0,97.0,4854,2023-03-30T20:59,0,129000
392,3091287,33,119000,0,98.0,233,2023-03-30T20:59,0,119000
393,3079037,34,195000,0,97.0,190,2023-03-30T20:59,0,195000
394,2786814,35,149000,0,98.0,165,2023-03-30T20:59,0,149000
395,577636,36,99900,139000,95.0,31065,2023-03-30T20:59,0,99900
396,1955217,37,69000,109000,96.0,5116,2023-03-30T20:59,-13800,55200
397,1296778,38,99000,0,98.0,2052,2023-03-30T20:59,0,99000
398,1963478,39,170000,0,97.0,421,2023-03-30T20:59,0,170000
399,2737457,40,230000,0,98.0,432,2023-03-30T20:59,0,230000
400,2233180,41,75900,109000,97.0,14125,2023-03-30T20:59,0,75900
401,2778805,42,99000,0,97.0,933,2023-03-30T20:59,0,99000
402,2777005,43,497000,815000,95.0,32,2023-03-30T20:59,0,497000
403,1493265,44,85500,95000,98.0,4855,2023-03-30T20:59,0,85500
404,311050,45,53100,59000,97.0,8985,2023-03-30T20:59,0,53100
405,1473136,46,119900,149000,97.0,10756,2023-03-30T20:59,0,119900
406,2662649,47,485000,790000,98.0,189,2023-03-30T20:59,0,485000
407,3023097,48,230000,0,98.0,84,2023-03-30T20:59,0,230000
408,2909715,49,119000,0,96.0,74,2023-03-30T20:59,0,119000
409,1494180,50,71100,79000,95.0,5210,2023-03-30T20:59,0,71100
410,2268512,51,109000,0,97.0,414,2023-03-30T20:59,0,109000
411,3096431,52,139000,0,99.0,24,2023-03-30T20:59,0,139000
412,1608838,53,85000,0,97.0,12572,2023-03-30T20:59,0,85000
413,1354129,54,67000,99000,95.0,8661,2023-03-30T20:59,-13400,53600
414,2524840,55,139000,0,97.0,807,2023-03-30T20:59,0,139000
415,2861393,56,109900,139000,93.0,266,2023-03-30T20:59,0,109900
416,2916273,57,159000,0,98.0,145,2023-03-30T20:59,0,159000
417,2440110,58,53910,59900,97.0,886,2023-03-30T20:59,-4010,49900
418,2784035,59,743000,0,84.0,5,2023-03-30T20:59,0,743000
419,3181961,60,149000,0,100.0,3,2023-03-30T20:59,0,149000
420,2737458,61,230000,0,98.0,644,2023-03-30T20:59,0,230000
421,716244,62,69900,95000,98.0,1106,2023-03-30T20:59,0,69900
422,1130307,63,109000,0,97.0,6033,2023-03-30T20:59,0,109000
423,2469965,64,94900,149000,96.0,1082,2023-03-30T20:59,0,94900
424,311051,65,58500,65000,97.0,19520,2023-03-30T20:59,0,58500
425,1955210,66,69000,109000,95.0,1483,2023-03-30T20:59,-13800,55200
426,1868015,67,119900,129000,97.0,1920,2023-03-30T20:59,0,119900
427,1798273,68,75000,119000,96.0,1155,2023-03-30T20:59,0,75000
428,2233178,69,75900,109000,97.0,4924,2023-03-30T20:59,0,75900
429,2312772,70,69900,139800,96.0,1342,2023-03-30T20:59,0,69900
430,1635193,71,59390,69900,96.0,3645,2023-03-30T20:59,-5939,53451
431,2355071,72,265000,0,98.0,480,2023-03-30T20:59,0,265000
432,1718449,73,85500,95000,97.0,2076,2023-03-30T20:59,0,85500
433,2801307,74,424000,700000,98.0,66,2023-03-30T20:59,0,424000
434,3109771,75,133900,149000,96.0,12,2023-03-30T20:59,0,133900
435,3173049,76,129000,0,100.0,4,2023-03-30T20:59,0,129000
436,1770461,77,150000,0,97.0,32,2023-03-30T20:59,0,150000
437,2622252,78,109000,0,97.0,210,2023-03-30T20:59,0,109000
438,2267008,79,89100,99000,98.0,495,2023-03-30T20:59,0,89100
439,2631192,80,98100,109000,98.0,337,2023-03-30T20:59,0,98100
440,1729744,81,76500,85000,97.0,3319,2023-03-30T20:59,0,76500
441,2456728,82,29000,59000,96.0,89,2023-03-30T20:59,-5800,23200
442,810036,83,85500,95000,97.0,5108,2023-03-30T20:59,0,85500
443,2786813,84,149000,0,94.0,216,2023-03-30T20:59,0,149000
444,3034470,85,115000,129000,97.0,46,2023-03-30T20:59,0,115000
445,1017974,86,71100,79000,95.0,2926,2023-03-30T20:59,0,71100
446,2030626,87,103500,115000,97.0,8039,2023-03-30T20:59,0,103500
447,1493263,88,89100,99000,98.0,4178,2023-03-30T20:59,0,89100
448,957758,89,89000,0,97.0,4373,2023-03-30T20:59,0,89000
449,3136271,90,89100,99000,0.0,0,2023-03-30T20:59,0,89100
450,1092992,1,69000,0,97.0,37660,2023-03-30T20:59,0,69000
451,2091749,2,75650,89000,95.0,6181,2023-03-30T20:59,0,75650
452,1262089,3,300000,0,97.0,1580,2023-03-30T20:59,0,300000
453,2430426,4,169000,0,98.0,704,2023-03-30T20:59,0,169000
454,595040,5,210000,0,95.0,8707,2023-03-30T20:59,0,210000
455,2101924,6,99900,0,96.0,1344,2023-03-30T20:59,-9990,89910
456,2816812,7,119900,0,92.0,1502,2023-03-30T20:59,0,119900
457,2910082,8,265500,295000,98.0,443,2023-03-30T20:59,0,265500
458,2816816,9,159900,0,97.0,1817,2023-03-30T20:59,0,159900
459,1562990,10,230000,0,96.0,1271,2023-03-30T20:59,0,230000
460,1568047,11,143100,159000,95.0,11984,2023-03-30T20:59,0,143100
461,2433538,12,86700,102000,96.0,2334,2023-03-30T20:59,0,86700
462,1339622,13,42900,59000,97.0,16155,2023-03-30T20:59,0,42900
463,3093902,14,169000,0,100.0,13,2023-03-30T20:59,0,169000
464,2930571,15,557000,870000,0.0,0,2023-03-30T20:59,0,557000
465,1129750,16,69000,0,97.0,3880,2023-03-30T20:59,0,69000
466,2432733,17,44900,59000,97.0,2701,2023-03-30T20:59,0,44900
467,3024585,18,59000,0,97.0,89,2023-03-30T20:59,-11800,47200
468,2143833,19,91800,108000,96.0,2386,2023-03-30T20:59,0,91800
469,1334438,20,170000,0,96.0,4379,2023-03-30T20:59,0,170000
470,2440524,21,69000,0,97.0,1467,2023-03-30T20:59,-6900,62100
471,1699941,22,67150,79000,97.0,4781,2023-03-30T20:59,-3358,63792
472,3124961,23,62100,69000,95.0,28,2023-03-30T20:59,0,62100
473,3062046,24,78300,87000,96.0,70,2023-03-30T20:59,0,78300
474,2992149,25,424200,606000,0.0,0,2023-03-30T20:59,0,424200
475,595039,26,210000,0,97.0,3479,2023-03-30T20:59,0,210000
476,2599641,27,67830,119000,96.0,1979,2023-03-30T20:59,-3392,64438
477,2664373,28,65000,0,96.0,957,2023-03-30T20:59,0,65000
478,2340324,29,179100,199000,97.0,172,2023-03-30T20:59,0,179100
479,1730340,30,258000,0,97.0,4125,2023-03-30T20:59,0,258000
480,3049313,31,57100,64900,97.0,441,2023-03-30T20:59,0,57100
481,2305529,32,132000,168000,98.0,81,2023-03-30T20:59,0,132000
482,2435822,33,94500,99000,97.0,208,2023-03-30T20:59,0,94500
483,2624538,34,40900,59000,97.0,1372,2023-03-30T20:59,0,40900
484,2944032,35,989000,0,0.0,0,2023-03-30T20:59,0,989000
485,1815709,36,132000,168000,96.0,7111,2023-03-30T20:59,0,132000
486,607298,37,53600,59000,93.0,15560,2023-03-30T20:59,0,53600
487,1890398,38,132000,168000,96.0,2688,2023-03-30T20:59,0,132000
488,2910086,39,265500,295000,98.0,177,2023-03-30T20:59,0,265500
489,1548618,40,152000,198000,96.0,3280,2023-03-30T20:59,0,152000
490,2875382,41,486000,648000,0.0,0,2023-03-30T20:59,0,486000
491,3132539,42,69000,0,0.0,0,2023-03-30T20:59,-6900,62100
492,1128656,43,86800,99000,95.0,21568,2023-03-30T20:59,0,86800
493,3132541,44,69000,0,0.0,0,2023-03-30T20:59,-6900,62100
494,501198,45,129000,139000,95.0,2736,2023-03-30T20:59,0,129000
495,2664372,46,65000,0,97.0,995,2023-03-30T20:59,0,65000
496,2356342,47,103890,129900,94.0,448,2023-03-30T20:59,0,103890
497,1562988,48,260000,0,97.0,1477,2023-03-30T20:59,0,260000
498,2355318,49,98790,109900,96.0,630,2023-03-30T20:59,-9879,88911
499,2818158,50,199000,0,98.0,75,2023-03-30T20:59,0,199000
500,2101922,51,119900,0,96.0,1872,2023-03-30T20:59,0,119900
501,3061996,52,88200,98000,98.0,54,2023-03-30T20:59,0,88200
502,2518112,53,89250,105000,96.0,933,2023-03-30T20:59,0,89250
503,1438359,54,98000,0,97.0,1162,2023-03-30T20:59,0,98000
504,1439535,55,49000,0,96.0,16289,2023-03-30T20:59,0,49000
505,2686298,56,686000,980000,0.0,0,2023-03-30T20:59,0,686000
506,1021359,57,76000,100000,94.0,5370,2023-03-30T20:59,0,76000
507,451851,58,268000,0,97.0,1944,2023-03-30T20:59,0,268000
508,1720822,59,209000,0,97.0,294,2023-03-30T20:59,0,209000
509,2378989,60,159000,0,94.0,21,2023-03-30T20:59,0,159000
510,3128322,61,76300,109000,0.0,0,2023-03-30T20:59,0,76300
511,2437045,62,157000,218000,97.0,480,2023-03-30T20:59,0,157000
512,2069832,63,199900,332000,95.0,750,2023-03-30T20:59,-9995,189905
513,1973858,64,125300,179000,98.0,1169,2023-03-30T20:59,0,125300
514,2257887,65,109000,119000,96.0,2335,2023-03-30T20:59,0,109000
515,2306631,66,24900,0,96.0,2041,2023-03-30T20:59,0,24900
516,1952910,67,265500,295000,98.0,1719,2023-03-30T20:59,0,265500
517,2956589,68,628000,840000,100.0,1,2023-03-30T20:59,0,628000
518,2614276,69,69000,0,97.0,526,2023-03-30T20:59,-6900,62100
519,1720827,70,169000,0,98.0,566,2023-03-30T20:59,0,169000
520,2305523,71,139000,198000,96.0,72,2023-03-30T20:59,0,139000
521,3102922,72,89000,0,98.0,11,2023-03-30T20:59,0,89000
522,2744907,73,68850,81000,96.0,990,2023-03-30T20:59,0,68850
523,3045271,74,73800,82000,98.0,21,2023-03-30T20:59,0,73800
524,3052437,75,139500,155000,97.0,37,2023-03-30T20:59,0,139500
525,3132471,76,79000,0,0.0,0,2023-03-30T20:59,-7900,71100
526,3084458,77,138000,197000,90.0,6,2023-03-30T20:59,-13800,124200
527,3124959,78,52200,58000,98.0,23,2023-03-30T20:59,0,52200
528,2210201,79,259000,299000,94.0,193,2023-03-30T20:59,-12950,246050
529,2791587,80,150000,300000,91.0,12,2023-03-30T20:59,0,150000
530,2716424,81,198000,0,97.0,291,2023-03-30T20:59,0,198000
531,2243103,82,114500,135000,97.0,54,2023-03-30T20:59,0,114500
532,2858618,83,548000,685000,91.0,12,2023-03-30T20:59,0,548000
533,2531583,84,134000,189000,97.0,292,2023-03-30T20:59,0,134000
534,3156658,85,259000,299000,0.0,0,2023-03-30T20:59,-12950,246050
535,2972872,86,65000,0,97.0,297,2023-03-30T20:59,0,65000
536,1334813,87,134000,168000,95.0,1723,2023-03-30T20:59,0,134000
537,3139612,88,268000,0,0.0,0,2023-03-30T20:59,-13400,254600
538,2419871,89,44900,59000,97.0,871,2023-03-30T20:59,0,44900
539,1754219,90,31200,39000,96.0,2227,2023-03-30T20:59,0,31200
540,1214164,1,36000,0,96.0,24812,2023-03-30T20:59,0,36000
541,2280117,2,35100,39000,97.0,6127,2023-03-30T20:59,0,35100
542,1771137,3,29000,0,97.0,12382,2023-03-30T20:59,0,29000
543,2879419,4,46900,55000,98.0,618,2023-03-30T20:59,0,46900
544,1272626,5,36000,0,96.0,14053,2023-03-30T20:59,0,36000
545,1214174,6,36000,0,97.0,14966,2023-03-30T20:59,0,36000
546,2134140,7,39000,0,97.0,3453,2023-03-30T20:59,0,39000
547,2286829,8,33300,37000,95.0,4826,2023-03-30T20:59,0,33300
548,1022013,9,79000,0,96.0,6242,2023-03-30T20:59,0,79000
549,1214109,10,36000,0,97.0,8042,2023-03-30T20:59,0,36000
550,1822717,11,56050,59000,97.0,4260,2023-03-30T20:59,-2803,53247
551,1771132,12,29000,0,96.0,5198,2023-03-30T20:59,0,29000
552,1214317,13,36000,0,97.0,11440,2023-03-30T20:59,0,36000
553,3153584,14,45000,0,100.0,9,2023-03-30T20:59,-2250,42750
554,1855444,15,37800,42000,97.0,2978,2023-03-30T20:59,0,37800
555,1022014,16,79000,0,96.0,11408,2023-03-30T20:59,0,79000
556,1214169,17,36000,0,97.0,5299,2023-03-30T20:59,0,36000
557,1771133,18,29000,0,97.0,5642,2023-03-30T20:59,0,29000
558,2879425,19,46900,55000,97.0,239,2023-03-30T20:59,0,46900
559,2980928,20,308000,490000,92.0,15,2023-03-30T20:59,0,308000
560,2287131,21,33300,37000,95.0,1580,2023-03-30T20:59,0,33300
561,2221221,22,35100,39000,96.0,1839,2023-03-30T20:59,0,35100
562,2715553,23,68000,0,95.0,247,2023-03-30T20:59,0,68000
563,1214173,24,36000,0,96.0,5525,2023-03-30T20:59,0,36000
564,1497550,25,29600,37000,95.0,5656,2023-03-30T20:59,0,29600
565,2356713,26,39000,0,97.0,1422,2023-03-30T20:59,0,39000
566,2123132,27,39000,0,97.0,6348,2023-03-30T20:59,0,39000
567,2134158,28,39000,0,97.0,2461,2023-03-30T20:59,0,39000
568,3153581,29,45000,0,100.0,2,2023-03-30T20:59,-2250,42750
569,1906772,30,37800,42000,97.0,3025,2023-03-30T20:59,0,37800
570,2028240,31,39000,0,98.0,3326,2023-03-30T20:59,0,39000
571,1214106,32,36000,0,96.0,9704,2023-03-30T20:59,0,36000
572,2464070,33,44000,55000,97.0,296,2023-03-30T20:59,-2200,41800
573,2687157,34,45000,0,97.0,1011,2023-03-30T20:59,0,45000
574,2672186,35,20900,30000,96.0,540,2023-03-30T20:59,-2090,18810
575,3142351,36,49000,0,100.0,8,2023-03-30T20:59,-4900,44100
576,2329375,37,34710,39000,96.0,2054,2023-03-30T20:59,0,34710
577,2591291,38,39200,49000,97.0,1007,2023-03-30T20:59,0,39200
578,2859190,39,33300,37000,96.0,400,2023-03-30T20:59,0,33300
579,1452917,40,69000,0,96.0,2403,2023-03-30T20:59,0,69000
580,2707659,41,42000,0,97.0,498,2023-03-30T20:59,0,42000
581,1907733,42,29900,39000,96.0,3785,2023-03-30T20:59,0,29900
582,1524720,43,36000,0,96.0,3362,2023-03-30T20:59,0,36000
583,2356693,44,39000,0,97.0,1510,2023-03-30T20:59,0,39000
584,3012243,45,27900,39900,98.0,53,2023-03-30T20:59,0,27900
585,2864918,46,49000,0,99.0,114,2023-03-30T20:59,0,49000
586,2340293,47,398000,600000,100.0,11,2023-03-30T20:59,0,398000
587,1214171,48,36000,0,97.0,1693,2023-03-30T20:59,0,36000
588,2879417,49,46900,55000,98.0,170,2023-03-30T20:59,0,46900
589,2356711,50,39000,0,97.0,1456,2023-03-30T20:59,0,39000
590,1022012,51,79000,0,94.0,2782,2023-03-30T20:59,0,79000
591,1920929,52,39000,0,97.0,3946,2023-03-30T20:59,0,39000
592,1602670,53,56050,59000,97.0,736,2023-03-30T20:59,0,56050
593,2326114,54,32000,40000,97.0,969,2023-03-30T20:59,-4800,27200
594,3129450,55,44100,49000,0.0,0,2023-03-30T20:59,0,44100
595,2107999,56,36000,0,97.0,2640,2023-03-30T20:59,0,36000
596,2687161,57,36000,45000,96.0,156,2023-03-30T20:59,0,36000
597,1086824,58,29600,37000,95.0,18599,2023-03-30T20:59,0,29600
598,2859244,59,31450,37000,94.0,241,2023-03-30T20:59,0,31450
599,1214193,60,39000,0,97.0,15321,2023-03-30T20:59,0,39000
600,2280146,61,35100,39000,97.0,906,2023-03-30T20:59,0,35100
601,2922336,62,52000,0,97.0,130,2023-03-30T20:59,-5200,46800
602,2560668,63,58650,69000,97.0,1226,2023-03-30T20:59,0,58650
603,2922090,64,52000,0,96.0,62,2023-03-30T20:59,-5200,46800
604,2053753,65,42000,0,98.0,4102,2023-03-30T20:59,0,42000
605,3146242,66,46000,0,100.0,15,2023-03-30T20:59,0,46000
606,3142358,67,63000,0,100.0,1,2023-03-30T20:59,-6300,56700
607,2573131,68,37800,42000,98.0,683,2023-03-30T20:59,0,37800
608,2287158,69,37000,0,95.0,1177,2023-03-30T20:59,0,37000
609,2697593,70,99000,0,97.0,130,2023-03-30T20:59,0,99000
610,3119342,71,129000,0,0.0,0,2023-03-30T20:59,0,129000
611,2280141,72,35100,39000,96.0,1106,2023-03-30T20:59,0,35100
612,3142357,73,63000,0,95.0,4,2023-03-30T20:59,-6300,56700
613,3146200,74,46000,0,100.0,10,2023-03-30T20:59,0,46000
614,2364344,75,26600,38000,97.0,1672,2023-03-30T20:59,0,26600
615,2998516,76,29000,0,96.0,127,2023-03-30T20:59,0,29000
616,2315824,77,49000,0,97.0,402,2023-03-30T20:59,0,49000
617,2830515,78,35100,39000,97.0,103,2023-03-30T20:59,0,35100
618,3142349,79,49000,0,0.0,0,2023-03-30T20:59,-4900,44100
619,2921965,80,52000,0,98.0,171,2023-03-30T20:59,-5200,46800
620,1931716,81,56050,59000,97.0,244,2023-03-30T20:59,0,56050
621,2535631,82,35100,39000,95.0,331,2023-03-30T20:59,0,35100
622,2134287,83,39000,0,98.0,696,2023-03-30T20:59,0,39000
623,3019422,84,119000,0,96.0,5,2023-03-30T20:59,0,119000
624,1126959,85,29250,39000,91.0,2546,2023-03-30T20:59,0,29250
625,2289281,86,26600,38000,96.0,864,2023-03-30T20:59,0,26600
626,2484239,87,30600,36000,97.0,1425,2023-03-30T20:59,0,30600
627,2962388,88,31200,39000,96.0,109,2023-03-30T20:59,0,31200
628,2089719,89,36000,0,97.0,2386,2023-03-30T20:59,0,36000
629,3099130,90,54000,0,100.0,13,2023-03-30T20:59,0,54000
630,2781049,1,1285000,0,0.0,0,2023-03-30T20:59,0,1285000
631,3158235,2,278000,0,0.0,0,2023-03-30T20:59,-27800,250200
632,2605850,3,94000,0,97.0,162,2023-03-30T20:59,-4700,89300
633,3146212,4,69900,0,100.0,1,2023-03-30T20:59,-3495,66405
634,3106487,5,148000,0,100.0,18,2023-03-30T20:59,0,148000
635,3135904,6,92000,0,0.0,0,2023-03-30T20:59,-4600,87400
636,3173636,7,178000,0,0.0,0,2023-03-30T20:59,-26700,151300
637,2489894,8,150100,158000,98.0,101,2023-03-30T20:59,-7505,142595
638,3102263,9,165000,0,0.0,0,2023-03-30T20:59,-8250,156750
639,3008191,10,348000,498000,100.0,1,2023-03-30T20:59,-52200,295800
640,2587981,11,293300,419000,0.0,0,2023-03-30T20:59,-43995,249305
641,3174225,12,161100,179000,0.0,0,2023-03-30T20:59,-24165,136935
642,3184277,13,299000,0,0.0,0,2023-03-30T20:59,-14950,284050
643,3059119,14,179000,0,90.0,17,2023-03-30T20:59,-35800,143200
644,2588342,15,280000,0,0.0,0,2023-03-30T20:59,0,280000
645,3160501,16,278000,0,0.0,0,2023-03-30T20:59,-13900,264100
646,3145662,17,269000,0,0.0,0,2023-03-30T20:59,-13450,255550
647,3091290,18,85000,0,0.0,0,2023-03-30T20:59,0,85000
648,2485838,19,259000,0,100.0,1,2023-03-30T20:59,0,259000
649,3050174,20,258000,0,0.0,0,2023-03-30T20:59,-51600,206400
650,3070522,21,218000,0,0.0,0,2023-03-30T20:59,0,218000
651,2568529,22,220000,0,100.0,10,2023-03-30T20:59,0,220000
652,2612357,23,69000,139000,98.0,12,2023-03-30T20:59,0,69000
653,3124903,24,233100,259000,0.0,0,2023-03-30T20:59,0,233100
654,3093636,25,230000,0,0.0,0,2023-03-30T20:59,-34500,195500
655,3161727,26,223000,0,0.0,0,2023-03-30T20:59,0,223000
656,3046091,27,198400,248000,100.0,3,2023-03-30T20:59,-9920,188480
657,3046100,28,198400,248000,100.0,1,2023-03-30T20:59,-9920,188480
658,3149931,29,109000,0,0.0,0,2023-03-30T20:59,0,109000
659,3126194,30,79000,0,100.0,1,2023-03-30T20:59,0,79000
660,2742939,31,189000,0,100.0,2,2023-03-30T20:59,-9450,179550
661,3073259,32,196200,218000,100.0,3,2023-03-30T20:59,-29430,166770
662,2377484,33,209000,220000,0.0,0,2023-03-30T20:59,0,209000
663,3171883,34,149000,0,0.0,0,2023-03-30T20:59,0,149000
664,2738745,35,196800,328000,100.0,5,2023-03-30T20:59,0,196800
665,3124594,36,198000,0,0.0,0,2023-03-30T20:59,-39600,158400
666,3063575,37,203150,239000,0.0,0,2023-03-30T20:59,0,203150
667,3143043,38,199000,0,0.0,0,2023-03-30T20:59,0,199000
668,2373167,39,189000,0,96.0,21,2023-03-30T20:59,0,189000
669,3080769,40,197100,219000,0.0,0,2023-03-30T20:59,0,197100
670,2867200,41,198000,0,0.0,0,2023-03-30T20:59,0,198000
671,3041848,42,168000,0,0.0,0,2023-03-30T20:59,0,168000
672,3122381,43,151200,168000,100.0,3,2023-03-30T20:59,-22680,128520
673,2392489,44,31900,0,97.0,721,2023-03-30T20:59,0,31900
674,3154902,45,174400,218000,0.0,0,2023-03-30T20:59,0,174400
675,3053883,46,178200,198000,0.0,0,2023-03-30T20:59,-8910,169290
676,1455772,47,94000,0,96.0,208,2023-03-30T20:59,-4700,89300
677,1622447,48,62100,69000,90.0,185,2023-03-30T20:59,-3105,58995
678,3130640,49,169000,0,0.0,0,2023-03-30T20:59,0,169000
679,1421770,50,165600,184000,95.0,41,2023-03-30T20:59,0,165600
680,1871030,51,133600,167000,95.0,96,2023-03-30T20:59,-6680,126920
681,3155272,52,87200,109000,0.0,0,2023-03-30T20:59,0,87200
682,3146668,53,151200,168000,100.0,3,2023-03-30T20:59,0,151200
683,3147449,54,154000,0,0.0,0,2023-03-30T20:59,-7700,146300
684,1440030,55,85200,142000,94.0,49,2023-03-30T20:59,0,85200
685,3099772,56,89000,0,100.0,2,2023-03-30T20:59,0,89000
686,3055415,57,160000,0,93.0,3,2023-03-30T20:59,-24000,136000
687,2751224,58,138000,0,100.0,2,2023-03-30T20:59,0,138000
688,3134492,59,79000,0,100.0,2,2023-03-30T20:59,0,79000
689,3071459,60,159000,0,0.0,0,2023-03-30T20:59,0,159000
690,3109926,61,69700,82000,86.0,3,2023-03-30T20:59,0,69700
691,1682123,62,160000,200000,0.0,0,2023-03-30T20:59,0,160000
692,2388209,63,94000,0,96.0,153,2023-03-30T20:59,-4700,89300
693,2132552,64,145000,0,96.0,6,2023-03-30T20:59,-21750,123250
694,2717734,65,79000,0,97.0,54,2023-03-30T20:59,0,79000
695,3179872,66,128000,0,0.0,0,2023-03-30T20:59,0,128000
696,3178109,67,150000,0,0.0,0,2023-03-30T20:59,0,150000
697,1103286,68,94000,0,94.0,779,2023-03-30T20:59,-4700,89300
698,2114181,69,148000,0,0.0,0,2023-03-30T20:59,0,148000
699,2806283,70,145600,208000,90.0,2,2023-03-30T20:59,0,145600
700,2637839,71,149000,0,100.0,1,2023-03-30T20:59,0,149000
701,3084762,72,119000,0,100.0,1,2023-03-30T20:59,0,119000
702,1610334,73,149000,0,89.0,15,2023-03-30T20:59,0,149000
703,2044442,74,70000,0,96.0,170,2023-03-30T20:59,0,70000
704,2585634,75,139000,0,100.0,3,2023-03-30T20:59,-6950,132050
705,3181374,76,139000,0,0.0,0,2023-03-30T20:59,0,139000
706,3130642,77,119000,0,0.0,0,2023-03-30T20:59,0,119000
707,3116511,78,128000,0,0.0,0,2023-03-30T20:59,0,128000
708,3091291,79,85000,0,80.0,2,2023-03-30T20:59,0,85000
709,3137353,80,134100,149000,0.0,0,2023-03-30T20:59,0,134100
710,3137343,81,125100,139000,0.0,0,2023-03-30T20:59,0,125100
711,3145212,82,134400,168000,0.0,0,2023-03-30T20:59,0,134400
712,3174268,83,119000,0,0.0,0,2023-03-30T20:59,0,119000
713,2809914,84,126000,0,87.0,11,2023-03-30T20:59,0,126000
714,3104784,85,125100,139000,0.0,0,2023-03-30T20:59,0,125100
715,3084760,86,119000,0,100.0,1,2023-03-30T20:59,0,119000
716,2784512,87,126400,158000,86.0,3,2023-03-30T20:59,0,126400
717,2306207,88,19880,28000,93.0,506,2023-03-30T20:59,0,19880
718,2655316,89,121600,128000,100.0,1,2023-03-30T20:59,0,121600
719,2512635,90,35400,59000,96.0,201,2023-03-30T20:59,0,35400
720,3051039,1,95200,119000,100.0,17,2023-03-30T20:59,-19040,76160
721,2836351,2,49680,72000,96.0,426,2023-03-30T20:59,-4968,44712
722,1931894,3,37900,0,95.0,498,2023-03-30T20:59,0,37900
723,2756335,4,125400,132000,96.0,54,2023-03-30T20:59,-6270,119130
724,2738716,5,134400,168000,93.0,25,2023-03-30T20:59,-6720,127680
725,3031104,6,55200,69000,98.0,46,2023-03-30T20:59,-11040,44160
726,3070528,7,168000,0,0.0,0,2023-03-30T20:59,-8400,159600
727,3070530,8,168000,0,0.0,0,2023-03-30T20:59,0,168000
728,3081767,9,169000,0,80.0,2,2023-03-30T20:59,-8450,160550
729,3100903,10,159600,168000,100.0,1,2023-03-30T20:59,-23940,135660
730,3170471,11,139000,0,0.0,0,2023-03-30T20:59,0,139000
731,2448900,12,39490,43900,96.0,86,2023-03-30T20:59,0,39490
732,1788995,13,58500,65000,94.0,553,2023-03-30T20:59,-2925,55575
733,3088698,14,290000,0,0.0,0,2023-03-30T20:59,0,290000
734,3178568,15,290000,0,0.0,0,2023-03-30T20:59,0,290000
735,3038425,16,97300,139000,0.0,0,2023-03-30T20:59,-19460,77840
736,3085784,17,128000,0,0.0,0,2023-03-30T20:59,0,128000
737,2867750,18,135000,0,96.0,38,2023-03-30T20:59,-6750,128250
738,3112848,19,260000,0,100.0,1,2023-03-30T20:59,-39000,221000
739,3112847,20,260000,0,0.0,0,2023-03-30T20:59,-39000,221000
740,2573497,21,258000,430000,0.0,0,2023-03-30T20:59,-38700,219300
741,2864414,22,69300,99000,94.0,75,2023-03-30T20:59,-3465,65835
742,3000422,23,59000,0,97.0,23,2023-03-30T20:59,0,59000
743,3077493,24,238000,0,0.0,0,2023-03-30T20:59,-35700,202300
744,2499645,25,243600,348000,0.0,0,2023-03-30T20:59,0,243600
745,2806614,26,107100,119000,97.0,96,2023-03-30T20:59,0,107100
746,2408702,27,238000,340000,100.0,6,2023-03-30T20:59,-35700,202300
747,3146678,28,116100,129000,0.0,0,2023-03-30T20:59,0,116100
748,2390975,29,39760,56000,93.0,86,2023-03-30T20:59,0,39760
749,2408582,30,230300,329000,0.0,0,2023-03-30T20:59,0,230300
750,3040758,31,83200,111000,97.0,9,2023-03-30T20:59,-4160,79040
751,1645760,32,39390,43900,96.0,335,2023-03-30T20:59,0,39390
752,3073254,33,160200,178000,86.0,6,2023-03-30T20:59,-24030,136170
753,2144842,34,65400,109000,96.0,20,2023-03-30T20:59,0,65400
754,2664659,35,219000,0,0.0,0,2023-03-30T20:59,-32850,186150
755,2760121,36,216000,0,0.0,0,2023-03-30T20:59,-32400,183600
756,2830788,37,139000,0,96.0,26,2023-03-30T20:59,-6950,132050
757,2760122,38,216000,0,100.0,3,2023-03-30T20:59,-32400,183600
758,3011624,39,190000,318000,0.0,0,2023-03-30T20:59,-28500,161500
759,2571642,40,149000,0,95.0,8,2023-03-30T20:59,0,149000
760,1819994,41,36500,43000,92.0,653,2023-03-30T20:59,0,36500
761,2377804,42,188100,198000,93.0,37,2023-03-30T20:59,-28215,159885
762,3091303,43,59000,0,0.0,0,2023-03-30T20:59,0,59000
763,2925522,44,54600,65000,96.0,85,2023-03-30T20:59,0,54600
764,2796164,45,59200,74000,96.0,103,2023-03-30T20:59,-2960,56240
765,2792603,46,43900,0,100.0,46,2023-03-30T20:59,0,43900
766,2544025,47,189000,270000,100.0,1,2023-03-30T20:59,0,189000
767,1645762,48,39390,43900,94.0,332,2023-03-30T20:59,0,39390
768,3073252,49,160200,178000,100.0,4,2023-03-30T20:59,-24030,136170
769,3126112,50,79000,0,96.0,11,2023-03-30T20:59,0,79000
770,3071050,51,93100,98000,100.0,3,2023-03-30T20:59,0,93100
771,3100908,52,188100,198000,0.0,0,2023-03-30T20:59,-28215,159885
772,1324169,53,29900,0,95.0,1324,2023-03-30T20:59,0,29900
773,3144417,54,79000,0,0.0,0,2023-03-30T20:59,0,79000
774,3038069,55,89100,99000,100.0,10,2023-03-30T20:59,-4455,84645
775,2378593,56,88200,98000,94.0,70,2023-03-30T20:59,-4410,83790
776,3062800,57,154800,172000,100.0,2,2023-03-30T20:59,-7740,147060
777,2452289,58,181300,259000,100.0,1,2023-03-30T20:59,0,181300
778,3133082,59,171000,0,80.0,3,2023-03-30T20:59,-8550,162450
779,3098868,60,195000,0,0.0,0,2023-03-30T20:59,0,195000
780,3071045,61,148000,0,100.0,1,2023-03-30T20:59,-22200,125800
781,2882569,62,164000,249000,0.0,0,2023-03-30T20:59,-24600,139400
782,3121771,63,129000,0,0.0,0,2023-03-30T20:59,-19350,109650
783,2882567,64,164000,249000,0.0,0,2023-03-30T20:59,-24600,139400
784,3066304,65,89000,0,97.0,7,2023-03-30T20:59,-4450,84550
785,3039835,66,158000,0,100.0,2,2023-03-30T20:59,0,158000
786,3096621,67,48300,69000,100.0,5,2023-03-30T20:59,-4830,43470
787,3119193,68,159000,0,0.0,0,2023-03-30T20:59,0,159000
788,3055929,69,57600,72000,100.0,6,2023-03-30T20:59,-2880,54720
789,3074718,70,84550,89000,0.0,0,2023-03-30T20:59,0,84550
790,3142040,71,102000,0,80.0,2,2023-03-30T20:59,0,102000
791,2195066,72,160000,200000,0.0,0,2023-03-30T20:59,-24000,136000
792,2643770,73,138000,0,98.0,18,2023-03-30T20:59,-20700,117300
793,1955949,74,29700,45000,96.0,478,2023-03-30T20:59,-2970,26730
794,3133721,75,138500,154000,0.0,0,2023-03-30T20:59,-6925,131575
795,2551409,76,37900,0,95.0,110,2023-03-30T20:59,0,37900
796,2796178,77,51200,64000,97.0,17,2023-03-30T20:59,0,51200
797,2448899,78,39490,43900,95.0,128,2023-03-30T20:59,0,39490
798,3090420,79,139000,0,0.0,0,2023-03-30T20:59,-6950,132050
799,2733236,80,78850,83000,93.0,12,2023-03-30T20:59,0,78850
800,3091304,81,59000,0,0.0,0,2023-03-30T20:59,0,59000
801,2478664,82,45500,65000,96.0,34,2023-03-30T20:59,0,45500
802,3069542,83,143650,169000,0.0,0,2023-03-30T20:59,-21548,122102
803,2551407,84,37900,0,97.0,151,2023-03-30T20:59,0,37900
804,3102030,85,143400,239000,0.0,0,2023-03-30T20:59,-21510,121890
805,2925523,86,54600,65000,95.0,19,2023-03-30T20:59,0,54600
806,2643318,87,138000,0,98.0,10,2023-03-30T20:59,-20700,117300
807,2981150,88,75000,0,91.0,22,2023-03-30T20:59,-3750,71250
808,3120203,89,138000,0,0.0,0,2023-03-30T20:59,-20700,117300
809,1950964,90,51200,64000,95.0,157,2023-03-30T20:59,-2560,48640
810,991339,1,17890,19900,97.0,52323,2023-03-30T20:59,0,17890
811,1986031,2,24990,27900,97.0,10383,2023-03-30T20:59,0,24990
812,991340,3,17890,19900,97.0,30656,2023-03-30T20:59,0,17890
813,998051,4,12900,24000,97.0,161509,2023-03-30T20:59,0,12900
814,1094748,5,19900,0,97.0,18972,2023-03-30T20:59,0,19900
815,763821,6,13900,22000,96.0,31238,2023-03-30T20:59,0,13900
816,1477845,7,15400,22000,96.0,9530,2023-03-30T20:59,0,15400
817,1986029,8,27900,0,97.0,3884,2023-03-30T20:59,0,27900
818,1443937,9,12900,24000,97.0,7720,2023-03-30T20:59,0,12900
819,792919,10,15190,16900,96.0,17882,2023-03-30T20:59,0,15190
820,1094835,11,14290,15900,97.0,6154,2023-03-30T20:59,0,14290
821,746158,12,22900,0,96.0,20486,2023-03-30T20:59,0,22900
822,1996705,13,23690,27900,98.0,2665,2023-03-30T20:59,0,23690
823,1342874,14,16900,33000,97.0,12609,2023-03-30T20:59,0,16900
824,734085,15,10900,19800,96.0,64483,2023-03-30T20:59,0,10900
825,991570,16,12900,20000,97.0,18968,2023-03-30T20:59,0,12900
826,1996702,17,23690,27900,97.0,1905,2023-03-30T20:59,0,23690
827,1821485,18,30000,0,96.0,1239,2023-03-30T20:59,0,30000
828,991341,19,16890,19900,96.0,10157,2023-03-30T20:59,0,16890
829,2297277,20,19900,22000,96.0,262,2023-03-30T20:59,0,19900
830,479245,21,15400,22000,93.0,5360,2023-03-30T20:59,0,15400
831,1729576,22,9500,13900,97.0,15885,2023-03-30T20:59,0,9500
832,1986030,23,23690,27900,97.0,1641,2023-03-30T20:59,0,23690
833,2448999,24,4800,7900,98.0,91,2023-03-30T20:59,0,4800
834,792920,25,15190,16900,96.0,9648,2023-03-30T20:59,0,15190
835,746159,26,20590,22900,95.0,28690,2023-03-30T20:59,0,20590
836,2832613,27,11200,33000,97.0,598,2023-03-30T20:59,0,11200
837,1821487,28,30000,0,97.0,671,2023-03-30T20:59,0,30000
838,2960555,29,19000,0,94.0,88,2023-03-30T20:59,0,19000
839,2845854,30,14900,18900,97.0,188,2023-03-30T20:59,0,14900
840,1346009,31,9900,12000,97.0,6653,2023-03-30T20:59,0,9900
841,746154,32,17900,0,96.0,5142,2023-03-30T20:59,-1790,16110
842,1974077,33,42090,46900,97.0,887,2023-03-30T20:59,0,42090
843,1094750,34,16890,19900,97.0,3535,2023-03-30T20:59,0,16890
844,752821,35,9900,0,94.0,23697,2023-03-30T20:59,0,9900
845,1996704,36,22290,27900,97.0,693,2023-03-30T20:59,0,22290
846,1094749,37,19900,0,96.0,4933,2023-03-30T20:59,0,19900
847,1094834,38,21490,23900,96.0,2443,2023-03-30T20:59,0,21490
848,2971853,39,19000,0,94.0,39,2023-03-30T20:59,0,19000
849,2959925,40,22000,27500,98.0,76,2023-03-30T20:59,0,22000
850,2467197,41,30000,0,95.0,128,2023-03-30T20:59,0,30000
851,2293399,42,19900,22000,95.0,614,2023-03-30T20:59,0,19900
852,3009680,43,12590,14900,98.0,93,2023-03-30T20:59,0,12590
853,1358721,44,14200,22000,96.0,1099,2023-03-30T20:59,0,14200
854,2011852,45,21490,23900,97.0,1299,2023-03-30T20:59,0,21490
855,1094836,46,14290,15900,97.0,1306,2023-03-30T20:59,0,14290
856,1475055,47,16200,22000,96.0,1163,2023-03-30T20:59,0,16200
857,1477846,48,15400,22000,96.0,2654,2023-03-30T20:59,0,15400
858,1260388,49,20900,0,96.0,664,2023-03-30T20:59,0,20900
859,2821598,50,19390,22900,97.0,135,2023-03-30T20:59,0,19390
860,2477852,51,17890,19900,98.0,669,2023-03-30T20:59,0,17890
861,2477854,52,17890,19900,98.0,1446,2023-03-30T20:59,0,17890
862,1647682,53,14900,23600,97.0,941,2023-03-30T20:59,0,14900
863,746161,54,20590,22900,95.0,7728,2023-03-30T20:59,0,20590
864,1360043,55,17890,19900,97.0,782,2023-03-30T20:59,0,17890
865,1777081,56,8000,12800,96.0,1130,2023-03-30T20:59,0,8000
866,2973894,57,22000,27500,98.0,19,2023-03-30T20:59,0,22000
867,2347097,58,14900,24000,98.0,1519,2023-03-30T20:59,0,14900
868,2973915,59,14850,16500,99.0,46,2023-03-30T20:59,0,14850
869,2509300,60,19900,0,96.0,386,2023-03-30T20:59,0,19900
870,3184319,61,48000,0,0.0,0,2023-03-30T20:59,0,48000
871,1348077,62,10900,16500,97.0,1849,2023-03-30T20:59,0,10900
872,1573974,63,39790,46900,97.0,1449,2023-03-30T20:59,0,39790
873,3150590,64,32000,0,0.0,0,2023-03-30T20:59,0,32000
874,2829802,65,14900,18900,97.0,24,2023-03-30T20:59,0,14900
875,792921,66,15190,16900,95.0,7804,2023-03-30T20:59,0,15190
876,1286366,67,11900,24000,97.0,9779,2023-03-30T20:59,0,11900
877,472686,68,9500,14800,94.0,705,2023-03-30T20:59,0,9500
878,3118094,69,28800,32000,100.0,3,2023-03-30T20:59,0,28800
879,2477851,70,19900,0,98.0,631,2023-03-30T20:59,0,19900
880,2821589,71,19690,21900,96.0,28,2023-03-30T20:59,0,19690
881,2738096,72,19900,0,97.0,96,2023-03-30T20:59,0,19900
882,2929635,73,15900,27000,97.0,489,2023-03-30T20:59,0,15900
883,3146033,74,48000,0,100.0,1,2023-03-30T20:59,-7200,40800
884,1790245,75,16200,22000,95.0,90,2023-03-30T20:59,0,16200
885,2821588,76,19690,21900,97.0,44,2023-03-30T20:59,0,19690
886,2346958,77,18200,24000,98.0,503,2023-03-30T20:59,0,18200
887,1346070,78,9900,12000,97.0,1853,2023-03-30T20:59,0,9900
888,1556775,79,15200,16000,97.0,347,2023-03-30T20:59,0,15200
889,1821480,80,30000,0,98.0,228,2023-03-30T20:59,0,30000
890,2795585,81,35000,0,92.0,45,2023-03-30T20:59,0,35000
891,1092994,82,22900,0,96.0,2636,2023-03-30T20:59,0,22900
892,746157,83,17900,0,95.0,981,2023-03-30T20:59,-1790,16110
893,2610915,84,17000,0,94.0,91,2023-03-30T20:59,-2550,14450
894,3102029,85,24750,27500,95.0,4,2023-03-30T20:59,0,24750
895,2433154,86,30000,0,95.0,88,2023-03-30T20:59,0,30000
896,1523782,87,20900,0,97.0,321,2023-03-30T20:59,0,20900
897,768442,88,12500,0,96.0,1225,2023-03-30T20:59,0,12500
898,2122868,89,9500,13900,97.0,3804,2023-03-30T20:59,0,9500
899,3106972,90,19900,0,92.0,8,2023-03-30T20:59,0,19900
