,item_id,rank,price,del_price,rating,rating_count,time,coupon,real_price
0,2272830,1,35910,39900,97.0,19191,2023-04-06T18:55,-3591,32319
1,1848166,2,44100,49000,97.0,41024,2023-04-06T18:55,0,44100
2,2479911,3,49400,76000,97.0,4197,2023-04-06T18:55,0,49400
3,345889,4,29900,47900,95.0,9770,2023-04-06T18:55,0,29900
4,1763157,5,49400,52000,95.0,2634,2023-04-06T18:55,0,49400
5,2646350,6,59800,94000,95.0,4127,2023-04-06T18:55,-11960,47840
6,2086653,7,16900,0,97.0,39431,2023-04-06T18:55,0,16900
7,1882578,8,35910,39900,97.0,9471,2023-04-06T18:55,0,35910
8,3134406,9,53910,59900,0.0,0,2023-04-06T18:55,0,53910
9,3187851,10,49900,110000,99.0,42,2023-04-06T18:55,0,49900
10,2034137,11,31800,0,97.0,17068,2023-04-06T18:55,-4770,27030
11,2377269,12,38250,45000,97.0,3893,2023-04-06T18:55,0,38250
12,3105468,13,71100,79000,98.0,42,2023-04-06T18:55,0,71100
13,3134405,14,44910,49900,0.0,0,2023-04-06T18:55,0,44910
14,2149254,15,37800,0,97.0,33201,2023-04-06T18:55,-5670,32130
15,2442409,16,39000,78000,96.0,8893,2023-04-06T18:55,-5850,33150
16,3154713,17,49500,66000,0.0,0,2023-04-06T18:55,-4950,44550
17,2996536,18,39900,59000,96.0,496,2023-04-06T18:55,-7980,31920
18,1921901,19,36900,70500,96.0,7556,2023-04-06T18:55,0,36900
19,2122566,20,33800,0,97.0,15940,2023-04-06T18:55,-6760,27040
20,1939099,21,34300,49000,97.0,11744,2023-04-06T18:55,0,34300
21,2313388,22,76500,85000,96.0,2118,2023-04-06T18:55,0,76500
22,2409397,23,31500,45000,97.0,2742,2023-04-06T18:55,-3150,28350
23,1706633,24,199000,0,97.0,2389,2023-04-06T18:55,0,199000
24,3154715,25,49500,66000,0.0,0,2023-04-06T18:55,-4950,44550
25,1884943,26,29900,39000,96.0,18884,2023-04-06T18:55,0,29900
26,1828538,27,39900,69900,95.0,2928,2023-04-06T18:55,0,39900
27,1817394,28,59900,150000,93.0,7189,2023-04-06T18:55,0,59900
28,1944612,29,35800,59700,97.0,2867,2023-04-06T18:55,0,35800
29,2737983,30,119000,0,99.0,50,2023-04-06T18:55,0,119000
30,1899755,31,29900,39000,96.0,4936,2023-04-06T18:55,0,29900
31,2314616,32,39000,43000,97.0,8250,2023-04-06T18:55,0,39000
32,2065708,33,59000,62000,98.0,6585,2023-04-06T18:55,-8850,50150
33,1420730,34,35000,58000,95.0,35959,2023-04-06T18:55,-7000,28000
34,2396645,35,39900,59000,96.0,23445,2023-04-06T18:55,-7980,31920
35,1706634,36,199000,0,97.0,1537,2023-04-06T18:55,0,199000
36,1503352,37,39900,42000,97.0,8416,2023-04-06T18:55,0,39900
37,3143791,38,39900,68000,99.0,48,2023-04-06T18:55,-7980,31920
38,994588,39,39900,53000,93.0,6014,2023-04-06T18:55,-3990,35910
39,1005680,40,17500,35000,95.0,9084,2023-04-06T18:55,0,17500
40,2368712,41,38700,43000,97.0,5575,2023-04-06T18:55,-1935,36765
41,3034895,42,101150,119000,98.0,360,2023-04-06T18:55,0,101150
42,2326935,43,63200,79000,96.0,12946,2023-04-06T18:55,-6320,56880
43,2403601,44,32500,50000,96.0,2206,2023-04-06T18:55,0,32500
44,1763164,45,49400,52000,96.0,2379,2023-04-06T18:55,0,49400
45,2913656,46,47900,64000,96.0,305,2023-04-06T18:55,-4790,43110
46,2851485,47,68900,0,96.0,465,2023-04-06T18:55,0,68900
47,854337,48,33900,0,95.0,17322,2023-04-06T18:55,0,33900
48,996177,49,15900,0,95.0,77519,2023-04-06T18:55,0,15900
49,2285512,50,44200,52000,96.0,1715,2023-04-06T18:55,0,44200
50,3206068,51,52900,74000,0.0,0,2023-04-06T18:55,0,52900
51,3154716,52,49500,66000,0.0,0,2023-04-06T18:55,-4950,44550
52,2038497,53,36000,45000,95.0,16285,2023-04-06T18:55,-3600,32400
53,2376229,54,36000,0,97.0,3830,2023-04-06T18:55,0,36000
54,3154714,55,49500,66000,0.0,0,2023-04-06T18:55,-4950,44550
55,1943792,56,34400,43000,96.0,5347,2023-04-06T18:55,0,34400
56,3180166,57,31200,39000,100.0,7,2023-04-06T18:55,0,31200
57,2708999,58,49800,62500,96.0,636,2023-04-06T18:55,-4980,44820
58,2453556,59,39900,42000,97.0,6265,2023-04-06T18:55,0,39900
59,1763123,60,84550,89000,96.0,1667,2023-04-06T18:55,-4228,80322
60,3146113,61,19900,49000,86.0,3,2023-04-06T18:55,0,19900
61,2392759,62,39900,49600,95.0,4004,2023-04-06T18:55,-3990,35910
62,1336398,63,40200,67000,96.0,19057,2023-04-06T18:55,0,40200
63,2065703,64,59000,62000,98.0,5512,2023-04-06T18:55,-8850,50150
64,1582356,65,49200,82000,96.0,16131,2023-04-06T18:55,0,49200
65,1911516,66,48900,81900,95.0,6171,2023-04-06T18:55,0,48900
66,2035287,67,39800,0,97.0,8701,2023-04-06T18:55,-5970,33830
67,2376233,68,36000,0,97.0,2217,2023-04-06T18:55,0,36000
68,2050094,69,27800,0,97.0,6669,2023-04-06T18:55,-4170,23630
69,1005683,70,17500,35000,95.0,10771,2023-04-06T18:55,0,17500
70,2996537,71,39900,59000,96.0,304,2023-04-06T18:55,-7980,31920
71,3150102,72,30600,34000,0.0,0,2023-04-06T18:55,0,30600
72,1417691,73,13900,0,97.0,18526,2023-04-06T18:55,0,13900
73,3052036,74,59400,66000,96.0,150,2023-04-06T18:55,-11880,47520
74,3034893,75,65400,109000,100.0,31,2023-04-06T18:55,0,65400
75,2612829,76,44900,67900,97.0,1685,2023-04-06T18:55,-8980,35920
76,2398381,77,31500,45000,96.0,3575,2023-04-06T18:55,-3150,28350
77,2471760,78,35100,39000,97.0,6510,2023-04-06T18:55,-3510,31590
78,1742666,79,46900,66000,96.0,3912,2023-04-06T18:55,-9380,37520
79,1382658,80,16900,0,94.0,47372,2023-04-06T18:55,0,16900
80,2518417,81,27500,55000,93.0,448,2023-04-06T18:55,0,27500
81,3058273,82,86400,108000,100.0,3,2023-04-06T18:55,-8640,77760
82,2456003,83,54900,82900,95.0,2214,2023-04-06T18:55,-10980,43920
83,2043036,84,59900,97900,95.0,7463,2023-04-06T18:55,-11980,47920
84,2851727,85,49800,62000,96.0,289,2023-04-06T18:55,-2490,47310
85,903340,86,35000,0,96.0,25138,2023-04-06T18:55,0,35000
86,2877493,87,59800,92000,95.0,1429,2023-04-06T18:55,0,59800
87,2015684,88,39000,0,94.0,6367,2023-04-06T18:55,0,39000
88,3042516,89,42000,65000,96.0,75,2023-04-06T18:55,-8400,33600
89,1779737,90,20800,32000,96.0,7225,2023-04-06T18:55,0,20800
90,1571879,1,79900,112900,96.0,7048,2023-04-06T18:55,-15980,63920
91,1558197,2,73690,81900,97.0,32298,2023-04-06T18:55,0,73690
92,1778404,3,42000,45000,96.0,67137,2023-04-06T18:55,0,42000
93,2723218,4,69900,109000,97.0,2209,2023-04-06T18:55,0,69900
94,3132559,5,179100,199000,100.0,5,2023-04-06T18:55,0,179100
95,3132593,6,179100,199000,100.0,2,2023-04-06T18:55,0,179100
96,1283757,7,75490,83900,96.0,26627,2023-04-06T18:55,0,75490
97,1530517,8,69900,79000,96.0,2068,2023-04-06T18:55,-13980,55920
98,3012082,9,59900,79000,96.0,952,2023-04-06T18:55,-11980,47920
99,1856181,10,35910,39900,97.0,7372,2023-04-06T18:55,-3591,32319
100,1571878,11,79900,112900,96.0,4666,2023-04-06T18:55,-15980,63920
101,3037701,12,215000,239000,98.0,86,2023-04-06T18:55,-43000,172000
102,2061715,13,83900,105000,97.0,2696,2023-04-06T18:55,0,83900
103,1790383,14,59000,86000,95.0,5443,2023-04-06T18:55,0,59000
104,2471405,15,89000,138000,97.0,2057,2023-04-06T18:55,0,89000
105,2699189,16,179000,0,99.0,124,2023-04-06T18:55,0,179000
106,3033224,17,59900,74000,97.0,614,2023-04-06T18:55,-11980,47920
107,841230,18,154000,172000,96.0,7264,2023-04-06T18:55,0,154000
108,1576700,19,89000,129000,97.0,16720,2023-04-06T18:55,0,89000
109,2732486,20,109000,179000,98.0,671,2023-04-06T18:55,0,109000
110,1108007,21,79900,0,95.0,47882,2023-04-06T18:55,0,79900
111,1195307,22,82400,103000,96.0,12597,2023-04-06T18:55,-8240,74160
112,2329532,23,119200,149000,97.0,3953,2023-04-06T18:55,0,119200
113,2343199,24,119000,129000,98.0,1797,2023-04-06T18:55,0,119000
114,1776552,25,59000,69000,94.0,6109,2023-04-06T18:55,0,59000
115,3055246,26,159000,0,98.0,53,2023-04-06T18:55,0,159000
116,2020732,27,70900,89000,95.0,804,2023-04-06T18:55,0,70900
117,3078900,28,148000,0,98.0,190,2023-04-06T18:55,-14800,133200
118,2343198,29,119000,129000,97.0,4996,2023-04-06T18:55,0,119000
119,2284220,30,79900,112900,96.0,1682,2023-04-06T18:55,-15980,63920
120,1778408,31,42000,45000,95.0,11681,2023-04-06T18:55,0,42000
121,1817381,32,47900,69000,96.0,1047,2023-04-06T18:55,0,47900
122,2159724,33,29900,32000,95.0,2270,2023-04-06T18:55,0,29900
123,2110493,34,389000,0,96.0,626,2023-04-06T18:55,0,389000
124,2752332,35,94700,105300,95.0,2545,2023-04-06T18:55,0,94700
125,1139192,36,71100,94900,97.0,14393,2023-04-06T18:55,-7110,63990
126,3010527,37,237150,279000,98.0,211,2023-04-06T18:55,0,237150
127,3010524,38,237150,279000,99.0,52,2023-04-06T18:55,0,237150
128,1751722,39,53910,59900,97.0,3373,2023-04-06T18:55,-5391,48519
129,1337094,40,69900,0,95.0,5374,2023-04-06T18:55,0,69900
130,3025211,41,44900,69000,96.0,154,2023-04-06T18:55,-8980,35920
131,864404,42,108000,135000,95.0,13376,2023-04-06T18:55,0,108000
132,3125671,43,148000,0,97.0,18,2023-04-06T18:55,0,148000
133,1737051,44,62300,89000,96.0,5094,2023-04-06T18:55,0,62300
134,2322836,45,139200,174000,97.0,1008,2023-04-06T18:55,0,139200
135,2288426,46,69000,109000,94.0,806,2023-04-06T18:55,0,69000
136,2064545,47,59800,94000,97.0,11094,2023-04-06T18:55,-2990,56810
137,1833230,48,108800,136000,97.0,5406,2023-04-06T18:55,0,108800
138,2403367,49,146000,0,97.0,630,2023-04-06T18:55,0,146000
139,1776549,50,59000,69000,94.0,4601,2023-04-06T18:55,0,59000
140,1558688,51,73690,81900,97.0,5726,2023-04-06T18:55,0,73690
141,1620285,52,299000,0,97.0,160,2023-04-06T18:55,0,299000
142,2288704,53,121000,132000,97.0,3363,2023-04-06T18:55,0,121000
143,3128134,54,392000,490000,0.0,0,2023-04-06T18:55,-78400,313600
144,2668986,55,35910,39900,96.0,3473,2023-04-06T18:55,-3591,32319
145,3037703,56,215000,239000,99.0,68,2023-04-06T18:55,-43000,172000
146,1530516,57,69900,79000,96.0,2313,2023-04-06T18:55,-13980,55920
147,3029811,58,63200,79000,97.0,244,2023-04-06T18:55,0,63200
148,3058726,59,149000,169000,94.0,39,2023-04-06T18:55,-29800,119200
149,2723772,60,109900,169000,94.0,993,2023-04-06T18:55,-21980,87920
150,1618312,61,83900,0,97.0,7090,2023-04-06T18:55,0,83900
151,1558683,62,81900,0,97.0,6211,2023-04-06T18:55,0,81900
152,3100493,63,139000,0,97.0,34,2023-04-06T18:55,0,139000
153,1571876,64,79900,112900,96.0,1209,2023-04-06T18:55,-15980,63920
154,1620288,65,299000,0,97.0,227,2023-04-06T18:55,0,299000
155,3047185,66,129000,0,94.0,27,2023-04-06T18:55,0,129000
156,3058783,67,179000,209000,95.0,37,2023-04-06T18:55,-35800,143200
157,2712632,68,107000,0,97.0,1327,2023-04-06T18:55,0,107000
158,2375909,69,80890,89900,98.0,1538,2023-04-06T18:55,0,80890
159,2572705,70,168300,198000,96.0,58,2023-04-06T18:55,-25245,143055
160,965917,71,71890,79900,95.0,13070,2023-04-06T18:55,0,71890
161,3058495,72,198000,220000,98.0,64,2023-04-06T18:55,0,198000
162,2723216,73,69900,109000,97.0,1079,2023-04-06T18:55,0,69900
163,3128131,74,408000,510000,100.0,7,2023-04-06T18:55,-81600,326400
164,2444808,75,83900,0,97.0,683,2023-04-06T18:55,0,83900
165,1567183,76,75900,94900,97.0,7429,2023-04-06T18:55,-7590,68310
166,3081572,77,109000,0,97.0,28,2023-04-06T18:55,-10900,98100
167,3031450,78,146000,159000,96.0,88,2023-04-06T18:55,0,146000
168,2322837,79,139200,174000,97.0,1580,2023-04-06T18:55,0,139200
169,2682432,80,79900,112900,96.0,163,2023-04-06T18:55,-15980,63920
170,727847,81,68500,159000,93.0,10886,2023-04-06T18:55,0,68500
171,3042936,82,90900,105000,97.0,328,2023-04-06T18:55,0,90900
172,2715055,83,159000,189000,97.0,1990,2023-04-06T18:55,0,159000
173,1576682,84,245000,339000,97.0,8574,2023-04-06T18:55,0,245000
174,3062738,85,119200,149000,92.0,5,2023-04-06T18:55,0,119200
175,1116010,86,154000,172000,96.0,2236,2023-04-06T18:55,0,154000
176,2122596,87,39800,57000,96.0,2660,2023-04-06T18:55,0,39800
177,2699160,88,179000,0,96.0,86,2023-04-06T18:55,0,179000
178,1404195,89,49000,59000,95.0,1844,2023-04-06T18:55,0,49000
179,3029809,90,63200,79000,99.0,121,2023-04-06T18:55,0,63200
180,1149329,1,39900,0,96.0,85963,2023-04-06T18:55,0,39900
181,2112059,2,36400,0,97.0,42845,2023-04-06T18:55,0,36400
182,750908,3,34900,54000,96.0,84004,2023-04-06T18:55,0,34900
183,1551840,4,39000,0,97.0,83583,2023-04-06T18:55,0,39000
184,1168906,5,41900,0,97.0,71008,2023-04-06T18:55,0,41900
185,2112061,6,36400,52000,97.0,14616,2023-04-06T18:55,0,36400
186,1149328,7,39900,0,96.0,94464,2023-04-06T18:55,0,39900
187,2060719,8,55200,69000,96.0,5110,2023-04-06T18:55,-2760,52440
188,1370101,9,39000,89000,96.0,22873,2023-04-06T18:55,-1950,37050
189,2351467,10,29000,54000,96.0,6110,2023-04-06T18:55,0,29000
190,1924274,11,49900,66000,95.0,22480,2023-04-06T18:55,0,49900
191,858911,12,39000,49000,95.0,66873,2023-04-06T18:55,0,39000
192,2092852,13,42000,52800,96.0,11088,2023-04-06T18:55,-2100,39900
193,1568057,14,49600,62000,96.0,22273,2023-04-06T18:55,0,49600
194,1926048,15,32000,0,97.0,14671,2023-04-06T18:55,0,32000
195,3154689,16,49800,63000,98.0,89,2023-04-06T18:55,-4980,44820
196,3070909,17,139000,0,100.0,5,2023-04-06T18:55,0,139000
197,3154700,18,49800,63000,0.0,0,2023-04-06T18:55,-4980,44820
198,2060759,19,59800,74800,97.0,7182,2023-04-06T18:55,-2990,56810
199,2060717,20,55200,69000,95.0,3783,2023-04-06T18:55,-2760,52440
200,3141395,21,49900,73900,96.0,158,2023-04-06T18:55,-9980,39920
201,3154688,22,49800,63000,98.0,71,2023-04-06T18:55,-4980,44820
202,2310310,23,96750,129000,98.0,922,2023-04-06T18:55,-19350,77400
203,1551839,24,39000,0,97.0,23481,2023-04-06T18:55,0,39000
204,2028327,25,49900,0,97.0,9049,2023-04-06T18:55,0,49900
205,1736085,26,39900,59800,96.0,36689,2023-04-06T18:55,0,39900
206,3154699,27,49800,63000,0.0,0,2023-04-06T18:55,-4980,44820
207,1552753,28,62400,78000,97.0,28156,2023-04-06T18:55,-6240,56160
208,2789091,29,79200,99000,96.0,763,2023-04-06T18:55,-3960,75240
209,3154647,30,49800,63000,0.0,0,2023-04-06T18:55,-4980,44820
210,1555407,31,62400,78000,97.0,11553,2023-04-06T18:55,-6240,56160
211,3085508,32,108000,0,100.0,22,2023-04-06T18:55,0,108000
212,2723714,33,52000,58000,96.0,1529,2023-04-06T18:55,0,52000
213,2184087,34,49000,89000,96.0,4076,2023-04-06T18:55,-2450,46550
214,1759490,35,84150,99000,96.0,7306,2023-04-06T18:55,-16830,67320
215,2802101,36,49600,62000,94.0,21,2023-04-06T18:55,-9920,39680
216,3154697,37,49800,63000,0.0,0,2023-04-06T18:55,-4980,44820
217,1573215,38,133200,148000,98.0,9283,2023-04-06T18:55,0,133200
218,2028326,39,49900,0,97.0,6147,2023-04-06T18:55,0,49900
219,1477272,40,44200,68000,96.0,17829,2023-04-06T18:55,0,44200
220,3154694,41,49800,63000,0.0,0,2023-04-06T18:55,-4980,44820
221,2060743,42,33000,55000,95.0,3536,2023-04-06T18:55,0,33000
222,1222184,43,41900,0,97.0,48355,2023-04-06T18:55,0,41900
223,3057113,44,215100,239000,96.0,5,2023-04-06T18:55,0,215100
224,1436218,45,39900,68000,95.0,19201,2023-04-06T18:55,-7980,31920
225,890521,46,39800,63000,94.0,11093,2023-04-06T18:55,0,39800
226,2060720,47,55200,69000,95.0,2550,2023-04-06T18:55,-2760,52440
227,2032901,48,39900,0,97.0,6801,2023-04-06T18:55,0,39900
228,890338,49,39000,49000,95.0,47703,2023-04-06T18:55,0,39000
229,2503133,50,42000,52800,96.0,3082,2023-04-06T18:55,-2100,39900
230,3091296,51,129000,0,93.0,53,2023-04-06T18:55,0,129000
231,1568032,52,49600,62000,96.0,6121,2023-04-06T18:55,0,49600
232,2706287,53,39800,54000,95.0,3743,2023-04-06T18:55,0,39800
233,1666442,54,49900,0,97.0,10910,2023-04-06T18:55,0,49900
234,2827702,55,69800,87500,96.0,436,2023-04-06T18:55,-3490,66310
235,883004,56,69900,89000,94.0,9461,2023-04-06T18:55,0,69900
236,2268307,57,99200,124000,97.0,870,2023-04-06T18:55,-9920,89280
237,3154651,58,49800,63000,0.0,0,2023-04-06T18:55,-4980,44820
238,2877984,59,59000,0,97.0,415,2023-04-06T18:55,0,59000
239,2131950,60,39000,49000,96.0,3863,2023-04-06T18:55,0,39000
240,2789111,61,79200,99000,97.0,818,2023-04-06T18:55,-3960,75240
241,3043818,62,134000,189000,100.0,31,2023-04-06T18:55,0,134000
242,2150457,63,119250,159000,97.0,3795,2023-04-06T18:55,0,119250
243,2107115,64,121500,135000,98.0,11683,2023-04-06T18:55,0,121500
244,3188768,65,156000,0,100.0,10,2023-04-06T18:55,0,156000
245,2358429,66,143100,159000,98.0,2626,2023-04-06T18:55,0,143100
246,1985223,67,39000,89000,96.0,1638,2023-04-06T18:55,-1950,37050
247,2569078,68,79000,0,96.0,2430,2023-04-06T18:55,0,79000
248,1736562,69,39000,0,97.0,6009,2023-04-06T18:55,0,39000
249,1985224,70,39000,89000,96.0,1827,2023-04-06T18:55,-1950,37050
250,1224095,71,35890,39900,97.0,24392,2023-04-06T18:55,0,35890
251,1440874,72,39900,0,95.0,15134,2023-04-06T18:55,0,39900
252,1627892,73,43900,0,97.0,10880,2023-04-06T18:55,0,43900
253,3200524,74,49900,66000,100.0,1,2023-04-06T18:55,-9980,39920
254,2749153,75,66600,74000,97.0,551,2023-04-06T18:55,0,66600
255,3154648,76,49800,63000,0.0,0,2023-04-06T18:55,-4980,44820
256,3070906,77,139000,0,100.0,2,2023-04-06T18:55,0,139000
257,3154691,78,49800,63000,0.0,0,2023-04-06T18:55,-4980,44820
258,1323090,79,73600,92000,96.0,5980,2023-04-06T18:55,0,73600
259,1595607,80,57900,89000,97.0,5697,2023-04-06T18:55,0,57900
260,2381406,81,124200,138000,98.0,2292,2023-04-06T18:55,0,124200
261,3070904,82,139000,0,94.0,7,2023-04-06T18:55,0,139000
262,1168922,83,43900,0,96.0,18176,2023-04-06T18:55,0,43900
263,2092849,84,42000,52800,96.0,9741,2023-04-06T18:55,-2100,39900
264,1100326,85,57900,89000,95.0,36992,2023-04-06T18:55,0,57900
265,3043508,86,71200,89000,97.0,93,2023-04-06T18:55,-3560,67640
266,1885631,87,39000,49000,96.0,23718,2023-04-06T18:55,0,39000
267,1753536,88,58650,69000,97.0,4419,2023-04-06T18:55,-11730,46920
268,1843166,89,119000,0,97.0,319,2023-04-06T18:55,0,119000
269,2737165,90,69000,79000,96.0,2613,2023-04-06T18:55,-3450,65550
270,1789507,1,69900,79000,98.0,25826,2023-04-06T18:55,-6990,62910
271,1034480,2,135000,150000,97.0,18055,2023-04-06T18:55,0,135000
272,2558648,3,119000,0,98.0,1256,2023-04-06T18:55,0,119000
273,1969507,4,88000,0,98.0,5383,2023-04-06T18:55,0,88000
274,2235274,5,145000,0,98.0,692,2023-04-06T18:55,0,145000
275,1835080,6,98000,0,97.0,2792,2023-04-06T18:55,0,98000
276,3038000,7,74700,83000,96.0,351,2023-04-06T18:55,-14940,59760
277,3024801,8,138000,0,100.0,17,2023-04-06T18:55,0,138000
278,2344540,9,96000,0,98.0,9213,2023-04-06T18:55,0,96000
279,2932360,10,2790000,0,100.0,3,2023-04-06T18:55,0,2790000
280,2770508,11,138000,0,97.0,331,2023-04-06T18:55,0,138000
281,1581689,12,75600,89000,97.0,3973,2023-04-06T18:55,-3780,71820
282,1264107,13,65000,90000,97.0,6349,2023-04-06T18:55,0,65000
283,2584181,14,72000,0,99.0,1050,2023-04-06T18:55,0,72000
284,2344538,15,119000,0,98.0,6373,2023-04-06T18:55,0,119000
285,1842449,16,84000,99000,97.0,5372,2023-04-06T18:55,0,84000
286,3050557,17,2027000,3290000,0.0,0,2023-04-06T18:55,0,2027000
287,2343665,18,89000,0,97.0,4601,2023-04-06T18:55,0,89000
288,1564343,19,92800,119000,98.0,8093,2023-04-06T18:55,-6496,86304
289,1910358,20,89100,99000,98.0,2468,2023-04-06T18:55,0,89100
290,1969488,21,88000,0,98.0,1745,2023-04-06T18:55,0,88000
291,2066837,22,79000,119000,97.0,6482,2023-04-06T18:55,-7900,71100
292,2408317,23,145800,162000,96.0,372,2023-04-06T18:55,-14580,131220
293,1528287,24,49000,0,96.0,4595,2023-04-06T18:55,0,49000
294,2849886,25,1880000,2430000,93.0,6,2023-04-06T18:55,0,1880000
295,2320927,26,39000,51000,97.0,2128,2023-04-06T18:55,-3900,35100
296,1744101,27,103500,109000,98.0,2909,2023-04-06T18:55,0,103500
297,2271789,28,71100,79000,97.0,2507,2023-04-06T18:55,0,71100
298,342189,29,39500,52000,95.0,15724,2023-04-06T18:55,0,39500
299,2514819,30,55000,66000,97.0,829,2023-04-06T18:55,-2750,52250
300,1263004,31,159000,0,97.0,5251,2023-04-06T18:55,0,159000
301,3082387,32,139000,0,98.0,122,2023-04-06T18:55,-13900,125100
302,2688604,33,139000,159000,97.0,858,2023-04-06T18:55,-13900,125100
303,1323612,34,238000,0,97.0,3823,2023-04-06T18:55,-11900,226100
304,2754080,35,88000,0,97.0,476,2023-04-06T18:55,0,88000
305,2757112,36,359000,0,93.0,98,2023-04-06T18:55,0,359000
306,2422175,37,137700,162000,99.0,204,2023-04-06T18:55,0,137700
307,3048800,38,2081000,4630000,0.0,0,2023-04-06T18:55,0,2081000
308,1745100,39,103500,109000,97.0,988,2023-04-06T18:55,0,103500
309,3011494,40,69900,79000,96.0,229,2023-04-06T18:55,-13980,55920
310,1320752,41,67800,135000,97.0,4733,2023-04-06T18:55,-3390,64410
311,3077448,42,273600,288000,98.0,15,2023-04-06T18:55,-13680,259920
312,3203669,43,118000,0,0.0,0,2023-04-06T18:55,0,118000
313,2325729,44,87200,109000,97.0,788,2023-04-06T18:55,-17440,69760
314,1247560,45,69900,79000,96.0,4262,2023-04-06T18:55,-6990,62910
315,2624678,46,145000,0,96.0,130,2023-04-06T18:55,0,145000
316,1456515,47,49500,55000,97.0,8715,2023-04-06T18:55,-9900,39600
317,2702033,48,127200,159000,97.0,396,2023-04-06T18:55,0,127200
318,3034745,49,84000,0,97.0,167,2023-04-06T18:55,0,84000
319,1964770,50,59400,66000,97.0,2489,2023-04-06T18:55,-11880,47520
320,3045584,51,130500,145000,97.0,3773,2023-04-06T18:55,0,130500
321,693318,52,79000,110000,96.0,13160,2023-04-06T18:55,0,79000
322,2902211,53,390000,600000,100.0,13,2023-04-06T18:55,0,390000
323,3034751,54,64800,72000,96.0,455,2023-04-06T18:55,0,64800
324,2789786,55,150100,158000,98.0,217,2023-04-06T18:55,0,150100
325,2789785,56,140600,148000,97.0,585,2023-04-06T18:55,0,140600
326,3034749,57,64800,72000,97.0,425,2023-04-06T18:55,0,64800
327,2930265,58,91000,0,98.0,552,2023-04-06T18:55,0,91000
328,2998775,59,142200,158000,96.0,497,2023-04-06T18:55,0,142200
329,2657250,60,125400,149000,98.0,117,2023-04-06T18:55,0,125400
330,2975285,61,55250,65000,98.0,307,2023-04-06T18:55,0,55250
331,3047568,62,119970,129000,95.0,43,2023-04-06T18:55,0,119970
332,3054230,63,62100,69000,100.0,17,2023-04-06T18:55,-6210,55890
333,913402,64,83000,98000,95.0,8036,2023-04-06T18:55,0,83000
334,3070516,65,138000,0,98.0,23,2023-04-06T18:55,0,138000
335,2679537,66,145800,162000,96.0,96,2023-04-06T18:55,-14580,131220
336,3045076,67,54600,84000,96.0,85,2023-04-06T18:55,0,54600
337,2770504,68,138000,0,96.0,134,2023-04-06T18:55,0,138000
338,3029922,69,295000,0,96.0,85,2023-04-06T18:55,0,295000
339,2112607,70,178000,0,97.0,353,2023-04-06T18:55,0,178000
340,3116527,71,449000,0,0.0,0,2023-04-06T18:55,0,449000
341,1736022,72,169200,188000,95.0,431,2023-04-06T18:55,-16920,152280
342,3142123,73,290000,0,100.0,14,2023-04-06T18:55,0,290000
343,938746,74,80100,89000,95.0,12514,2023-04-06T18:55,0,80100
344,3203661,75,158000,0,0.0,0,2023-04-06T18:55,0,158000
345,3038001,76,74700,83000,97.0,79,2023-04-06T18:55,-14940,59760
346,3034743,77,84000,0,96.0,204,2023-04-06T18:55,0,84000
347,2371565,78,888000,1072000,100.0,1,2023-04-06T18:55,0,888000
348,2890575,79,118000,0,95.0,139,2023-04-06T18:55,0,118000
349,2911055,80,832000,1340000,100.0,17,2023-04-06T18:55,0,832000
350,2911056,81,408000,755000,100.0,13,2023-04-06T18:55,0,408000
351,2512405,82,854100,1150000,0.0,0,2023-04-06T18:55,0,854100
352,1453531,83,53000,59000,96.0,2989,2023-04-06T18:55,-5300,47700
353,3072371,84,125100,139000,96.0,113,2023-04-06T18:55,-12510,112590
354,2688927,85,65600,82000,97.0,646,2023-04-06T18:55,-13120,52480
355,3105955,86,279000,0,100.0,4,2023-04-06T18:55,0,279000
356,2973716,87,815000,1160000,93.0,6,2023-04-06T18:55,0,815000
357,2744332,88,159000,0,98.0,194,2023-04-06T18:55,0,159000
358,1758217,89,43900,56000,97.0,13127,2023-04-06T18:55,-2195,41705
359,2002697,90,67900,76000,97.0,3463,2023-04-06T18:55,-6790,61110
360,2545799,1,149000,0,98.0,2093,2023-04-06T18:55,0,149000
361,1762407,2,260000,0,97.0,3238,2023-04-06T18:55,0,260000
362,969541,3,69000,0,97.0,29500,2023-04-06T18:55,0,69000
363,1762406,4,260000,0,98.0,3320,2023-04-06T18:55,0,260000
364,810034,5,85500,95000,97.0,45189,2023-04-06T18:55,0,85500
365,1622069,6,119000,0,98.0,5753,2023-04-06T18:55,0,119000
366,2638067,7,99000,139000,97.0,3063,2023-04-06T18:55,0,99000
367,311052,8,53100,59000,97.0,41144,2023-04-06T18:55,0,53100
368,1990244,9,129000,0,98.0,1076,2023-04-06T18:55,0,129000
369,2293400,10,129000,0,96.0,965,2023-04-06T18:55,0,129000
370,2320478,11,129000,0,97.0,503,2023-04-06T18:55,0,129000
371,695334,12,78900,99000,96.0,9366,2023-04-06T18:55,0,78900
372,716244,13,54900,95000,98.0,1183,2023-04-06T18:55,0,54900
373,1622068,14,119000,0,97.0,6619,2023-04-06T18:55,0,119000
374,490091,15,36900,69000,97.0,955,2023-04-06T18:55,0,36900
375,2233180,16,75900,109000,97.0,14179,2023-04-06T18:55,0,75900
376,181907,17,89900,119000,97.0,7122,2023-04-06T18:55,0,89900
377,1296778,18,99000,0,98.0,2097,2023-04-06T18:55,0,99000
378,810032,19,85500,95000,97.0,13740,2023-04-06T18:55,0,85500
379,1900410,20,129000,0,97.0,4875,2023-04-06T18:55,0,129000
380,2741233,21,109000,0,97.0,2717,2023-04-06T18:55,0,109000
381,2778805,22,99000,0,97.0,984,2023-04-06T18:55,0,99000
382,577636,23,99900,139000,95.0,31173,2023-04-06T18:55,0,99900
383,2786814,24,149000,0,98.0,183,2023-04-06T18:55,0,149000
384,810033,25,89100,99000,97.0,34237,2023-04-06T18:55,0,89100
385,490136,26,76000,95000,98.0,2271,2023-04-06T18:55,0,76000
386,2662649,27,485000,790000,98.0,192,2023-04-06T18:55,0,485000
387,1963478,28,170000,0,97.0,438,2023-04-06T18:55,0,170000
388,311050,29,53100,59000,97.0,9030,2023-04-06T18:55,0,53100
389,3033248,30,109000,0,97.0,635,2023-04-06T18:55,0,109000
390,1473136,31,119900,149000,97.0,10779,2023-04-06T18:55,0,119900
391,2631192,32,98100,109000,98.0,377,2023-04-06T18:55,0,98100
392,1792640,33,99000,0,98.0,3534,2023-04-06T18:55,0,99000
393,3023097,34,230000,0,98.0,98,2023-04-06T18:55,0,230000
394,1900420,35,129000,0,96.0,1495,2023-04-06T18:55,0,129000
395,3030422,36,139000,0,96.0,834,2023-04-06T18:55,0,139000
396,2229208,37,109000,0,97.0,1606,2023-04-06T18:55,0,109000
397,816033,38,70900,89000,96.0,13278,2023-04-06T18:55,0,70900
398,1231944,39,119000,0,97.0,1301,2023-04-06T18:55,0,119000
399,3079037,40,195000,0,97.0,244,2023-04-06T18:55,0,195000
400,1493265,41,85500,95000,98.0,4904,2023-04-06T18:55,0,85500
401,186610,42,75900,85000,97.0,16531,2023-04-06T18:55,0,75900
402,1744960,43,119900,149000,97.0,8230,2023-04-06T18:55,0,119900
403,2139107,44,44900,89000,95.0,387,2023-04-06T18:55,0,44900
404,311051,45,58500,65000,97.0,19561,2023-04-06T18:55,0,58500
405,2899664,46,78900,159000,96.0,119,2023-04-06T18:55,0,78900
406,2737458,47,230000,0,98.0,666,2023-04-06T18:55,0,230000
407,3091287,48,119000,0,98.0,286,2023-04-06T18:55,0,119000
408,2239045,49,306000,0,95.0,124,2023-04-06T18:55,-45900,260100
409,1130307,50,109000,0,97.0,6048,2023-04-06T18:55,0,109000
410,2267008,51,89100,99000,98.0,505,2023-04-06T18:55,0,89100
411,2355071,52,265000,0,98.0,505,2023-04-06T18:55,0,265000
412,3096431,53,139000,0,99.0,44,2023-04-06T18:55,0,139000
413,2851292,54,49900,89000,96.0,270,2023-04-06T18:55,0,49900
414,2161992,55,69900,95000,98.0,3300,2023-04-06T18:55,0,69900
415,2918213,56,129000,0,96.0,228,2023-04-06T18:55,0,129000
416,2861392,57,124900,139000,97.0,576,2023-04-06T18:55,0,124900
417,2312772,58,69900,139800,96.0,1373,2023-04-06T18:55,0,69900
418,2207771,59,44900,89000,95.0,449,2023-04-06T18:55,0,44900
419,1955217,60,69000,109000,96.0,5185,2023-04-06T18:55,-13800,55200
420,1296776,61,99000,0,98.0,2937,2023-04-06T18:55,0,99000
421,1798273,62,63070,119000,96.0,1175,2023-04-06T18:55,0,63070
422,2737455,63,260000,0,97.0,252,2023-04-06T18:55,0,260000
423,1635193,64,69900,0,96.0,3686,2023-04-06T18:55,0,69900
424,3053324,65,129000,0,98.0,56,2023-04-06T18:55,0,129000
425,2691016,66,306000,0,98.0,192,2023-04-06T18:55,-45900,260100
426,1729744,67,76500,85000,97.0,3351,2023-04-06T18:55,0,76500
427,1494180,68,71100,79000,95.0,5242,2023-04-06T18:55,0,71100
428,3172975,69,260000,0,0.0,0,2023-04-06T18:55,0,260000
429,2268512,70,109000,0,97.0,437,2023-04-06T18:55,0,109000
430,810036,71,85500,95000,97.0,5131,2023-04-06T18:55,0,85500
431,1478592,72,75900,95000,97.0,3002,2023-04-06T18:55,0,75900
432,2493214,73,169000,0,98.0,177,2023-04-06T18:55,0,169000
433,490135,74,75900,95000,97.0,3275,2023-04-06T18:55,0,75900
434,2050300,75,39900,129000,96.0,632,2023-04-06T18:55,0,39900
435,1955210,76,69000,109000,95.0,1513,2023-04-06T18:55,-13800,55200
436,3048675,77,64000,89000,100.0,26,2023-04-06T18:55,-6400,57600
437,2899656,78,78900,159000,96.0,99,2023-04-06T18:55,0,78900
438,2565212,79,119000,0,99.0,418,2023-04-06T18:55,0,119000
439,2440110,80,59900,0,97.0,1021,2023-04-06T18:55,0,59900
440,2970200,81,79000,0,98.0,500,2023-04-06T18:55,0,79000
441,1868015,82,129000,0,97.0,1941,2023-04-06T18:55,0,129000
442,2524840,83,139000,0,97.0,847,2023-04-06T18:55,0,139000
443,1493263,84,89100,99000,98.0,4226,2023-04-06T18:55,0,89100
444,3185391,85,99000,0,100.0,5,2023-04-06T18:55,0,99000
445,957758,86,89000,0,97.0,4462,2023-04-06T18:55,0,89000
446,102620,87,69000,0,97.0,17862,2023-04-06T18:55,0,69000
447,2233178,88,75900,109000,97.0,4939,2023-04-06T18:55,0,75900
448,2469965,89,94900,149000,96.0,1086,2023-04-06T18:55,0,94900
449,2855992,90,159000,0,97.0,564,2023-04-06T18:55,0,159000
450,1720813,1,149000,0,97.0,417,2023-04-06T18:55,-7450,141550
451,1092992,2,69000,0,97.0,37824,2023-04-06T18:55,0,69000
452,3062046,3,78300,87000,95.0,105,2023-04-06T18:55,-3915,74385
453,1720822,4,209000,0,97.0,294,2023-04-06T18:55,-10450,198550
454,3061996,5,88200,98000,97.0,72,2023-04-06T18:55,-4410,83790
455,3124961,6,62100,69000,98.0,74,2023-04-06T18:55,-3105,58995
456,3062069,7,67150,79000,98.0,27,2023-04-06T18:55,-3358,63792
457,2091749,8,80100,89000,95.0,6220,2023-04-06T18:55,0,80100
458,595039,9,210000,0,97.0,3509,2023-04-06T18:55,0,210000
459,3161736,10,67900,158000,0.0,0,2023-04-06T18:55,0,67900
460,1339622,11,42900,59000,97.0,16277,2023-04-06T18:55,0,42900
461,2433538,12,86700,102000,96.0,2387,2023-04-06T18:55,0,86700
462,595040,13,210000,0,95.0,8740,2023-04-06T18:55,0,210000
463,2101924,14,99900,0,96.0,1364,2023-04-06T18:55,0,99900
464,2237841,15,195000,0,98.0,60,2023-04-06T18:55,0,195000
465,2432733,16,44900,59000,97.0,2784,2023-04-06T18:55,0,44900
466,1897197,17,47200,59000,96.0,946,2023-04-06T18:55,0,47200
467,1129750,18,69000,0,97.0,3920,2023-04-06T18:55,0,69000
468,2910082,19,265500,295000,98.0,468,2023-04-06T18:55,0,265500
469,1334438,20,170000,0,96.0,4394,2023-04-06T18:55,0,170000
470,2621831,21,59800,85000,95.0,711,2023-04-06T18:55,-5980,53820
471,1720817,22,175000,0,98.0,187,2023-04-06T18:55,-8750,166250
472,1568047,23,159000,0,95.0,12008,2023-04-06T18:55,0,159000
473,1719363,24,190000,0,97.0,75,2023-04-06T18:55,-9500,180500
474,1891201,25,155000,0,98.0,192,2023-04-06T18:55,-7750,147250
475,2650879,26,169000,0,100.0,19,2023-04-06T18:55,0,169000
476,1828166,27,168000,210000,94.0,847,2023-04-06T18:55,0,168000
477,2624538,28,40900,59000,97.0,1448,2023-04-06T18:55,0,40900
478,2816812,29,119900,0,92.0,1525,2023-04-06T18:55,0,119900
479,2071613,30,99000,0,92.0,1499,2023-04-06T18:55,0,99000
480,2735953,31,207000,230000,98.0,408,2023-04-06T18:55,0,207000
481,2430426,32,169000,0,98.0,729,2023-04-06T18:55,0,169000
482,451851,33,268000,0,97.0,1951,2023-04-06T18:55,0,268000
483,1890398,34,138000,168000,96.0,2726,2023-04-06T18:55,0,138000
484,1891202,35,165000,0,98.0,91,2023-04-06T18:55,-8250,156750
485,1262092,36,250000,0,96.0,772,2023-04-06T18:55,0,250000
486,2069832,37,298000,332000,95.0,766,2023-04-06T18:55,-14900,283100
487,1699941,38,67150,79000,97.0,4834,2023-04-06T18:55,-3358,63792
488,1810760,39,120000,150000,96.0,159,2023-04-06T18:55,0,120000
489,3052437,40,139500,155000,97.0,43,2023-04-06T18:55,-27900,111600
490,1419869,41,70300,74000,95.0,10568,2023-04-06T18:55,0,70300
491,2395327,42,149000,0,97.0,543,2023-04-06T18:55,0,149000
492,2690519,43,73800,82000,96.0,174,2023-04-06T18:55,-3690,70110
493,2440524,44,69000,0,97.0,1529,2023-04-06T18:55,-6900,62100
494,3049313,45,57100,64900,97.0,549,2023-04-06T18:55,0,57100
495,2363570,46,39900,55000,97.0,989,2023-04-06T18:55,0,39900
496,2725559,47,47200,59000,100.0,20,2023-04-06T18:55,0,47200
497,2664372,48,65000,0,97.0,1049,2023-04-06T18:55,0,65000
498,607298,49,53600,59000,93.0,15573,2023-04-06T18:55,0,53600
499,1439535,50,49000,0,96.0,16313,2023-04-06T18:55,0,49000
500,2814379,51,160000,200000,98.0,24,2023-04-06T18:55,0,160000
501,3132471,52,79000,0,100.0,3,2023-04-06T18:55,-7900,71100
502,2305529,53,138000,168000,97.0,91,2023-04-06T18:55,0,138000
503,3124959,54,52200,58000,98.0,35,2023-04-06T18:55,-2610,49590
504,2664373,55,65000,0,97.0,1001,2023-04-06T18:55,0,65000
505,2379000,56,151500,159000,97.0,112,2023-04-06T18:55,0,151500
506,595038,57,210000,0,96.0,1323,2023-04-06T18:55,0,210000
507,1438359,58,98000,0,97.0,1177,2023-04-06T18:55,0,98000
508,2210201,59,259000,299000,94.0,194,2023-04-06T18:55,-12950,246050
509,2818506,60,168000,280000,95.0,129,2023-04-06T18:55,0,168000
510,3167199,61,205000,0,0.0,0,2023-04-06T18:55,-10250,194750
511,1754219,62,31200,39000,96.0,2250,2023-04-06T18:55,0,31200
512,3093902,63,169000,0,97.0,17,2023-04-06T18:55,0,169000
513,1926895,64,49900,108000,93.0,4161,2023-04-06T18:55,0,49900
514,685185,65,148000,198000,95.0,12490,2023-04-06T18:55,0,148000
515,501198,66,129000,139000,95.0,2739,2023-04-06T18:55,0,129000
516,2114461,67,384900,428000,98.0,181,2023-04-06T18:55,0,384900
517,3128322,68,98100,109000,96.0,26,2023-04-06T18:55,0,98100
518,1128656,69,86800,99000,95.0,21614,2023-04-06T18:55,0,86800
519,1215246,70,54300,110000,95.0,360,2023-04-06T18:55,0,54300
520,1859865,71,166600,238000,95.0,66,2023-04-06T18:55,0,166600
521,2143833,72,91800,108000,96.0,2415,2023-04-06T18:55,0,91800
522,2910086,73,265500,295000,98.0,191,2023-04-06T18:55,0,265500
523,2599641,74,67830,119000,96.0,2005,2023-04-06T18:55,-3392,64438
524,2383245,75,99000,0,98.0,824,2023-04-06T18:55,0,99000
525,1439527,76,49000,0,95.0,13429,2023-04-06T18:55,0,49000
526,1815709,77,138000,168000,96.0,7130,2023-04-06T18:55,0,138000
527,2736221,78,99000,110000,96.0,248,2023-04-06T18:55,0,99000
528,1021359,79,76000,100000,94.0,5377,2023-04-06T18:55,0,76000
529,2816816,80,143890,159900,97.0,1861,2023-04-06T18:55,0,143890
530,2518112,81,89250,105000,96.0,961,2023-04-06T18:55,0,89250
531,626636,82,260000,0,96.0,1111,2023-04-06T18:55,0,260000
532,3132539,83,69000,0,100.0,2,2023-04-06T18:55,-6900,62100
533,2419871,84,44900,59000,97.0,904,2023-04-06T18:55,0,44900
534,2814394,85,168000,240000,100.0,1,2023-04-06T18:55,0,168000
535,2330196,86,59000,0,97.0,633,2023-04-06T18:55,0,59000
536,636821,87,152100,169000,93.0,2583,2023-04-06T18:55,0,152100
537,1010925,88,170000,0,96.0,2088,2023-04-06T18:55,0,170000
538,3097625,89,95000,0,100.0,3,2023-04-06T18:55,0,95000
539,2355318,90,109900,0,96.0,642,2023-04-06T18:55,0,109900
540,1822717,1,56050,59000,97.0,4297,2023-04-06T18:55,-2803,53247
541,1214164,2,36000,0,96.0,24899,2023-04-06T18:55,0,36000
542,2280117,3,35100,39000,97.0,6233,2023-04-06T18:55,0,35100
543,2134140,4,39000,0,97.0,3496,2023-04-06T18:55,0,39000
544,2879419,5,46900,55000,98.0,691,2023-04-06T18:55,0,46900
545,1771137,6,26100,29000,97.0,12487,2023-04-06T18:55,0,26100
546,1022014,7,79000,0,96.0,11433,2023-04-06T18:55,0,79000
547,1214174,8,36000,0,97.0,15008,2023-04-06T18:55,0,36000
548,1272626,9,36000,0,96.0,14121,2023-04-06T18:55,0,36000
549,2286829,10,37000,0,95.0,4928,2023-04-06T18:55,0,37000
550,1214173,11,36000,0,96.0,5556,2023-04-06T18:55,0,36000
551,1214109,12,36000,0,97.0,8108,2023-04-06T18:55,0,36000
552,2356713,13,39000,0,97.0,1450,2023-04-06T18:55,0,39000
553,1771132,14,26100,29000,96.0,5239,2023-04-06T18:55,0,26100
554,1214317,15,36000,0,97.0,11475,2023-04-06T18:55,0,36000
555,2134158,16,39000,0,97.0,2491,2023-04-06T18:55,0,39000
556,1771133,17,26100,29000,97.0,5692,2023-04-06T18:55,0,26100
557,1214169,18,36000,0,97.0,5321,2023-04-06T18:55,0,36000
558,2879425,19,46900,55000,98.0,272,2023-04-06T18:55,0,46900
559,1855444,20,39900,42000,97.0,3008,2023-04-06T18:55,0,39900
560,2123132,21,39000,0,97.0,6380,2023-04-06T18:55,-3900,35100
561,1906772,22,39900,42000,97.0,3058,2023-04-06T18:55,0,39900
562,1920929,23,39000,0,97.0,3966,2023-04-06T18:55,0,39000
563,1925814,24,35100,39000,96.0,1643,2023-04-06T18:55,0,35100
564,2929128,25,335000,565000,0.0,0,2023-04-06T18:55,0,335000
565,1022013,26,79000,0,96.0,6259,2023-04-06T18:55,0,79000
566,2287131,27,37000,0,95.0,1625,2023-04-06T18:55,0,37000
567,2221221,28,35100,39000,96.0,1858,2023-04-06T18:55,0,35100
568,2464070,29,44000,55000,96.0,344,2023-04-06T18:55,-2200,41800
569,2356693,30,39000,0,97.0,1517,2023-04-06T18:55,0,39000
570,2356711,31,39000,0,98.0,1482,2023-04-06T18:55,0,39000
571,1907733,32,29900,39000,96.0,3820,2023-04-06T18:55,0,29900
572,2028240,33,39000,0,98.0,3341,2023-04-06T18:55,0,39000
573,2384630,34,42000,0,98.0,750,2023-04-06T18:55,0,42000
574,2107999,35,36000,0,97.0,2663,2023-04-06T18:55,0,36000
575,1524720,36,36000,0,96.0,3371,2023-04-06T18:55,0,36000
576,1755276,37,49000,0,97.0,2404,2023-04-06T18:55,0,49000
577,2560668,38,58650,69000,97.0,1243,2023-04-06T18:55,0,58650
578,2134287,39,39000,0,98.0,702,2023-04-06T18:55,0,39000
579,1335132,40,29000,0,95.0,1101,2023-04-06T18:55,0,29000
580,2715553,41,68000,0,95.0,256,2023-04-06T18:55,0,68000
581,3012243,42,29900,39900,98.0,61,2023-04-06T18:55,0,29900
582,3153584,43,45000,0,99.0,36,2023-04-06T18:55,-2250,42750
583,3125906,44,80100,89000,100.0,7,2023-04-06T18:55,0,80100
584,2329375,45,34710,39000,96.0,2082,2023-04-06T18:55,0,34710
585,2591291,46,39200,49000,97.0,1018,2023-04-06T18:55,0,39200
586,2922336,47,52000,0,97.0,144,2023-04-06T18:55,0,52000
587,1214106,48,36000,0,96.0,9730,2023-04-06T18:55,0,36000
588,1214171,49,36000,0,97.0,1705,2023-04-06T18:55,0,36000
589,2687157,50,45000,0,97.0,1034,2023-04-06T18:55,0,45000
590,2864774,51,49000,0,98.0,90,2023-04-06T18:55,0,49000
591,2089719,52,36000,0,97.0,2405,2023-04-06T18:55,0,36000
592,2879417,53,46900,55000,98.0,190,2023-04-06T18:55,0,46900
593,2672186,54,20900,30000,96.0,570,2023-04-06T18:55,-2090,18810
594,3203657,55,68000,0,0.0,0,2023-04-06T18:55,0,68000
595,1602670,56,56050,59000,97.0,741,2023-04-06T18:55,0,56050
596,3142350,57,49000,0,100.0,13,2023-04-06T18:55,-4900,44100
597,2148582,58,42000,0,97.0,1424,2023-04-06T18:55,0,42000
598,1086824,59,29600,37000,95.0,18619,2023-04-06T18:55,0,29600
599,3039055,60,34400,43000,93.0,35,2023-04-06T18:55,0,34400
600,2756881,61,47700,53000,96.0,35,2023-04-06T18:55,-4770,42930
601,2707659,62,42000,0,97.0,511,2023-04-06T18:55,0,42000
602,2998516,63,29000,0,96.0,144,2023-04-06T18:55,0,29000
603,1906773,64,39900,42000,97.0,657,2023-04-06T18:55,0,39900
604,3129450,65,44100,49000,0.0,0,2023-04-06T18:55,0,44100
605,1214193,66,39000,0,97.0,15343,2023-04-06T18:55,0,39000
606,3142351,67,49000,0,100.0,16,2023-04-06T18:55,-4900,44100
607,2864918,68,49000,0,99.0,120,2023-04-06T18:55,0,49000
608,1433907,69,29250,39000,93.0,1484,2023-04-06T18:55,0,29250
609,2683883,70,69000,0,97.0,121,2023-04-06T18:55,0,69000
610,1126959,71,29250,39000,91.0,2552,2023-04-06T18:55,0,29250
611,2650965,72,46900,53000,98.0,366,2023-04-06T18:55,0,46900
612,2507021,73,42000,0,96.0,410,2023-04-06T18:55,0,42000
613,2164773,74,69000,0,97.0,517,2023-04-06T18:55,0,69000
614,2364344,75,26600,38000,97.0,1685,2023-04-06T18:55,0,26600
615,3142349,76,49000,0,100.0,7,2023-04-06T18:55,-4900,44100
616,3042427,77,89000,0,97.0,9,2023-04-06T18:55,0,89000
617,1760824,78,49700,59000,97.0,300,2023-04-06T18:55,0,49700
618,2573131,79,39900,42000,98.0,693,2023-04-06T18:55,0,39900
619,1296603,80,36000,0,96.0,1562,2023-04-06T18:55,0,36000
620,3146218,81,46000,0,90.0,4,2023-04-06T18:55,0,46000
621,2280146,82,35100,39000,97.0,925,2023-04-06T18:55,0,35100
622,3153581,83,45000,0,100.0,11,2023-04-06T18:55,-2250,42750
623,3099784,84,57000,0,100.0,6,2023-04-06T18:55,0,57000
624,2650964,85,46900,53000,98.0,185,2023-04-06T18:55,0,46900
625,2106843,86,49000,0,97.0,801,2023-04-06T18:55,0,49000
626,1535402,87,39000,0,97.0,1195,2023-04-06T18:55,0,39000
627,3188727,88,59900,0,0.0,0,2023-04-06T18:55,0,59900
628,2134295,89,39000,0,97.0,401,2023-04-06T18:55,0,39000
629,1497550,90,29600,37000,95.0,5677,2023-04-06T18:55,0,29600
630,3008189,1,334000,478000,100.0,3,2023-04-06T18:55,-33400,300600
631,3106487,2,148000,0,99.0,25,2023-04-06T18:55,0,148000
632,3073257,3,196200,218000,94.0,10,2023-04-06T18:55,-29430,166770
633,3186158,4,418000,0,0.0,0,2023-04-06T18:55,-75240,342760
634,3053225,5,159000,0,100.0,2,2023-04-06T18:55,0,159000
635,3112830,6,360000,0,0.0,0,2023-04-06T18:55,-64800,295200
636,3008191,7,348000,498000,100.0,1,2023-04-06T18:55,-34800,313200
637,3083230,8,159000,0,100.0,4,2023-04-06T18:55,0,159000
638,1511128,9,168000,0,97.0,51,2023-04-06T18:55,0,168000
639,3008190,10,334000,478000,100.0,1,2023-04-06T18:55,-33400,300600
640,3117209,11,338000,0,0.0,0,2023-04-06T18:55,-60840,277160
641,3134492,12,79000,0,100.0,3,2023-04-06T18:55,0,79000
642,2587982,13,293300,419000,80.0,3,2023-04-06T18:55,-35196,258104
643,1779568,14,57600,64000,95.0,289,2023-04-06T18:55,0,57600
644,3109926,15,69700,82000,86.0,3,2023-04-06T18:55,-13940,55760
645,2457512,16,237300,339000,98.0,36,2023-04-06T18:55,0,237300
646,2820729,17,375000,750000,0.0,0,2023-04-06T18:55,0,375000
647,3102177,18,230000,0,100.0,1,2023-04-06T18:55,0,230000
648,3158246,19,278000,0,0.0,0,2023-04-06T18:55,-27800,250200
649,2590132,20,280000,0,0.0,0,2023-04-06T18:55,-50400,229600
650,3098628,21,222740,259000,0.0,0,2023-04-06T18:55,-33411,189329
651,3203197,22,264000,0,0.0,0,2023-04-06T18:55,0,264000
652,2568529,23,220000,0,100.0,10,2023-04-06T18:55,0,220000
653,3145625,24,249000,0,0.0,0,2023-04-06T18:55,-12450,236550
654,3196932,25,151050,159000,0.0,0,2023-04-06T18:55,-7553,143497
655,3084760,26,119000,0,100.0,1,2023-04-06T18:55,0,119000
656,3096967,27,249000,0,0.0,0,2023-04-06T18:55,0,249000
657,2377832,28,195000,0,95.0,174,2023-04-06T18:55,0,195000
658,3135904,29,92000,0,100.0,4,2023-04-06T18:55,0,92000
659,3146600,30,235600,248000,0.0,0,2023-04-06T18:55,0,235600
660,2605850,31,94000,0,97.0,164,2023-04-06T18:55,0,94000
661,2848613,32,86900,0,100.0,3,2023-04-06T18:55,0,86900
662,3156875,33,224000,0,0.0,0,2023-04-06T18:55,0,224000
663,3196917,34,151050,159000,0.0,0,2023-04-06T18:55,-7553,143497
664,3154817,35,218000,0,0.0,0,2023-04-06T18:55,0,218000
665,2717734,36,79000,0,97.0,56,2023-04-06T18:55,0,79000
666,2795049,37,226000,0,0.0,0,2023-04-06T18:55,0,226000
667,2593633,38,212000,0,100.0,3,2023-04-06T18:55,0,212000
668,3155023,39,58500,78000,0.0,0,2023-04-06T18:55,-11700,46800
669,2714524,40,48300,69000,95.0,397,2023-04-06T18:55,-9660,38640
670,2153636,41,173600,248000,98.0,30,2023-04-06T18:55,0,173600
671,3073253,42,196200,218000,0.0,0,2023-04-06T18:55,-29430,166770
672,2492543,43,169000,0,95.0,13,2023-04-06T18:55,-30420,138580
673,3096975,44,199000,0,0.0,0,2023-04-06T18:55,0,199000
674,2830893,45,189000,0,100.0,5,2023-04-06T18:55,0,189000
675,1511131,46,168000,0,96.0,57,2023-04-06T18:55,0,168000
676,2830892,47,189000,0,100.0,1,2023-04-06T18:55,0,189000
677,1871030,48,133600,167000,95.0,100,2023-04-06T18:55,0,133600
678,2478652,49,57800,68000,94.0,329,2023-04-06T18:55,0,57800
679,3053223,50,179000,0,100.0,4,2023-04-06T18:55,0,179000
680,3053221,51,179000,0,0.0,0,2023-04-06T18:55,0,179000
681,3156576,52,191200,239000,0.0,0,2023-04-06T18:55,0,191200
682,3055337,53,159000,0,0.0,0,2023-04-06T18:55,0,159000
683,3126193,54,63200,79000,100.0,1,2023-04-06T18:55,0,63200
684,1431138,55,179000,0,100.0,6,2023-04-06T18:55,0,179000
685,3146761,56,179100,199000,0.0,0,2023-04-06T18:55,-26865,152235
686,2613666,57,169200,188000,90.0,12,2023-04-06T18:55,0,169200
687,3156602,58,179100,199000,0.0,0,2023-04-06T18:55,0,179100
688,3196948,59,122550,129000,0.0,0,2023-04-06T18:55,-6128,116422
689,2585187,60,148000,0,94.0,11,2023-04-06T18:55,0,148000
690,2612357,61,69000,139000,96.0,15,2023-04-06T18:55,0,69000
691,2567533,62,176000,0,0.0,0,2023-04-06T18:55,0,176000
692,3174225,63,161100,179000,0.0,0,2023-04-06T18:55,-24165,136935
693,2453664,64,148400,185500,100.0,5,2023-04-06T18:55,0,148400
694,1103286,65,94000,0,94.0,778,2023-04-06T18:55,0,94000
695,2610806,66,226000,473000,0.0,0,2023-04-06T18:55,0,226000
696,2528000,67,168000,0,100.0,5,2023-04-06T18:55,0,168000
697,2970900,68,189000,0,100.0,6,2023-04-06T18:55,0,189000
698,1911293,69,168000,0,0.0,0,2023-04-06T18:55,0,168000
699,3122373,70,151200,168000,0.0,0,2023-04-06T18:55,-22680,128520
700,3083239,71,159000,0,0.0,0,2023-04-06T18:55,0,159000
701,2714533,72,48300,69000,93.0,232,2023-04-06T18:55,-9660,38640
702,2424645,73,80000,179000,94.0,11,2023-04-06T18:55,0,80000
703,3130620,74,149000,0,0.0,0,2023-04-06T18:55,0,149000
704,3130622,75,149000,0,0.0,0,2023-04-06T18:55,0,149000
705,2558167,76,151240,199000,97.0,9,2023-04-06T18:55,0,151240
706,2920324,77,158000,0,0.0,0,2023-04-06T18:55,0,158000
707,3195133,78,159000,0,0.0,0,2023-04-06T18:55,0,159000
708,2512635,79,35400,59000,96.0,206,2023-04-06T18:55,0,35400
709,3111732,80,67200,84000,100.0,3,2023-04-06T18:55,-3360,63840
710,2703252,81,167300,239000,96.0,11,2023-04-06T18:55,-20076,147224
711,2415412,82,148000,0,100.0,8,2023-04-06T18:55,0,148000
712,2558807,83,137600,172000,91.0,19,2023-04-06T18:55,0,137600
713,2489892,84,142200,158000,95.0,20,2023-04-06T18:55,0,142200
714,3137353,85,149000,0,0.0,0,2023-04-06T18:55,0,149000
715,3092123,86,142200,158000,100.0,2,2023-04-06T18:55,0,142200
716,2507573,87,149000,0,0.0,0,2023-04-06T18:55,0,149000
717,3162414,88,79000,0,0.0,0,2023-04-06T18:55,0,79000
718,2714448,89,49600,62000,91.0,104,2023-04-06T18:55,-9920,39680
719,2424653,90,139300,199000,100.0,4,2023-04-06T18:55,-16716,122584
720,2378594,1,88200,98000,95.0,126,2023-04-06T18:55,0,88200
721,3073252,2,160200,178000,100.0,4,2023-04-06T18:55,-24030,136170
722,2551401,3,37900,0,94.0,304,2023-04-06T18:55,0,37900
723,3107292,4,152100,169000,0.0,0,2023-04-06T18:55,-22815,129285
724,3073254,5,160200,178000,92.0,8,2023-04-06T18:55,-24030,136170
725,3147257,6,378000,0,0.0,0,2023-04-06T18:55,-45360,332640
726,2377812,7,188100,198000,96.0,58,2023-04-06T18:55,-22572,165528
727,2235510,8,360000,0,100.0,4,2023-04-06T18:55,-64800,295200
728,2643318,9,124000,138000,95.0,16,2023-04-06T18:55,-18600,105400
729,3070528,10,168000,0,93.0,3,2023-04-06T18:55,0,168000
730,2756335,11,125400,132000,96.0,59,2023-04-06T18:55,0,125400
731,2836351,12,49680,72000,96.0,451,2023-04-06T18:55,-9936,39744
732,2631865,13,174000,290000,0.0,0,2023-04-06T18:55,0,174000
733,3098351,14,161100,179000,100.0,1,2023-04-06T18:55,-24165,136935
734,2448900,15,43900,0,96.0,94,2023-04-06T18:55,0,43900
735,3051036,16,95200,119000,100.0,5,2023-04-06T18:55,0,95200
736,2925522,17,58500,65000,95.0,102,2023-04-06T18:55,0,58500
737,3000422,18,59000,0,97.0,25,2023-04-06T18:55,0,59000
738,3112821,19,304000,320000,0.0,0,2023-04-06T18:55,-45600,258400
739,3051039,20,95200,119000,100.0,18,2023-04-06T18:55,0,95200
740,2571642,21,149000,0,96.0,10,2023-04-06T18:55,0,149000
741,2830808,22,139000,0,97.0,16,2023-04-06T18:55,0,139000
742,3026955,23,86700,102000,80.0,2,2023-04-06T18:55,0,86700
743,1931894,24,37900,0,95.0,509,2023-04-06T18:55,0,37900
744,3178575,25,290000,0,0.0,0,2023-04-06T18:55,0,290000
745,3038069,26,89100,99000,100.0,13,2023-04-06T18:55,0,89100
746,3190559,27,264000,378000,0.0,0,2023-04-06T18:55,-26400,237600
747,3040758,28,83200,111000,98.0,11,2023-04-06T18:55,-4160,79040
748,1690312,29,260000,0,100.0,1,2023-04-06T18:55,0,260000
749,3101514,30,122500,129000,100.0,4,2023-04-06T18:55,-24500,98000
750,3194479,31,113050,119000,0.0,0,2023-04-06T18:55,-5653,107397
751,2360537,32,77900,82000,96.0,81,2023-04-06T18:55,0,77900
752,3160116,33,126000,140000,0.0,0,2023-04-06T18:55,-18900,107100
753,3024747,34,240000,0,0.0,0,2023-04-06T18:55,-43200,196800
754,3099073,35,238000,0,0.0,0,2023-04-06T18:55,-42840,195160
755,3194014,36,118000,0,0.0,0,2023-04-06T18:55,0,118000
756,1324169,37,29900,0,95.0,1331,2023-04-06T18:55,0,29900
757,2849028,38,77500,0,0.0,0,2023-04-06T18:55,0,77500
758,2448899,39,43900,0,95.0,135,2023-04-06T18:55,0,43900
759,2591530,40,218000,0,80.0,1,2023-04-06T18:55,-39240,178760
760,3144374,41,71100,79000,100.0,3,2023-04-06T18:55,0,71100
761,3100234,42,196200,218000,0.0,0,2023-04-06T18:55,-29430,166770
762,2607580,43,238000,0,0.0,0,2023-04-06T18:55,-42840,195160
763,3160024,44,111200,139000,0.0,0,2023-04-06T18:55,0,111200
764,2373068,45,98100,109000,91.0,55,2023-04-06T18:55,0,98100
765,2416846,46,54000,67900,92.0,80,2023-04-06T18:55,0,54000
766,2117249,47,32900,0,94.0,453,2023-04-06T18:55,0,32900
767,2691884,48,198000,0,0.0,0,2023-04-06T18:55,-35640,162360
768,2747061,49,199000,0,0.0,0,2023-04-06T18:55,-35820,163180
769,3190834,50,198000,0,0.0,0,2023-04-06T18:55,-5940,192060
770,3134486,51,188340,219000,0.0,0,2023-04-06T18:55,-28251,160089
771,2942764,52,189000,0,98.0,12,2023-04-06T18:55,0,189000
772,2377814,53,188100,198000,96.0,73,2023-04-06T18:55,-22572,165528
773,3150273,54,186000,0,0.0,0,2023-04-06T18:55,0,186000
774,3109155,55,41650,49000,93.0,15,2023-04-06T18:55,-8330,33320
775,2801889,56,179400,299000,100.0,2,2023-04-06T18:55,-17940,161460
776,3049792,57,71100,79000,100.0,7,2023-04-06T18:55,0,71100
777,3069510,58,170100,189000,100.0,4,2023-04-06T18:55,-25515,144585
778,2738716,59,151200,168000,94.0,28,2023-04-06T18:55,0,151200
779,2664567,60,173000,0,0.0,0,2023-04-06T18:55,0,173000
780,2860567,61,167300,239000,95.0,4,2023-04-06T18:55,-20076,147224
781,3069519,62,170100,189000,90.0,2,2023-04-06T18:55,-25515,144585
782,1944554,63,36900,0,96.0,536,2023-04-06T18:55,0,36900
783,3125458,64,171000,0,0.0,0,2023-04-06T18:55,0,171000
784,3031104,65,55200,69000,98.0,57,2023-04-06T18:55,0,55200
785,2390967,66,39530,59000,93.0,210,2023-04-06T18:55,-7906,31624
786,2830788,67,139000,0,96.0,26,2023-04-06T18:55,0,139000
787,2452284,68,167300,239000,0.0,0,2023-04-06T18:55,0,167300
788,2758483,69,158000,0,100.0,10,2023-04-06T18:55,-28440,129560
789,2618806,70,165000,0,0.0,0,2023-04-06T18:55,0,165000
790,1788995,71,58500,65000,94.0,560,2023-04-06T18:55,0,58500
791,2836289,72,39530,59000,95.0,202,2023-04-06T18:55,-7906,31624
792,2063182,73,23000,46000,95.0,19,2023-04-06T18:55,0,23000
793,2830762,74,139000,0,99.0,46,2023-04-06T18:55,0,139000
794,2571681,75,149000,0,86.0,9,2023-04-06T18:55,0,149000
795,3092933,76,139000,0,80.0,1,2023-04-06T18:55,0,139000
796,1560183,77,44000,49000,93.0,875,2023-04-06T18:55,0,44000
797,2297209,78,155400,259000,0.0,0,2023-04-06T18:55,0,155400
798,2942714,79,149000,0,0.0,0,2023-04-06T18:55,0,149000
799,1819994,80,36500,43000,92.0,658,2023-04-06T18:55,0,36500
800,2796166,81,51200,64000,96.0,228,2023-04-06T18:55,0,51200
801,3178147,82,150000,0,0.0,0,2023-04-06T18:55,0,150000
802,3149612,83,125100,139000,0.0,0,2023-04-06T18:55,-18765,106335
803,1955949,84,29700,45000,96.0,481,2023-04-06T18:55,-5940,23760
804,3200163,85,139000,0,0.0,0,2023-04-06T18:55,-25020,113980
805,1645760,86,43900,0,96.0,340,2023-04-06T18:55,0,43900
806,3192943,87,122550,129000,0.0,0,2023-04-06T18:55,-6128,116422
807,3049781,88,76000,95000,0.0,0,2023-04-06T18:55,0,76000
808,3111742,89,55200,69000,0.0,0,2023-04-06T18:55,-2760,52440
809,3078112,90,134100,149000,0.0,0,2023-04-06T18:55,0,134100
810,991339,1,17890,19900,97.0,52643,2023-04-06T18:55,0,17890
811,1986031,2,24990,27900,97.0,10537,2023-04-06T18:55,0,24990
812,998051,3,12900,24000,97.0,162495,2023-04-06T18:55,0,12900
813,1094748,4,19900,0,97.0,19084,2023-04-06T18:55,0,19900
814,991340,5,17890,19900,97.0,30814,2023-04-06T18:55,0,17890
815,763821,6,13900,22000,96.0,31332,2023-04-06T18:55,0,13900
816,1477845,7,15400,22000,96.0,9631,2023-04-06T18:55,0,15400
817,1443937,8,24000,0,97.0,7901,2023-04-06T18:55,0,24000
818,1094835,9,14290,15900,97.0,6197,2023-04-06T18:55,0,14290
819,792919,10,15190,16900,96.0,17912,2023-04-06T18:55,0,15190
820,2959925,11,22000,27500,98.0,93,2023-04-06T18:55,-2200,19800
821,1342874,12,16900,33000,97.0,12744,2023-04-06T18:55,0,16900
822,1986029,13,27900,0,97.0,3930,2023-04-06T18:55,0,27900
823,991570,14,12900,20000,97.0,19039,2023-04-06T18:55,0,12900
824,1996705,15,23690,27900,98.0,2679,2023-04-06T18:55,0,23690
825,734085,16,10900,19800,96.0,64717,2023-04-06T18:55,0,10900
826,1996702,17,23690,27900,97.0,1921,2023-04-06T18:55,0,23690
827,746158,18,22900,0,96.0,20512,2023-04-06T18:55,0,22900
828,1729576,19,9500,13900,97.0,16044,2023-04-06T18:55,0,9500
829,479245,20,15400,22000,93.0,5391,2023-04-06T18:55,0,15400
830,746154,21,17900,0,96.0,5160,2023-04-06T18:55,0,17900
831,2297277,22,19900,22000,95.0,283,2023-04-06T18:55,0,19900
832,2845854,23,13200,18900,97.0,208,2023-04-06T18:55,0,13200
833,991341,24,16890,19900,96.0,10199,2023-04-06T18:55,0,16890
834,1821485,25,30000,0,96.0,1250,2023-04-06T18:55,0,30000
835,2832613,26,11200,33000,97.0,659,2023-04-06T18:55,0,11200
836,1986030,27,23690,27900,97.0,1668,2023-04-06T18:55,0,23690
837,1094749,28,19900,0,96.0,4951,2023-04-06T18:55,0,19900
838,3118094,29,28800,32000,95.0,4,2023-04-06T18:55,0,28800
839,1346009,30,9900,12000,97.0,6684,2023-04-06T18:55,0,9900
840,1094750,31,16890,19900,97.0,3551,2023-04-06T18:55,0,16890
841,2011852,32,21490,23900,97.0,1301,2023-04-06T18:55,0,21490
842,1094834,33,21490,23900,96.0,2457,2023-04-06T18:55,0,21490
843,3134423,34,39000,0,100.0,2,2023-04-06T18:55,0,39000
844,1477846,35,15400,22000,96.0,2672,2023-04-06T18:55,0,15400
845,1974077,36,42090,46900,97.0,896,2023-04-06T18:55,0,42090
846,2821598,37,19390,22900,97.0,144,2023-04-06T18:55,0,19390
847,792920,38,15190,16900,96.0,9661,2023-04-06T18:55,0,15190
848,746159,39,22900,0,95.0,28719,2023-04-06T18:55,0,22900
849,2960555,40,19000,0,94.0,98,2023-04-06T18:55,0,19000
850,1996704,41,22290,27900,98.0,700,2023-04-06T18:55,0,22290
851,3009680,42,12590,14900,97.0,106,2023-04-06T18:55,0,12590
852,1260383,43,19900,0,95.0,1452,2023-04-06T18:55,0,19900
853,1647682,44,14900,23600,97.0,949,2023-04-06T18:55,0,14900
854,1358721,45,14200,22000,96.0,1118,2023-04-06T18:55,0,14200
855,1094837,46,13490,15900,96.0,1752,2023-04-06T18:55,0,13490
856,2821589,47,19690,21900,96.0,36,2023-04-06T18:55,0,19690
857,2509300,48,19900,0,96.0,392,2023-04-06T18:55,0,19900
858,2798430,49,24000,29000,97.0,42,2023-04-06T18:55,-3600,20400
859,1094836,50,14290,15900,97.0,1312,2023-04-06T18:55,0,14290
860,2964177,51,23400,36000,92.0,14,2023-04-06T18:55,0,23400
861,1260384,52,19900,0,95.0,1800,2023-04-06T18:55,0,19900
862,792921,53,15190,16900,95.0,7807,2023-04-06T18:55,0,15190
863,746155,54,17900,0,95.0,1261,2023-04-06T18:55,0,17900
864,1092994,55,22900,0,96.0,2650,2023-04-06T18:55,0,22900
865,2973095,56,20000,25000,100.0,24,2023-04-06T18:55,-2000,18000
866,752821,57,9900,0,94.0,23751,2023-04-06T18:55,0,9900
867,1286366,58,11900,24000,97.0,9793,2023-04-06T18:55,0,11900
868,2477854,59,17890,19900,98.0,1457,2023-04-06T18:55,0,17890
869,3065854,60,21250,25000,97.0,16,2023-04-06T18:55,0,21250
870,2346958,61,18200,24000,98.0,513,2023-04-06T18:55,0,18200
871,2467197,62,30000,0,95.0,131,2023-04-06T18:55,0,30000
872,1475031,63,16900,27000,96.0,1722,2023-04-06T18:55,0,16900
873,2122868,64,9500,13900,97.0,3840,2023-04-06T18:55,0,9500
874,3197136,65,75050,79000,0.0,0,2023-04-06T18:55,-3753,71297
875,2870865,66,15900,19900,96.0,63,2023-04-06T18:55,0,15900
876,1839836,67,9500,15000,97.0,328,2023-04-06T18:55,0,9500
877,1573974,68,39790,46900,97.0,1451,2023-04-06T18:55,0,39790
878,3135826,69,45000,0,0.0,0,2023-04-06T18:55,0,45000
879,2347097,70,14900,24000,98.0,1545,2023-04-06T18:55,0,14900
880,2649999,71,12800,16000,94.0,79,2023-04-06T18:55,0,12800
881,2295818,72,19900,22000,95.0,185,2023-04-06T18:55,0,19900
882,2855921,73,23000,27000,96.0,5,2023-04-06T18:55,-3450,19550
883,2973894,74,22000,27500,98.0,22,2023-04-06T18:55,-2200,19800
884,2293399,75,19900,22000,96.0,626,2023-04-06T18:55,0,19900
885,2990345,76,27900,0,98.0,47,2023-04-06T18:55,0,27900
886,924947,77,14900,19800,96.0,3606,2023-04-06T18:55,0,14900
887,2477852,78,17890,19900,98.0,682,2023-04-06T18:55,0,17890
888,958997,79,16090,17900,95.0,1408,2023-04-06T18:55,0,16090
889,2624467,80,27900,44000,93.0,23,2023-04-06T18:55,0,27900
890,1121544,81,15190,16900,96.0,863,2023-04-06T18:55,0,15190
891,2652523,82,9500,12000,98.0,111,2023-04-06T18:55,0,9500
892,2821590,83,19690,21900,98.0,45,2023-04-06T18:55,0,19690
893,3026986,84,25900,0,100.0,5,2023-04-06T18:55,0,25900
894,1821487,85,30000,0,97.0,677,2023-04-06T18:55,0,30000
895,1475055,86,16200,22000,96.0,1171,2023-04-06T18:55,0,16200
896,2845855,87,13200,18900,98.0,47,2023-04-06T18:55,0,13200
897,2821597,88,22900,0,98.0,103,2023-04-06T18:55,0,22900
898,1348077,89,10900,16500,97.0,1858,2023-04-06T18:55,0,10900
899,2738094,90,19900,0,96.0,174,2023-04-06T18:55,0,19900
