,item_id,rank,price,del_price,rating,rating_count,time,coupon,real_price
0,2442409,1,39000,78000,96.0,9668,2023-05-02T20:34,-5850,33150
1,1848166,2,34300,49000,97.0,41902,2023-05-02T20:34,0,34300
2,2272830,3,35910,39900,97.0,21497,2023-05-02T20:34,-7182,28728
3,3187851,4,49900,110000,96.0,517,2023-05-02T20:34,-4990,44910
4,1763157,5,43900,52000,96.0,3142,2023-05-02T20:34,0,43900
5,2575342,6,39900,59000,96.0,1092,2023-05-02T20:34,-5985,33915
6,1944612,7,35800,59700,97.0,3335,2023-05-02T20:34,0,35800
7,3046771,8,39560,46000,98.0,265,2023-05-02T20:34,0,39560
8,2285512,9,43900,52000,96.0,1994,2023-05-02T20:34,0,43900
9,1921901,10,36900,70500,96.0,7969,2023-05-02T20:34,0,36900
10,345889,11,29900,47900,96.0,10780,2023-05-02T20:34,-2990,26910
11,3204179,12,49900,0,96.0,152,2023-05-02T20:34,0,49900
12,2646350,13,59800,94000,95.0,5386,2023-05-02T20:34,-11960,47840
13,2122566,14,33800,0,97.0,17436,2023-05-02T20:34,-5070,28730
14,3266515,15,100000,200000,0.0,0,2023-05-02T20:34,0,100000
15,3219911,16,69900,118000,97.0,116,2023-05-02T20:34,-10485,59415
16,1971243,17,24900,45000,95.0,402,2023-05-02T20:34,-7470,17430
17,2479911,18,49400,76000,97.0,4849,2023-05-02T20:34,-2470,46930
18,1884943,19,27900,39000,96.0,19293,2023-05-02T20:34,0,27900
19,3114844,20,49300,58000,100.0,2,2023-05-02T20:34,-4930,44370
20,2996536,21,39900,59000,96.0,944,2023-05-02T20:34,-5985,33915
21,2086653,22,16900,0,97.0,41528,2023-05-02T20:34,0,16900
22,3043740,23,49700,59000,98.0,123,2023-05-02T20:34,-2485,47215
23,1882578,24,35910,39900,97.0,11196,2023-05-02T20:34,-7182,28728
24,1899755,25,27900,39000,96.0,5236,2023-05-02T20:34,0,27900
25,2700429,26,493000,0,100.0,6,2023-05-02T20:34,0,493000
26,3114897,27,67150,79000,100.0,4,2023-05-02T20:34,-6715,60435
27,2645415,28,63200,79000,98.0,407,2023-05-02T20:34,0,63200
28,3249024,29,55800,62000,0.0,0,2023-05-02T20:34,0,55800
29,3105468,30,63200,79000,98.0,166,2023-05-02T20:34,0,63200
30,3114908,31,75650,89000,100.0,1,2023-05-02T20:34,-7565,68085
31,1763123,32,84550,89000,96.0,1738,2023-05-02T20:34,0,84550
32,2453556,33,39900,42000,97.0,6593,2023-05-02T20:34,0,39900
33,2409894,34,39000,78000,97.0,5460,2023-05-02T20:34,-5850,33150
34,2376229,35,32400,36000,97.0,4063,2023-05-02T20:34,0,32400
35,1939099,36,31850,49000,97.0,12372,2023-05-02T20:34,0,31850
36,2034137,37,31800,0,97.0,18852,2023-05-02T20:34,-4770,27030
37,994588,38,39900,53000,94.0,6263,2023-05-02T20:34,-4788,35112
38,1058098,39,34200,38000,97.0,611,2023-05-02T20:34,-3420,30780
39,3266517,40,70000,150000,0.0,0,2023-05-02T20:34,0,70000
40,1706633,41,199000,0,97.0,2536,2023-05-02T20:34,0,199000
41,2329308,42,39100,46000,97.0,1352,2023-05-02T20:34,0,39100
42,3143791,43,45900,68000,97.0,1215,2023-05-02T20:34,-6885,39015
43,2376233,44,32400,36000,97.0,2404,2023-05-02T20:34,0,32400
44,2623779,45,88200,98000,97.0,162,2023-05-02T20:34,0,88200
45,3046818,46,39560,46000,98.0,176,2023-05-02T20:34,0,39560
46,2462040,47,38000,45000,95.0,4153,2023-05-02T20:34,0,38000
47,3214271,48,49200,82000,98.0,416,2023-05-02T20:34,0,49200
48,3201923,49,87200,109000,100.0,12,2023-05-02T20:34,-13080,74120
49,3114843,50,49300,58000,100.0,8,2023-05-02T20:34,-4930,44370
50,1763218,51,84550,89000,96.0,1579,2023-05-02T20:34,0,84550
51,3042516,52,42000,65000,96.0,302,2023-05-02T20:34,-6300,35700
52,2326935,53,47400,79000,96.0,13258,2023-05-02T20:34,-7110,40290
53,1336398,54,33500,67000,96.0,19332,2023-05-02T20:34,-6700,26800
54,1742666,55,46900,66000,96.0,4138,2023-05-02T20:34,-7035,39865
55,3265079,56,42000,0,96.0,145,2023-05-02T20:34,0,42000
56,3206068,57,52900,74000,98.0,825,2023-05-02T20:34,-2645,50255
57,1848797,58,169000,0,96.0,160,2023-05-02T20:34,0,169000
58,3265713,59,150000,300000,0.0,0,2023-05-02T20:34,0,150000
59,3163734,60,63200,79000,98.0,229,2023-05-02T20:34,0,63200
60,2426596,61,34400,43000,96.0,3102,2023-05-02T20:34,0,34400
61,1820701,62,31500,35000,97.0,5680,2023-05-02T20:34,0,31500
62,2913659,63,47900,64000,96.0,444,2023-05-02T20:34,0,47900
63,2398380,64,27000,45000,96.0,1985,2023-05-02T20:34,-2700,24300
64,1503352,65,39900,42000,97.0,8653,2023-05-02T20:34,0,39900
65,1911516,66,48900,81900,95.0,6278,2023-05-02T20:34,-4890,44010
66,3129723,67,31200,39000,97.0,199,2023-05-02T20:34,-4680,26520
67,3214275,68,49200,82000,98.0,656,2023-05-02T20:34,0,49200
68,3149296,69,39900,59000,97.0,147,2023-05-02T20:34,-5985,33915
69,3227259,70,39900,45000,97.0,9,2023-05-02T20:34,-11970,27930
70,3259338,71,88200,98000,100.0,3,2023-05-02T20:34,0,88200
71,996177,72,14290,15900,95.0,78407,2023-05-02T20:34,0,14290
72,2375962,73,59000,62000,98.0,6111,2023-05-02T20:34,0,59000
73,3134406,74,53910,59900,99.0,347,2023-05-02T20:34,-10782,43128
74,2313388,75,76500,85000,96.0,2351,2023-05-02T20:34,0,76500
75,3064420,76,61500,69000,98.0,203,2023-05-02T20:34,-3075,58425
76,3211815,77,24500,35000,97.0,129,2023-05-02T20:34,0,24500
77,1779737,78,20800,32000,96.0,7654,2023-05-02T20:34,0,20800
78,1934937,79,34400,43000,97.0,835,2023-05-02T20:34,0,34400
79,3046775,80,39560,46000,96.0,125,2023-05-02T20:34,0,39560
80,2630449,81,33600,42000,96.0,701,2023-05-02T20:34,-5040,28560
81,3086241,82,39800,49800,98.0,41,2023-05-02T20:34,0,39800
82,1836749,83,119000,0,95.0,39,2023-05-02T20:34,0,119000
83,3125099,84,29900,39000,97.0,63,2023-05-02T20:34,-4485,25415
84,3200626,85,22300,24800,98.0,71,2023-05-02T20:34,0,22300
85,1031260,86,33600,42000,96.0,13343,2023-05-02T20:34,0,33600
86,1955452,87,39800,69990,95.0,2852,2023-05-02T20:34,0,39800
87,2690691,88,20000,22000,98.0,1343,2023-05-02T20:34,0,20000
88,1846930,89,21400,39000,96.0,8561,2023-05-02T20:34,0,21400
89,1417691,90,13900,0,97.0,19268,2023-05-02T20:34,0,13900
90,3033083,1,97900,109000,97.0,112,2023-05-02T20:34,-29370,68530
91,1558197,2,81900,0,97.0,33455,2023-05-02T20:34,0,81900
92,1778404,3,42000,45000,96.0,68980,2023-05-02T20:34,-4200,37800
93,2061715,4,83900,105000,97.0,2944,2023-05-02T20:34,0,83900
94,2723218,5,69900,85900,97.0,3400,2023-05-02T20:34,-10485,59415
95,3012082,6,59900,79000,96.0,1409,2023-05-02T20:34,-8985,50915
96,1571879,7,79900,112900,96.0,7354,2023-05-02T20:34,-11985,67915
97,1856181,8,35910,39900,97.0,9035,2023-05-02T20:34,-7182,28728
98,1776552,9,65000,69000,94.0,6347,2023-05-02T20:34,-9750,55250
99,1790383,10,59000,86000,95.0,6094,2023-05-02T20:34,-8850,50150
100,2329532,11,129630,149000,97.0,4232,2023-05-02T20:34,0,129630
101,3033224,12,59900,74000,97.0,995,2023-05-02T20:34,-8985,50915
102,3046899,13,95900,105000,96.0,201,2023-05-02T20:34,-28770,67130
103,1530516,14,69900,79000,96.0,2594,2023-05-02T20:34,-10485,59415
104,1683384,15,599000,0,99.0,38,2023-05-02T20:34,0,599000
105,1108007,16,71890,79900,95.0,48104,2023-05-02T20:34,0,71890
106,1283757,17,75490,83900,96.0,27079,2023-05-02T20:34,0,75490
107,2184466,18,359000,0,98.0,38,2023-05-02T20:34,0,359000
108,3029811,19,63200,79000,96.0,388,2023-05-02T20:34,-6320,56880
109,1737051,20,62300,89000,96.0,5241,2023-05-02T20:34,0,62300
110,3092774,21,139900,0,97.0,29,2023-05-02T20:34,-20985,118915
111,1139192,22,66400,94900,97.0,14616,2023-05-02T20:34,-9960,56440
112,2822678,23,89900,149000,96.0,305,2023-05-02T20:34,0,89900
113,946995,24,112500,125000,94.0,2925,2023-05-02T20:34,-16875,95625
114,1778408,25,42000,45000,95.0,12107,2023-05-02T20:34,-4200,37800
115,3124313,26,83300,98000,93.0,9,2023-05-02T20:34,-8330,74970
116,3042939,27,88900,95000,94.0,50,2023-05-02T20:34,-26670,62230
117,2891213,28,109900,189000,96.0,223,2023-05-02T20:34,0,109900
118,2471405,29,89000,138000,97.0,2309,2023-05-02T20:34,-10680,78320
119,2444808,30,83900,0,97.0,782,2023-05-02T20:34,0,83900
120,1530517,31,69900,79000,96.0,2307,2023-05-02T20:34,-10485,59415
121,1776549,32,65000,69000,94.0,4692,2023-05-02T20:34,-9750,55250
122,2732486,33,89000,179000,98.0,919,2023-05-02T20:34,0,89000
123,3124310,34,83300,98000,0.0,0,2023-05-02T20:34,-8330,74970
124,3042934,35,125900,139000,98.0,37,2023-05-02T20:34,-37770,88130
125,2572705,36,168300,198000,96.0,89,2023-05-02T20:34,-28611,139689
126,3184338,37,2322000,2850000,0.0,0,2023-05-02T20:34,0,2322000
127,2329533,38,129630,149000,97.0,1467,2023-05-02T20:34,0,129630
128,3054935,39,89900,0,96.0,142,2023-05-02T20:34,0,89900
129,2159724,40,29900,32000,95.0,2559,2023-05-02T20:34,0,29900
130,2751502,41,103200,129000,90.0,10,2023-05-02T20:34,-10320,92880
131,1751722,42,53910,59900,97.0,3623,2023-05-02T20:34,-10782,43128
132,3037473,43,69900,85900,96.0,456,2023-05-02T20:34,-10485,59415
133,727847,44,68500,159000,93.0,11055,2023-05-02T20:34,-10275,58225
134,1571878,45,79900,112900,96.0,4935,2023-05-02T20:34,-11985,67915
135,1139338,46,66400,94900,97.0,17212,2023-05-02T20:34,-9960,56440
136,1776365,47,53400,89000,96.0,4743,2023-05-02T20:34,-8010,45390
137,2322836,48,139200,174000,97.0,1095,2023-05-02T20:34,-20880,118320
138,3051261,49,53400,89000,96.0,198,2023-05-02T20:34,-8010,45390
139,2381781,50,249000,0,98.0,891,2023-05-02T20:34,0,249000
140,2379844,51,97300,139000,96.0,162,2023-05-02T20:34,0,97300
141,3186581,52,126650,149000,100.0,2,2023-05-02T20:34,-12665,113985
142,2288426,53,79000,109000,94.0,907,2023-05-02T20:34,-11850,67150
143,3010527,54,237150,279000,97.0,348,2023-05-02T20:34,0,237150
144,3092776,55,139900,0,96.0,17,2023-05-02T20:34,-20985,118915
145,1618312,56,83900,0,97.0,7394,2023-05-02T20:34,0,83900
146,3157691,57,188100,209000,99.0,21,2023-05-02T20:34,-22572,165528
147,2064545,58,59800,94000,97.0,11573,2023-05-02T20:34,-7176,52624
148,1776550,59,65000,69000,94.0,4243,2023-05-02T20:34,-9750,55250
149,2343199,60,119000,129000,98.0,2010,2023-05-02T20:34,0,119000
150,2836481,61,279000,0,99.0,114,2023-05-02T20:34,0,279000
151,1567183,62,71100,94900,97.0,7592,2023-05-02T20:34,-10665,60435
152,1576700,63,89000,129000,97.0,17283,2023-05-02T20:34,-8900,80100
153,3100545,64,129000,0,97.0,36,2023-05-02T20:34,0,129000
154,3047188,65,109650,129000,99.0,80,2023-05-02T20:34,0,109650
155,1558683,66,81900,0,97.0,6430,2023-05-02T20:34,0,81900
156,2357957,67,149000,0,97.0,2292,2023-05-02T20:34,0,149000
157,2820551,68,1596000,0,0.0,0,2023-05-02T20:34,0,1596000
158,2752332,69,94700,105300,95.0,2786,2023-05-02T20:34,0,94700
159,2887119,70,45900,89000,96.0,162,2023-05-02T20:34,0,45900
160,2788216,71,146000,159000,98.0,237,2023-05-02T20:34,0,146000
161,3023666,72,42000,49000,97.0,347,2023-05-02T20:34,-4200,37800
162,3029809,73,63200,79000,98.0,184,2023-05-02T20:34,-6320,56880
163,1760178,74,139200,174000,96.0,264,2023-05-02T20:34,-20880,118320
164,3037468,75,49900,68500,97.0,138,2023-05-02T20:34,-7485,42415
165,2683549,76,149000,0,97.0,2683,2023-05-02T20:34,0,149000
166,1857631,77,89900,136000,94.0,113,2023-05-02T20:34,-13485,76415
167,2784041,78,1496000,0,100.0,1,2023-05-02T20:34,0,1496000
168,2537153,79,54500,109000,97.0,776,2023-05-02T20:34,-6540,47960
169,1337094,80,69900,0,96.0,5612,2023-05-02T20:34,0,69900
170,3055246,81,159000,0,97.0,108,2023-05-02T20:34,0,159000
171,3080043,82,89100,99000,95.0,92,2023-05-02T20:34,-8910,80190
172,3037472,83,69900,85900,96.0,300,2023-05-02T20:34,-10485,59415
173,2820619,84,1428000,0,100.0,7,2023-05-02T20:34,0,1428000
174,2743475,85,1440000,0,0.0,0,2023-05-02T20:34,0,1440000
175,3010441,86,249000,0,98.0,149,2023-05-02T20:34,0,249000
176,2702015,87,79800,99000,95.0,767,2023-05-02T20:34,0,79800
177,2819023,88,99900,149000,95.0,138,2023-05-02T20:34,0,99900
178,3051570,89,69000,93000,97.0,49,2023-05-02T20:34,-6900,62100
179,2668986,90,35910,39900,96.0,3811,2023-05-02T20:34,-7182,28728
180,2112059,1,36400,52000,97.0,44931,2023-05-02T20:34,-3640,32760
181,1924274,2,49900,66000,95.0,23082,2023-05-02T20:34,-7485,42415
182,750908,3,35900,54000,96.0,85528,2023-05-02T20:34,0,35900
183,2092852,4,42000,52800,96.0,11939,2023-05-02T20:34,-4200,37800
184,1551840,5,39000,0,97.0,85764,2023-05-02T20:34,-3900,35100
185,1926048,6,32000,0,97.0,15472,2023-05-02T20:34,-3200,28800
186,2060719,7,47800,69000,96.0,5874,2023-05-02T20:34,-5736,42064
187,1149329,8,39900,0,96.0,87520,2023-05-02T20:34,0,39900
188,2060717,9,55200,69000,95.0,4288,2023-05-02T20:34,-5520,49680
189,2060720,10,55200,69000,96.0,2847,2023-05-02T20:34,-5520,49680
190,2028327,11,44890,49900,97.0,9758,2023-05-02T20:34,0,44890
191,1168906,12,41900,0,97.0,72534,2023-05-02T20:34,0,41900
192,1149328,13,35890,39900,96.0,95229,2023-05-02T20:34,0,35890
193,2112061,14,36400,52000,97.0,15683,2023-05-02T20:34,-3640,32760
194,1370101,15,39000,89000,96.0,24063,2023-05-02T20:34,0,39000
195,2358429,16,119250,159000,98.0,2847,2023-05-02T20:34,-11925,107325
196,3141395,17,49900,73900,96.0,510,2023-05-02T20:34,0,49900
197,2569078,18,59250,79000,96.0,2644,2023-05-02T20:34,0,59250
198,3154699,19,49800,63000,96.0,282,2023-05-02T20:34,0,49800
199,3024451,20,79900,109000,94.0,21,2023-05-02T20:34,-7990,71910
200,1568057,21,49600,62000,96.0,23101,2023-05-02T20:34,-7440,42160
201,858911,22,39000,49000,95.0,67695,2023-05-02T20:34,-3900,35100
202,2351467,23,39800,54000,96.0,7012,2023-05-02T20:34,-5970,33830
203,2060743,24,33000,55000,95.0,3858,2023-05-02T20:34,0,33000
204,1440874,25,39900,0,95.0,15410,2023-05-02T20:34,0,39900
205,3134710,26,79900,0,96.0,37,2023-05-02T20:34,-11985,67915
206,2495075,27,49800,72000,95.0,12506,2023-05-02T20:34,-9960,39840
207,3086712,28,50900,85000,97.0,304,2023-05-02T20:34,-7635,43265
208,1885631,29,39000,49000,96.0,24070,2023-05-02T20:34,-3900,35100
209,3044076,30,80100,89000,97.0,77,2023-05-02T20:34,-12015,68085
210,1627892,31,43900,0,97.0,11878,2023-05-02T20:34,0,43900
211,2789111,32,79200,99000,97.0,1161,2023-05-02T20:34,0,79200
212,1555407,33,74100,78000,97.0,11947,2023-05-02T20:34,0,74100
213,1539028,34,61900,89000,95.0,4827,2023-05-02T20:34,-18570,43330
214,2150457,35,119250,159000,97.0,4273,2023-05-02T20:34,-17888,101362
215,3129951,36,39800,49800,98.0,98,2023-05-02T20:34,-3980,35820
216,3252638,37,59800,86000,96.0,25,2023-05-02T20:34,-5980,53820
217,1551839,38,39000,0,97.0,24512,2023-05-02T20:34,-3900,35100
218,1222184,39,37690,41900,97.0,49117,2023-05-02T20:34,0,37690
219,2184087,40,49000,89000,96.0,4388,2023-05-02T20:34,0,49000
220,2578996,41,39900,59000,95.0,4940,2023-05-02T20:34,-5985,33915
221,2028326,42,49900,0,97.0,6707,2023-05-02T20:34,0,49900
222,1436504,43,41900,0,96.0,9457,2023-05-02T20:34,0,41900
223,2060759,44,59800,74800,97.0,7614,2023-05-02T20:34,-5980,53820
224,1323090,45,73600,92000,96.0,6244,2023-05-02T20:34,-11040,62560
225,2503133,46,42000,52800,96.0,3288,2023-05-02T20:34,-4200,37800
226,1778523,47,39000,49000,96.0,3599,2023-05-02T20:34,-3900,35100
227,3129953,48,39800,49800,98.0,56,2023-05-02T20:34,-3980,35820
228,1926034,49,32000,0,97.0,3317,2023-05-02T20:34,-3200,28800
229,3043508,50,71200,89000,98.0,423,2023-05-02T20:34,0,71200
230,883004,51,69900,89000,94.0,9593,2023-05-02T20:34,0,69900
231,1159065,52,59000,83000,95.0,21880,2023-05-02T20:34,-5900,53100
232,1369488,53,34900,49000,95.0,2312,2023-05-02T20:34,-10470,24430
233,2706287,54,29000,54000,95.0,4501,2023-05-02T20:34,0,29000
234,2723714,55,52000,58000,96.0,1988,2023-05-02T20:34,0,52000
235,2381406,56,124200,138000,98.0,2430,2023-05-02T20:34,0,124200
236,1595607,57,57900,89000,97.0,5967,2023-05-02T20:34,-8685,49215
237,2129180,58,76300,109000,96.0,462,2023-05-02T20:34,-9156,67144
238,1753533,59,59900,105000,95.0,3326,2023-05-02T20:34,-17970,41930
239,2261213,60,121500,135000,98.0,4238,2023-05-02T20:34,0,121500
240,3163314,61,58800,98000,93.0,699,2023-05-02T20:34,0,58800
241,3051693,62,55900,0,100.0,3,2023-05-02T20:34,0,55900
242,1985223,63,39000,89000,96.0,1878,2023-05-02T20:34,0,39000
243,2092849,64,42000,52800,96.0,10081,2023-05-02T20:34,-4200,37800
244,890521,65,39800,63000,94.0,11517,2023-05-02T20:34,0,39800
245,2789091,66,79200,99000,97.0,1142,2023-05-02T20:34,0,79200
246,2678399,67,33900,69000,96.0,1081,2023-05-02T20:34,0,33900
247,1568032,68,49600,62000,96.0,6468,2023-05-02T20:34,-7440,42160
248,2330460,69,118400,148000,97.0,2008,2023-05-02T20:34,-11840,106560
249,2562527,70,29400,42000,97.0,4460,2023-05-02T20:34,-5880,23520
250,1885345,71,36000,45000,97.0,2064,2023-05-02T20:34,-10800,25200
251,2569079,72,67150,79000,96.0,1263,2023-05-02T20:34,0,67150
252,1552753,73,74100,78000,97.0,28553,2023-05-02T20:34,0,74100
253,3154697,74,49800,63000,96.0,214,2023-05-02T20:34,0,49800
254,1436218,75,39900,68000,95.0,20123,2023-05-02T20:34,0,39900
255,1317598,76,39000,0,97.0,5637,2023-05-02T20:34,0,39000
256,2574822,77,22900,27800,96.0,2001,2023-05-02T20:34,0,22900
257,2496647,78,34300,49000,96.0,545,2023-05-02T20:34,-10290,24010
258,3046898,79,69900,89000,95.0,94,2023-05-02T20:34,-20970,48930
259,1736085,80,43900,59800,96.0,37923,2023-05-02T20:34,0,43900
260,2032901,81,35890,39900,97.0,7221,2023-05-02T20:34,0,35890
261,1985224,82,39000,89000,96.0,2065,2023-05-02T20:34,0,39000
262,1246215,83,52000,65000,96.0,6509,2023-05-02T20:34,-7800,44200
263,3220911,84,129000,0,97.0,356,2023-05-02T20:34,0,129000
264,2749153,85,66600,74000,97.0,733,2023-05-02T20:34,0,66600
265,2725611,86,115200,128000,98.0,2397,2023-05-02T20:34,0,115200
266,2592084,87,39900,59000,96.0,688,2023-05-02T20:34,-5985,33915
267,2459074,88,51900,69000,96.0,1017,2023-05-02T20:34,0,51900
268,1885563,89,39000,49000,95.0,4659,2023-05-02T20:34,-3900,35100
269,3034850,90,135150,159000,98.0,195,2023-05-02T20:34,-13515,121635
270,2537633,1,338000,388000,97.0,31,2023-05-02T20:34,-33800,304200
271,2537628,2,338000,388000,98.0,40,2023-05-02T20:34,-33800,304200
272,2537631,3,338000,388000,100.0,24,2023-05-02T20:34,-33800,304200
273,2806847,4,318000,368000,98.0,16,2023-05-02T20:34,-31800,286200
274,2806850,5,318000,368000,100.0,29,2023-05-02T20:34,-31800,286200
275,3241206,6,259000,289000,0.0,0,2023-05-02T20:34,0,259000
276,3241208,7,259000,289000,0.0,0,2023-05-02T20:34,0,259000
277,3241207,8,259000,289000,0.0,0,2023-05-02T20:34,0,259000
278,3241217,9,229000,259000,0.0,0,2023-05-02T20:34,0,229000
279,3241215,10,229000,259000,0.0,0,2023-05-02T20:34,0,229000
280,1789507,11,79000,0,98.0,26578,2023-05-02T20:34,-7900,71100
281,2806849,12,318000,368000,100.0,9,2023-05-02T20:34,-31800,286200
282,1034480,13,135000,150000,97.0,18430,2023-05-02T20:34,0,135000
283,3241214,14,229000,259000,0.0,0,2023-05-02T20:34,0,229000
284,2806848,15,318000,368000,100.0,13,2023-05-02T20:34,-31800,286200
285,3241216,16,229000,259000,0.0,0,2023-05-02T20:34,0,229000
286,2633416,17,3159000,0,100.0,3,2023-05-02T20:34,-20000,3139000
287,3165919,18,288000,0,0.0,0,2023-05-02T20:34,0,288000
288,3241209,19,189000,219000,0.0,0,2023-05-02T20:34,0,189000
289,3241212,20,189000,219000,0.0,0,2023-05-02T20:34,0,189000
290,1969507,21,88000,0,98.0,5687,2023-05-02T20:34,0,88000
291,3241205,22,169000,199000,0.0,0,2023-05-02T20:34,0,169000
292,2770508,23,138000,0,97.0,394,2023-05-02T20:34,0,138000
293,2422175,24,145800,162000,98.0,269,2023-05-02T20:34,0,145800
294,1835080,25,98000,0,97.0,3005,2023-05-02T20:34,0,98000
295,3241211,26,189000,219000,0.0,0,2023-05-02T20:34,0,189000
296,3165926,27,288000,0,0.0,0,2023-05-02T20:34,0,288000
297,2702033,28,127200,159000,97.0,476,2023-05-02T20:34,-12720,114480
298,3241210,29,189000,219000,0.0,0,2023-05-02T20:34,0,189000
299,1264107,30,65000,90000,97.0,6645,2023-05-02T20:34,-9750,55250
300,3241203,31,169000,199000,0.0,0,2023-05-02T20:34,0,169000
301,2911057,32,2575000,3820000,100.0,1,2023-05-02T20:34,0,2575000
302,3024801,33,138000,0,98.0,41,2023-05-02T20:34,0,138000
303,2897978,34,2610000,0,0.0,0,2023-05-02T20:34,-20000,2590000
304,2657250,35,125400,169000,98.0,189,2023-05-02T20:34,0,125400
305,3034751,36,64800,72000,96.0,825,2023-05-02T20:34,0,64800
306,3165922,37,288000,0,0.0,0,2023-05-02T20:34,0,288000
307,2066837,38,79000,119000,97.0,6780,2023-05-02T20:34,-11850,67150
308,3047568,39,99330,129000,97.0,162,2023-05-02T20:34,0,99330
309,2393864,40,2210000,3130000,100.0,1,2023-05-02T20:34,0,2210000
310,3038000,41,74700,83000,96.0,613,2023-05-02T20:34,-11205,63495
311,3241204,42,169000,199000,0.0,0,2023-05-02T20:34,0,169000
312,1969488,43,88000,0,98.0,1874,2023-05-02T20:34,0,88000
313,2086532,44,98000,124000,97.0,447,2023-05-02T20:34,-11760,86240
314,1650065,45,161100,179000,98.0,215,2023-05-02T20:34,-19332,141768
315,2514819,46,59000,66000,97.0,974,2023-05-02T20:34,0,59000
316,1447194,47,64900,230000,96.0,3022,2023-05-02T20:34,-3245,61655
317,2849886,48,1851000,2430000,93.0,6,2023-05-02T20:34,0,1851000
318,1842449,49,84000,99000,97.0,5601,2023-05-02T20:34,-12600,71400
319,2818754,50,1860000,0,0.0,0,2023-05-02T20:34,0,1860000
320,2757112,51,359000,0,93.0,116,2023-05-02T20:34,-71800,287200
321,3170663,52,1680000,2350000,0.0,0,2023-05-02T20:34,0,1680000
322,1090160,53,99000,0,97.0,1372,2023-05-02T20:34,0,99000
323,3011494,54,69900,79000,95.0,321,2023-05-02T20:34,-10485,59415
324,3037524,55,74800,88000,96.0,79,2023-05-02T20:34,-3740,71060
325,3034745,56,75600,84000,98.0,275,2023-05-02T20:34,0,75600
326,1564343,57,92800,119000,98.0,8243,2023-05-02T20:34,0,92800
327,3161081,58,169200,188000,100.0,12,2023-05-02T20:34,0,169200
328,693318,59,79000,110000,96.0,13331,2023-05-02T20:34,-11850,67150
329,2700259,60,1764000,0,0.0,0,2023-05-02T20:34,0,1764000
330,3161658,61,502000,900000,0.0,0,2023-05-02T20:34,-20000,482000
331,342189,62,39500,52000,95.0,16011,2023-05-02T20:34,0,39500
332,2305287,63,69800,0,98.0,1116,2023-05-02T20:34,-8376,61424
333,1744101,64,109000,0,98.0,3001,2023-05-02T20:34,0,109000
334,1964770,65,59400,66000,97.0,2594,2023-05-02T20:34,-8910,50490
335,1758217,66,43900,56000,97.0,13320,2023-05-02T20:34,-5268,38632
336,3164863,67,69000,139000,0.0,0,2023-05-02T20:34,0,69000
337,3187993,68,395000,0,100.0,4,2023-05-02T20:34,0,395000
338,2630526,69,100000,0,96.0,754,2023-05-02T20:34,0,100000
339,3070516,70,138000,0,98.0,65,2023-05-02T20:34,0,138000
340,2343664,71,89000,0,97.0,1363,2023-05-02T20:34,0,89000
341,2344538,72,119000,0,98.0,6691,2023-05-02T20:34,0,119000
342,2279619,73,89000,0,97.0,516,2023-05-02T20:34,0,89000
343,2584181,74,57600,72000,99.0,1334,2023-05-02T20:34,0,57600
344,2271789,75,71100,79000,97.0,2689,2023-05-02T20:34,0,71100
345,2229665,76,145350,153000,97.0,420,2023-05-02T20:34,-21803,123547
346,2789785,77,140600,148000,97.0,751,2023-05-02T20:34,-7030,133570
347,1528287,78,46500,49000,96.0,4844,2023-05-02T20:34,0,46500
348,1736022,79,188000,0,96.0,497,2023-05-02T20:34,0,188000
349,1910358,80,99000,0,98.0,2596,2023-05-02T20:34,0,99000
350,1315954,81,219000,0,93.0,617,2023-05-02T20:34,-43800,175200
351,3034749,82,64800,72000,97.0,615,2023-05-02T20:34,0,64800
352,2914924,83,369000,439000,98.0,20,2023-05-02T20:34,0,369000
353,1456515,84,49500,55000,97.0,8909,2023-05-02T20:34,-7425,42075
354,1323612,85,238000,0,97.0,3895,2023-05-02T20:34,-23800,214200
355,2325729,86,87200,109000,97.0,856,2023-05-02T20:34,-13080,74120
356,2930265,87,91000,0,97.0,724,2023-05-02T20:34,0,91000
357,2911054,88,1098000,1590000,97.0,38,2023-05-02T20:34,0,1098000
358,2754080,89,88000,0,97.0,566,2023-05-02T20:34,0,88000
359,3048786,90,1458000,3050000,93.0,3,2023-05-02T20:34,0,1458000
360,1622069,1,119000,0,98.0,6165,2023-05-02T20:34,0,119000
361,2638067,2,99000,139000,97.0,3518,2023-05-02T20:34,-29700,69300
362,3030422,3,117900,139000,97.0,1051,2023-05-02T20:34,-35370,82530
363,1762406,4,260000,0,98.0,3618,2023-05-02T20:34,0,260000
364,1762407,5,260000,0,97.0,3653,2023-05-02T20:34,0,260000
365,577636,6,99900,139000,95.0,31478,2023-05-02T20:34,-29970,69930
366,2545799,7,149000,0,98.0,2513,2023-05-02T20:34,0,149000
367,810034,8,85500,95000,97.0,45630,2023-05-02T20:34,0,85500
368,969541,9,69000,0,97.0,30834,2023-05-02T20:34,0,69000
369,2861393,10,96900,139000,93.0,352,2023-05-02T20:34,-29070,67830
370,2565212,11,119000,0,99.0,495,2023-05-02T20:34,0,119000
371,311052,12,53100,59000,97.0,41708,2023-05-02T20:34,0,53100
372,3091287,13,119000,0,98.0,458,2023-05-02T20:34,0,119000
373,2861392,14,96900,139000,97.0,692,2023-05-02T20:34,-29070,67830
374,1473136,15,119900,149000,97.0,10886,2023-05-02T20:34,0,119900
375,1622068,16,119000,0,97.0,7048,2023-05-02T20:34,0,119000
376,490136,17,76000,95000,98.0,3009,2023-05-02T20:34,0,76000
377,2383963,18,139000,0,96.0,210,2023-05-02T20:34,0,139000
378,2899663,19,109900,159000,96.0,92,2023-05-02T20:34,-32970,76930
379,2733049,20,79900,119000,96.0,666,2023-05-02T20:34,0,79900
380,1608838,21,67900,85000,97.0,12757,2023-05-02T20:34,-13580,54320
381,181907,22,89900,119000,97.0,7379,2023-05-02T20:34,0,89900
382,2293400,23,129000,0,96.0,1182,2023-05-02T20:34,0,129000
383,490135,24,75900,95000,98.0,3651,2023-05-02T20:34,0,75900
384,2785168,25,179000,0,99.0,115,2023-05-02T20:34,0,179000
385,695334,26,78900,99000,96.0,9735,2023-05-02T20:34,0,78900
386,2622254,27,109000,0,98.0,1039,2023-05-02T20:34,0,109000
387,816033,28,70900,89000,96.0,13593,2023-05-02T20:34,0,70900
388,2577087,29,89900,139000,97.0,492,2023-05-02T20:34,-26970,62930
389,2320478,30,129000,0,97.0,633,2023-05-02T20:34,0,129000
390,2703013,31,75900,129000,96.0,44,2023-05-02T20:34,-22770,53130
391,2731878,32,67900,79000,97.0,2104,2023-05-02T20:34,0,67900
392,186610,33,75900,85000,97.0,16926,2023-05-02T20:34,0,75900
393,2404877,34,39000,109000,96.0,618,2023-05-02T20:34,-9750,29250
394,810033,35,89100,99000,97.0,34467,2023-05-02T20:34,0,89100
395,2161992,36,69900,95000,97.0,3678,2023-05-02T20:34,0,69900
396,3033084,37,129000,0,99.0,94,2023-05-02T20:34,0,129000
397,2996167,38,96900,139000,97.0,227,2023-05-02T20:34,-29070,67830
398,2233180,39,75900,109000,97.0,14707,2023-05-02T20:34,0,75900
399,102618,40,54900,69000,97.0,6270,2023-05-02T20:34,-10980,43920
400,1955217,41,89000,109000,96.0,5449,2023-05-02T20:34,-13350,75650
401,3033248,42,109000,0,97.0,831,2023-05-02T20:34,0,109000
402,2996166,43,109900,129000,96.0,59,2023-05-02T20:34,-32970,76930
403,1296778,44,99000,0,97.0,2279,2023-05-02T20:34,0,99000
404,1470186,45,75000,0,97.0,3042,2023-05-02T20:34,0,75000
405,1492897,46,59900,75000,96.0,3331,2023-05-02T20:34,-11980,47920
406,2848244,47,115900,129000,96.0,26,2023-05-02T20:34,-34770,81130
407,1493265,48,85500,95000,98.0,5088,2023-05-02T20:34,0,85500
408,1594352,49,67900,85000,97.0,5670,2023-05-02T20:34,-13580,54320
409,2899664,50,109900,159000,97.0,186,2023-05-02T20:34,0,109900
410,2899656,51,109900,159000,96.0,197,2023-05-02T20:34,0,109900
411,810032,52,85500,95000,97.0,13885,2023-05-02T20:34,0,85500
412,1296776,53,99000,0,98.0,3025,2023-05-02T20:34,0,99000
413,3048675,54,59000,89000,99.0,72,2023-05-02T20:34,0,59000
414,3024528,55,132050,139000,95.0,137,2023-05-02T20:34,0,132050
415,2861395,56,96900,139000,96.0,626,2023-05-02T20:34,-29070,67830
416,1130307,57,109000,0,97.0,6131,2023-05-02T20:34,0,109000
417,1469860,58,75000,0,97.0,6891,2023-05-02T20:34,0,75000
418,3172975,59,260000,0,97.0,28,2023-05-02T20:34,0,260000
419,1493263,60,89100,99000,98.0,4338,2023-05-02T20:34,0,89100
420,2433728,61,39000,109000,95.0,627,2023-05-02T20:34,-9750,29250
421,2992068,62,99900,129000,98.0,128,2023-05-02T20:34,-29970,69930
422,2741233,63,109000,0,97.0,2937,2023-05-02T20:34,0,109000
423,1900420,64,129000,0,96.0,1541,2023-05-02T20:34,0,129000
424,3079037,65,195000,0,98.0,361,2023-05-02T20:34,0,195000
425,1478592,66,75900,95000,97.0,3260,2023-05-02T20:34,0,75900
426,2909715,67,119000,0,96.0,147,2023-05-02T20:34,0,119000
427,2493214,68,169000,0,98.0,257,2023-05-02T20:34,0,169000
428,957758,69,70900,89000,97.0,4691,2023-05-02T20:34,0,70900
429,2261769,70,69900,119000,95.0,1431,2023-05-02T20:34,0,69900
430,2737457,71,230000,0,98.0,540,2023-05-02T20:34,0,230000
431,2819014,72,49900,79000,96.0,235,2023-05-02T20:34,0,49900
432,2670201,73,59900,109000,97.0,1187,2023-05-02T20:34,0,59900
433,1900410,74,129000,0,97.0,5042,2023-05-02T20:34,0,129000
434,2861396,75,89900,139000,94.0,95,2023-05-02T20:34,-26970,62930
435,2815897,76,79900,109000,95.0,131,2023-05-02T20:34,0,79900
436,2855992,77,159000,0,97.0,710,2023-05-02T20:34,0,159000
437,2233178,78,75900,109000,97.0,5161,2023-05-02T20:34,0,75900
438,1231944,79,119000,0,97.0,1484,2023-05-02T20:34,0,119000
439,3096431,80,139000,0,98.0,94,2023-05-02T20:34,0,139000
440,3109771,81,133900,149000,99.0,82,2023-05-02T20:34,-40170,93730
441,3138474,82,106900,119000,98.0,47,2023-05-02T20:34,-32070,74830
442,3200836,83,179000,0,98.0,91,2023-05-02T20:34,0,179000
443,1608813,84,59900,75000,97.0,1081,2023-05-02T20:34,-11980,47920
444,2992069,85,96900,139000,96.0,237,2023-05-02T20:34,-29070,67830
445,2631192,86,98100,109000,98.0,491,2023-05-02T20:34,0,98100
446,3072688,87,129000,0,100.0,24,2023-05-02T20:34,-38700,90300
447,3172977,88,148000,0,100.0,4,2023-05-02T20:34,0,148000
448,716244,89,69900,95000,98.0,1496,2023-05-02T20:34,0,69900
449,2113853,90,129000,0,97.0,1228,2023-05-02T20:34,0,129000
450,2624538,1,40900,59000,97.0,1872,2023-05-02T20:34,-12270,28630
451,1092992,2,69000,0,97.0,38873,2023-05-02T20:34,0,69000
452,3062046,3,78300,87000,97.0,466,2023-05-02T20:34,0,78300
453,3061996,4,88200,98000,97.0,320,2023-05-02T20:34,0,88200
454,3134621,5,136800,152000,97.0,119,2023-05-02T20:34,0,136800
455,1720822,6,209000,0,97.0,352,2023-05-02T20:34,0,209000
456,2432733,7,44900,59000,97.0,3185,2023-05-02T20:34,-13470,31430
457,1339622,8,42900,59000,97.0,16673,2023-05-02T20:34,-12870,30030
458,3062069,9,71100,79000,96.0,158,2023-05-02T20:34,0,71100
459,3124961,10,65550,69000,96.0,560,2023-05-02T20:34,0,65550
460,2091749,11,71200,89000,95.0,6475,2023-05-02T20:34,0,71200
461,1834405,12,39900,55000,96.0,2760,2023-05-02T20:34,-11970,27930
462,2383245,13,99000,0,98.0,972,2023-05-02T20:34,0,99000
463,1568047,14,143100,159000,95.0,12119,2023-05-02T20:34,-21465,121635
464,3008041,15,44900,59000,98.0,282,2023-05-02T20:34,-13470,31430
465,2419871,16,44900,59000,97.0,1061,2023-05-02T20:34,-13470,31430
466,1891201,17,155000,0,98.0,255,2023-05-02T20:34,0,155000
467,3161736,18,54900,158000,98.0,421,2023-05-02T20:34,-5490,49410
468,2664372,19,69000,0,97.0,1214,2023-05-02T20:34,0,69000
469,2957149,20,44900,59000,98.0,101,2023-05-02T20:34,-13470,31430
470,1828166,21,168000,210000,94.0,871,2023-05-02T20:34,0,168000
471,1926895,22,39990,108000,93.0,4397,2023-05-02T20:34,-3999,35991
472,1890398,23,138000,168000,96.0,2823,2023-05-02T20:34,-20700,117300
473,1439535,24,49000,0,96.0,16455,2023-05-02T20:34,0,49000
474,2816812,25,119900,0,93.0,1634,2023-05-02T20:34,0,119900
475,3133873,26,169000,0,0.0,0,2023-05-02T20:34,0,169000
476,2093156,27,259000,0,92.0,31,2023-05-02T20:34,0,259000
477,3224811,28,138000,0,98.0,20,2023-05-02T20:34,0,138000
478,1439527,29,49000,0,95.0,13489,2023-05-02T20:34,0,49000
479,1891202,30,165000,0,98.0,118,2023-05-02T20:34,0,165000
480,2101924,31,99900,0,96.0,1461,2023-05-02T20:34,0,99900
481,1419869,32,74000,0,95.0,10634,2023-05-02T20:34,0,74000
482,1334438,33,170000,0,96.0,4494,2023-05-02T20:34,0,170000
483,595040,34,210000,0,95.0,8786,2023-05-02T20:34,0,210000
484,1129750,35,69000,0,97.0,4045,2023-05-02T20:34,0,69000
485,2816816,36,135890,159900,97.0,1929,2023-05-02T20:34,0,135890
486,2736221,37,99000,110000,97.0,352,2023-05-02T20:34,0,99000
487,685185,38,148000,198000,95.0,12541,2023-05-02T20:34,-22200,125800
488,2433538,39,86700,102000,96.0,2562,2023-05-02T20:34,0,86700
489,3075621,40,339000,0,98.0,124,2023-05-02T20:34,0,339000
490,3188391,41,170000,0,96.0,6,2023-05-02T20:34,0,170000
491,3218310,42,149000,0,100.0,5,2023-05-02T20:34,0,149000
492,2463767,43,49000,0,96.0,492,2023-05-02T20:34,0,49000
493,2452100,44,59000,0,95.0,309,2023-05-02T20:34,-2950,56050
494,2910082,45,265500,295000,98.0,546,2023-05-02T20:34,0,265500
495,1928038,46,84600,94000,96.0,1205,2023-05-02T20:34,-12690,71910
496,2750309,47,44900,59000,98.0,489,2023-05-02T20:34,0,44900
497,1010925,48,170000,0,96.0,2095,2023-05-02T20:34,0,170000
498,2621831,49,64400,92000,95.0,850,2023-05-02T20:34,-6440,57960
499,3167199,50,205000,0,100.0,5,2023-05-02T20:34,0,205000
500,1813898,51,219000,0,97.0,45,2023-05-02T20:34,0,219000
501,607298,52,53600,59000,93.0,15647,2023-05-02T20:34,0,53600
502,595039,53,210000,0,97.0,3583,2023-05-02T20:34,0,210000
503,2379000,54,159000,0,97.0,159,2023-05-02T20:34,0,159000
504,3128322,55,98100,109000,97.0,61,2023-05-02T20:34,0,98100
505,1562990,56,230000,0,96.0,1300,2023-05-02T20:34,0,230000
506,2462774,57,44900,59000,98.0,820,2023-05-02T20:34,-13470,31430
507,1021359,58,76000,100000,94.0,5436,2023-05-02T20:34,-11400,64600
508,2684749,59,230000,0,97.0,49,2023-05-02T20:34,0,230000
509,3134563,60,88200,98000,95.0,61,2023-05-02T20:34,0,88200
510,3049313,61,57100,64900,97.0,976,2023-05-02T20:34,0,57100
511,2633381,62,992000,0,100.0,1,2023-05-02T20:34,0,992000
512,2555170,63,820000,0,100.0,3,2023-05-02T20:34,0,820000
513,3255625,64,74800,88000,0.0,0,2023-05-02T20:34,-3740,71060
514,1810760,65,135000,150000,96.0,216,2023-05-02T20:34,0,135000
515,1815709,66,138000,168000,96.0,7216,2023-05-02T20:34,-20700,117300
516,2355318,67,98890,109900,96.0,682,2023-05-02T20:34,0,98890
517,1334440,68,119000,170000,96.0,2083,2023-05-02T20:34,0,119000
518,2664373,69,65000,0,97.0,1169,2023-05-02T20:34,0,65000
519,127121,70,141000,152000,95.0,1893,2023-05-02T20:34,0,141000
520,1952910,71,265500,295000,98.0,1758,2023-05-02T20:34,0,265500
521,3223186,72,119000,0,100.0,8,2023-05-02T20:34,0,119000
522,2210201,73,299000,0,94.0,199,2023-05-02T20:34,0,299000
523,501198,74,132000,139000,95.0,2795,2023-05-02T20:34,-6600,125400
524,2725559,75,49300,59000,98.0,56,2023-05-02T20:34,0,49300
525,770006,76,92500,109000,95.0,5698,2023-05-02T20:34,-4625,87875
526,2071613,77,79900,99000,92.0,1526,2023-05-02T20:34,-11985,67915
527,2143833,78,91800,108000,96.0,2488,2023-05-02T20:34,0,91800
528,1762562,79,92500,109000,95.0,343,2023-05-02T20:34,0,92500
529,2552399,80,79200,88000,95.0,325,2023-05-02T20:34,-11880,67320
530,2340324,81,175000,199000,98.0,209,2023-05-02T20:34,-26250,148750
531,1419860,82,69000,0,92.0,4093,2023-05-02T20:34,0,69000
532,2435822,83,99000,0,98.0,336,2023-05-02T20:34,0,99000
533,1548618,84,152000,198000,96.0,3322,2023-05-02T20:34,-22800,129200
534,1417451,85,46550,49000,95.0,6624,2023-05-02T20:34,-4655,41895
535,3093902,86,169000,0,98.0,34,2023-05-02T20:34,0,169000
536,1140457,87,62300,82000,95.0,935,2023-05-02T20:34,-9345,52955
537,2589483,88,65000,0,97.0,1428,2023-05-02T20:34,0,65000
538,2921902,89,139000,0,97.0,32,2023-05-02T20:34,0,139000
539,2463768,90,49000,0,96.0,393,2023-05-02T20:34,0,49000
540,1214164,1,36000,0,96.0,25253,2023-05-02T20:34,0,36000
541,1822717,2,56050,59000,97.0,4482,2023-05-02T20:34,0,56050
542,2280117,3,35100,39000,97.0,6695,2023-05-02T20:34,0,35100
543,2356713,4,39000,0,97.0,1675,2023-05-02T20:34,0,39000
544,1836699,5,79000,0,96.0,281,2023-05-02T20:34,0,79000
545,1272626,6,36000,0,96.0,14338,2023-05-02T20:34,0,36000
546,2851288,7,25900,39000,94.0,64,2023-05-02T20:34,0,25900
547,2134140,8,39000,0,97.0,3841,2023-05-02T20:34,0,39000
548,1907733,9,29900,39000,96.0,4001,2023-05-02T20:34,-8970,20930
549,1214174,10,36000,0,97.0,15225,2023-05-02T20:34,0,36000
550,2356711,11,39000,0,97.0,1641,2023-05-02T20:34,0,39000
551,2149507,12,19900,29000,95.0,471,2023-05-02T20:34,0,19900
552,2287131,13,33300,37000,95.0,1860,2023-05-02T20:34,0,33300
553,1771137,14,29000,0,97.0,12821,2023-05-02T20:34,0,29000
554,2134158,15,39000,0,97.0,2686,2023-05-02T20:34,0,39000
555,1214173,16,36000,0,96.0,5707,2023-05-02T20:34,0,36000
556,1214109,17,36000,0,97.0,8306,2023-05-02T20:34,0,36000
557,1022013,18,79000,0,96.0,6369,2023-05-02T20:34,0,79000
558,1920929,19,39000,0,97.0,4205,2023-05-02T20:34,0,39000
559,1022014,20,79000,0,96.0,11544,2023-05-02T20:34,0,79000
560,2286829,21,33300,37000,96.0,5201,2023-05-02T20:34,-3996,29304
561,2356693,22,39000,0,97.0,1621,2023-05-02T20:34,-4680,34320
562,2879419,23,46900,55000,98.0,971,2023-05-02T20:34,0,46900
563,1214317,24,36000,0,97.0,11628,2023-05-02T20:34,0,36000
564,3218089,25,109000,0,0.0,0,2023-05-02T20:34,0,109000
565,2028240,26,39000,0,98.0,3424,2023-05-02T20:34,-3900,35100
566,3232889,27,35010,38900,93.0,19,2023-05-02T20:34,-3501,31509
567,1497550,28,29600,37000,95.0,5804,2023-05-02T20:34,-3552,26048
568,2123132,29,35100,39000,97.0,6553,2023-05-02T20:34,0,35100
569,2672186,30,20900,30000,96.0,671,2023-05-02T20:34,-2299,18601
570,2560668,31,58650,69000,97.0,1380,2023-05-02T20:34,0,58650
571,3099126,32,54000,0,99.0,46,2023-05-02T20:34,0,54000
572,1214171,33,36000,0,97.0,1755,2023-05-02T20:34,0,36000
573,2337876,34,25900,39000,95.0,189,2023-05-02T20:34,-7770,18130
574,1524720,35,36000,0,96.0,3486,2023-05-02T20:34,0,36000
575,3148335,36,800000,990000,0.0,0,2023-05-02T20:34,0,800000
576,2289281,37,29640,38000,96.0,944,2023-05-02T20:34,0,29640
577,1214169,38,36000,0,96.0,5455,2023-05-02T20:34,0,36000
578,2164773,39,69000,0,97.0,535,2023-05-02T20:34,0,69000
579,2879425,40,46900,55000,98.0,396,2023-05-02T20:34,0,46900
580,1907732,41,27900,39000,95.0,856,2023-05-02T20:34,-8370,19530
581,2107999,42,36000,0,97.0,2758,2023-05-02T20:34,0,36000
582,1771133,43,29000,0,97.0,5846,2023-05-02T20:34,0,29000
583,2381807,44,58650,69000,98.0,1219,2023-05-02T20:34,0,58650
584,3012243,45,29900,39900,98.0,127,2023-05-02T20:34,0,29900
585,2622323,46,25900,39000,96.0,84,2023-05-02T20:34,-7770,18130
586,1771132,47,29000,0,96.0,5445,2023-05-02T20:34,0,29000
587,2221221,48,35100,39000,96.0,1951,2023-05-02T20:34,0,35100
588,2329375,49,34710,39000,96.0,2173,2023-05-02T20:34,0,34710
589,2864918,50,49000,0,99.0,180,2023-05-02T20:34,0,49000
590,2280146,51,35100,39000,97.0,1001,2023-05-02T20:34,0,35100
591,1855444,52,33600,42000,97.0,3152,2023-05-02T20:34,-5040,28560
592,1214106,53,36000,0,96.0,9826,2023-05-02T20:34,0,36000
593,3039055,54,43000,0,96.0,96,2023-05-02T20:34,-5160,37840
594,2825398,55,25900,39000,93.0,41,2023-05-02T20:34,-7770,18130
595,1300684,56,41300,59000,93.0,286,2023-05-02T20:34,0,41300
596,1374020,57,35000,0,96.0,2929,2023-05-02T20:34,-5250,29750
597,1086824,58,29600,37000,95.0,18695,2023-05-02T20:34,-3552,26048
598,2867785,59,23900,39000,96.0,131,2023-05-02T20:34,0,23900
599,2883810,60,42900,65000,94.0,34,2023-05-02T20:34,0,42900
600,1906772,61,37800,42000,97.0,3178,2023-05-02T20:34,-5670,32130
601,2859190,62,33300,37000,96.0,552,2023-05-02T20:34,-3996,29304
602,2864774,63,49000,0,98.0,110,2023-05-02T20:34,0,49000
603,1836685,64,55300,79000,98.0,84,2023-05-02T20:34,0,55300
604,2687157,65,45000,0,97.0,1137,2023-05-02T20:34,-6750,38250
605,1755276,66,44100,49000,97.0,2455,2023-05-02T20:34,0,44100
606,2591291,67,39200,49000,97.0,1087,2023-05-02T20:34,-4704,34496
607,1452917,68,69000,0,96.0,2448,2023-05-02T20:34,0,69000
608,3235215,69,35010,38900,100.0,2,2023-05-02T20:34,-3501,31509
609,2157077,70,33600,42000,95.0,762,2023-05-02T20:34,-5040,28560
610,2053753,71,42000,0,98.0,4194,2023-05-02T20:34,-6300,35700
611,1214316,72,36000,0,97.0,2037,2023-05-02T20:34,0,36000
612,3125906,73,89000,0,97.0,36,2023-05-02T20:34,-10680,78320
613,2573131,74,33600,42000,97.0,769,2023-05-02T20:34,-5040,28560
614,2152223,75,36000,0,98.0,833,2023-05-02T20:34,0,36000
615,2134295,76,39000,0,97.0,446,2023-05-02T20:34,0,39000
616,2715553,77,68000,0,95.0,287,2023-05-02T20:34,0,68000
617,1433913,78,31500,42000,94.0,3629,2023-05-02T20:34,0,31500
618,2444602,79,54000,0,97.0,141,2023-05-02T20:34,0,54000
619,1063518,80,79000,0,96.0,975,2023-05-02T20:34,0,79000
620,2650964,81,46900,53000,98.0,227,2023-05-02T20:34,0,46900
621,2879431,82,46900,55000,98.0,88,2023-05-02T20:34,0,46900
622,2234533,83,31200,39000,97.0,533,2023-05-02T20:34,-3744,27456
623,3088383,84,32400,36000,95.0,52,2023-05-02T20:34,0,32400
624,3194983,85,97000,150000,0.0,0,2023-05-02T20:34,0,97000
625,1760824,86,49700,59000,97.0,339,2023-05-02T20:34,0,49700
626,3039061,87,39000,0,97.0,82,2023-05-02T20:34,-4680,34320
627,3087776,88,33900,39000,96.0,44,2023-05-02T20:34,-10170,23730
628,2699678,89,36000,0,98.0,291,2023-05-02T20:34,0,36000
629,1427407,90,39000,0,95.0,759,2023-05-02T20:34,0,39000
630,2512635,1,35400,59000,96.0,243,2023-05-02T20:34,-10620,24780
631,2457512,2,237300,339000,98.0,40,2023-05-02T20:34,0,237300
632,3008824,3,269000,0,100.0,5,2023-05-02T20:34,-48420,220580
633,2712722,4,46900,79000,96.0,35,2023-05-02T20:34,-14070,32830
634,2091668,5,339000,0,80.0,1,2023-05-02T20:34,0,339000
635,3106487,6,133200,148000,99.0,40,2023-05-02T20:34,0,133200
636,2714524,7,48300,69000,95.0,416,2023-05-02T20:34,0,48300
637,2070650,8,181300,259000,0.0,0,2023-05-02T20:34,0,181300
638,2371579,9,635000,1170000,100.0,5,2023-05-02T20:34,0,635000
639,3242733,10,224000,0,0.0,0,2023-05-02T20:34,0,224000
640,2392489,11,25490,31900,97.0,758,2023-05-02T20:34,0,25490
641,1875664,12,36900,0,96.0,586,2023-05-02T20:34,0,36900
642,2392491,13,25490,31900,96.0,421,2023-05-02T20:34,0,25490
643,2070403,14,181300,259000,0.0,0,2023-05-02T20:34,0,181300
644,3174225,15,179000,0,100.0,1,2023-05-02T20:34,-35800,143200
645,3149931,16,109000,0,100.0,9,2023-05-02T20:34,0,109000
646,2457511,17,339000,0,100.0,17,2023-05-02T20:34,0,339000
647,3008189,18,334000,478000,100.0,10,2023-05-02T20:34,-40080,293920
648,2612357,19,69000,139000,97.0,23,2023-05-02T20:34,0,69000
649,1962359,20,177000,0,98.0,70,2023-05-02T20:34,0,177000
650,3230044,21,160200,178000,0.0,0,2023-05-02T20:34,-8010,152190
651,3228639,22,159000,0,80.0,1,2023-05-02T20:34,0,159000
652,3130645,23,119000,0,100.0,3,2023-05-02T20:34,0,119000
653,2848613,24,86900,0,100.0,3,2023-05-02T20:34,0,86900
654,3190603,25,292000,418000,0.0,0,2023-05-02T20:34,-35040,256960
655,2605850,26,94000,0,97.0,190,2023-05-02T20:34,0,94000
656,1455772,27,94000,0,96.0,212,2023-05-02T20:34,0,94000
657,3202313,28,75200,94000,100.0,1,2023-05-02T20:34,0,75200
658,3102177,29,230000,0,100.0,1,2023-05-02T20:34,0,230000
659,3158231,30,278000,0,100.0,3,2023-05-02T20:34,-13900,264100
660,3120601,31,134100,149000,100.0,1,2023-05-02T20:34,-26820,107280
661,3233018,32,259000,0,0.0,0,2023-05-02T20:34,0,259000
662,3239514,33,255000,0,0.0,0,2023-05-02T20:34,-25500,229500
663,3041837,34,168000,0,100.0,5,2023-05-02T20:34,0,168000
664,3053225,35,159000,0,100.0,5,2023-05-02T20:34,0,159000
665,2489894,36,150100,158000,98.0,112,2023-05-02T20:34,0,150100
666,2070402,37,195300,279000,0.0,0,2023-05-02T20:34,0,195300
667,1779568,38,57600,64000,95.0,301,2023-05-02T20:34,0,57600
668,1875663,39,33190,36900,95.0,849,2023-05-02T20:34,0,33190
669,2664566,40,230000,0,100.0,4,2023-05-02T20:34,0,230000
670,3084761,41,119000,0,0.0,0,2023-05-02T20:34,0,119000
671,3102311,42,220000,0,100.0,3,2023-05-02T20:34,0,220000
672,3194638,43,219000,0,0.0,0,2023-05-02T20:34,0,219000
673,2388209,44,94000,0,97.0,165,2023-05-02T20:34,0,94000
674,3235369,45,98100,109000,0.0,0,2023-05-02T20:34,0,98100
675,1537416,46,57800,68000,90.0,135,2023-05-02T20:34,0,57800
676,2464116,47,201600,252000,93.0,6,2023-05-02T20:34,0,201600
677,3239520,48,195000,0,0.0,0,2023-05-02T20:34,-19500,175500
678,3120621,49,197100,219000,100.0,4,2023-05-02T20:34,-39420,157680
679,2457508,50,153300,219000,96.0,37,2023-05-02T20:34,0,153300
680,3122373,51,168000,0,100.0,3,2023-05-02T20:34,-30240,137760
681,3050173,52,166600,238000,100.0,7,2023-05-02T20:34,0,166600
682,3059119,53,161100,179000,92.0,29,2023-05-02T20:34,-28998,132102
683,3102249,54,165000,0,60.0,1,2023-05-02T20:34,0,165000
684,1840913,55,143200,179000,92.0,17,2023-05-02T20:34,0,143200
685,3124599,56,198000,0,0.0,0,2023-05-02T20:34,-29700,168300
686,3153601,57,198000,0,0.0,0,2023-05-02T20:34,-35640,162360
687,3173691,58,178000,0,100.0,1,2023-05-02T20:34,-17800,160200
688,2552064,59,198000,0,0.0,0,2023-05-02T20:34,0,198000
689,2612813,60,198000,0,0.0,0,2023-05-02T20:34,0,198000
690,3120280,61,198000,0,0.0,0,2023-05-02T20:34,0,198000
691,3053218,62,159000,0,90.0,4,2023-05-02T20:34,0,159000
692,3099416,63,44910,49900,90.0,16,2023-05-02T20:34,-8982,35928
693,3171882,64,141600,149000,100.0,5,2023-05-02T20:34,0,141600
694,3260105,65,179000,0,0.0,0,2023-05-02T20:34,0,179000
695,2517824,66,190000,0,0.0,0,2023-05-02T20:34,0,190000
696,1731794,67,187200,208000,98.0,37,2023-05-02T20:34,0,187200
697,3119153,68,160600,169000,0.0,0,2023-05-02T20:34,0,160600
698,3129903,69,176000,0,0.0,0,2023-05-02T20:34,0,176000
699,3122381,70,168000,0,94.0,7,2023-05-02T20:34,-30240,137760
700,3212524,71,173000,0,0.0,0,2023-05-02T20:34,0,173000
701,3135234,72,80100,89000,93.0,9,2023-05-02T20:34,0,80100
702,2415412,73,148000,0,100.0,8,2023-05-02T20:34,0,148000
703,2563691,74,159000,0,100.0,11,2023-05-02T20:34,0,159000
704,2608656,75,144400,152000,0.0,0,2023-05-02T20:34,0,144400
705,3193295,76,168000,0,0.0,0,2023-05-02T20:34,0,168000
706,3228128,77,159000,0,0.0,0,2023-05-02T20:34,0,159000
707,3225126,78,129000,0,100.0,2,2023-05-02T20:34,0,129000
708,1103286,79,94000,0,94.0,788,2023-05-02T20:34,0,94000
709,2044442,80,70000,0,96.0,173,2023-05-02T20:34,0,70000
710,2703252,81,167300,239000,96.0,12,2023-05-02T20:34,-25095,142205
711,3153592,82,168000,0,0.0,0,2023-05-02T20:34,-30240,137760
712,1871030,83,133600,167000,95.0,103,2023-05-02T20:34,0,133600
713,3174458,84,63200,79000,0.0,0,2023-05-02T20:34,0,63200
714,3103278,85,169000,0,0.0,0,2023-05-02T20:34,0,169000
715,3228630,86,159000,0,0.0,0,2023-05-02T20:34,0,159000
716,3228623,87,109000,0,100.0,1,2023-05-02T20:34,0,109000
717,3135499,88,150100,158000,0.0,0,2023-05-02T20:34,0,150100
718,3228642,89,159000,0,0.0,0,2023-05-02T20:34,0,159000
719,2585216,90,148000,0,88.0,14,2023-05-02T20:34,0,148000
720,3228597,1,89000,0,100.0,2,2023-05-02T20:34,0,89000
721,3210875,2,79200,99000,100.0,2,2023-05-02T20:34,-7920,71280
722,3051039,3,95200,119000,100.0,52,2023-05-02T20:34,-9520,85680
723,3144344,4,82000,0,97.0,7,2023-05-02T20:34,-12300,69700
724,3063419,5,49900,65000,98.0,18,2023-05-02T20:34,-14970,34930
725,1944554,6,36900,0,96.0,589,2023-05-02T20:34,0,36900
726,2864414,7,69300,99000,95.0,121,2023-05-02T20:34,-10395,58905
727,2716675,8,39900,59000,97.0,235,2023-05-02T20:34,0,39900
728,3058718,9,86400,96000,93.0,23,2023-05-02T20:34,-15552,70848
729,2942764,10,189000,0,96.0,18,2023-05-02T20:34,0,189000
730,3142895,11,99000,0,95.0,4,2023-05-02T20:34,0,99000
731,2759705,12,168000,0,100.0,8,2023-05-02T20:34,-30240,137760
732,2551401,13,37900,0,94.0,377,2023-05-02T20:34,0,37900
733,3144417,14,71100,79000,100.0,8,2023-05-02T20:34,0,71100
734,3031104,15,55200,69000,98.0,98,2023-05-02T20:34,-5520,49680
735,3112821,16,304000,320000,100.0,1,2023-05-02T20:34,-54720,249280
736,2063992,17,299000,0,86.0,3,2023-05-02T20:34,-53820,245180
737,2749471,18,291000,417000,0.0,0,2023-05-02T20:34,-20000,271000
738,2737869,19,146300,209000,93.0,6,2023-05-02T20:34,-21945,124355
739,2551407,20,37900,0,97.0,216,2023-05-02T20:34,0,37900
740,3222903,21,103550,109000,0.0,0,2023-05-02T20:34,-10355,93195
741,3103947,22,265050,279000,0.0,0,2023-05-02T20:34,0,265050
742,2198438,23,268200,298000,100.0,17,2023-05-02T20:34,-48276,219924
743,3092928,24,139000,0,100.0,3,2023-05-02T20:34,0,139000
744,3190572,25,264000,378000,100.0,1,2023-05-02T20:34,-31680,232320
745,3053289,26,275000,0,0.0,0,2023-05-02T20:34,0,275000
746,1931894,27,37900,0,95.0,553,2023-05-02T20:34,0,37900
747,3091520,28,299000,0,0.0,0,2023-05-02T20:34,-53820,245180
748,2978103,29,47900,0,98.0,24,2023-05-02T20:34,0,47900
749,2755918,30,119000,0,100.0,2,2023-05-02T20:34,0,119000
750,3109158,31,41650,49000,94.0,29,2023-05-02T20:34,-6248,35402
751,3081768,32,169000,0,100.0,9,2023-05-02T20:34,0,169000
752,3077493,33,238000,0,100.0,5,2023-05-02T20:34,-35700,202300
753,2589951,34,129500,185000,100.0,3,2023-05-02T20:34,-19425,110075
754,2812378,35,223000,0,0.0,0,2023-05-02T20:34,-40140,182860
755,2643318,36,138000,0,92.0,21,2023-05-02T20:34,-24840,113160
756,3117204,37,208600,298000,0.0,0,2023-05-02T20:34,-31290,177310
757,3026955,38,102000,0,88.0,16,2023-05-02T20:34,0,102000
758,1977234,39,33600,56000,91.0,85,2023-05-02T20:34,0,33600
759,3105350,40,52000,65000,97.0,17,2023-05-02T20:34,0,52000
760,2378594,41,88200,98000,95.0,132,2023-05-02T20:34,0,88200
761,1999505,42,71200,89000,94.0,45,2023-05-02T20:34,-10680,60520
762,3095636,43,199000,0,0.0,0,2023-05-02T20:34,-35820,163180
763,2417219,44,166600,196000,100.0,2,2023-05-02T20:34,-29988,136612
764,2925522,45,65000,0,96.0,150,2023-05-02T20:34,0,65000
765,2390967,46,39530,59000,93.0,229,2023-05-02T20:34,0,39530
766,3000422,47,59000,0,96.0,52,2023-05-02T20:34,0,59000
767,3135305,48,49500,55000,95.0,18,2023-05-02T20:34,0,49500
768,2121052,49,185000,0,100.0,2,2023-05-02T20:34,-33300,151700
769,2096991,50,199000,0,100.0,1,2023-05-02T20:34,-35820,163180
770,3075891,51,53910,59900,0.0,0,2023-05-02T20:34,-10782,43128
771,3051036,52,95200,119000,99.0,21,2023-05-02T20:34,-9520,85680
772,3113041,53,179000,0,0.0,0,2023-05-02T20:34,0,179000
773,3243283,54,178600,188000,0.0,0,2023-05-02T20:34,0,178600
774,1645760,55,43900,0,96.0,361,2023-05-02T20:34,0,43900
775,3108716,56,184500,205000,0.0,0,2023-05-02T20:34,-33210,151290
776,3206525,57,84550,89000,90.0,8,2023-05-02T20:34,0,84550
777,3165150,58,67200,84000,86.0,10,2023-05-02T20:34,0,67200
778,2631866,59,174000,290000,100.0,1,2023-05-02T20:34,0,174000
779,3171370,60,93100,98000,0.0,0,2023-05-02T20:34,0,93100
780,3228603,61,99000,0,92.0,5,2023-05-02T20:34,0,99000
781,3193136,62,149000,0,0.0,0,2023-05-02T20:34,0,149000
782,3053120,63,167300,239000,100.0,1,2023-05-02T20:34,-25095,142205
783,2117253,64,37290,43900,94.0,289,2023-05-02T20:34,0,37290
784,3073232,65,168000,0,100.0,1,2023-05-02T20:34,-30240,137760
785,3079664,66,168000,0,100.0,1,2023-05-02T20:34,0,168000
786,3185973,67,143100,159000,100.0,2,2023-05-02T20:34,-25758,117342
787,3171078,68,158000,0,100.0,2,2023-05-02T20:34,0,158000
788,2942722,69,149000,0,86.0,3,2023-05-02T20:34,0,149000
789,3159165,70,162000,0,0.0,0,2023-05-02T20:34,0,162000
790,1844574,71,156000,0,100.0,4,2023-05-02T20:34,-28080,127920
791,3222897,72,84550,89000,0.0,0,2023-05-02T20:34,-8455,76095
792,3120598,73,152100,169000,100.0,5,2023-05-02T20:34,-30420,121680
793,3228194,74,152100,169000,0.0,0,2023-05-02T20:34,-15210,136890
794,3083214,75,156000,0,0.0,0,2023-05-02T20:34,0,156000
795,2836351,76,49680,72000,96.0,503,2023-05-02T20:34,-7452,42228
796,2362483,77,84550,89000,97.0,77,2023-05-02T20:34,0,84550
797,2830788,78,139000,0,96.0,33,2023-05-02T20:34,0,139000
798,3193246,79,149000,0,0.0,0,2023-05-02T20:34,0,149000
799,3101516,80,129000,0,96.0,5,2023-05-02T20:34,0,129000
800,3216015,81,149000,0,0.0,0,2023-05-02T20:34,-29800,119200
801,3092938,82,129000,0,100.0,1,2023-05-02T20:34,0,129000
802,3200263,83,144000,0,0.0,0,2023-05-02T20:34,-21600,122400
803,2643770,84,138000,0,98.0,22,2023-05-02T20:34,-24840,113160
804,3062185,85,135850,143000,100.0,7,2023-05-02T20:34,0,135850
805,3200164,86,125100,139000,100.0,2,2023-05-02T20:34,-22518,102582
806,2643339,87,138000,0,95.0,22,2023-05-02T20:34,-24840,113160
807,3099005,88,127000,0,0.0,0,2023-05-02T20:34,0,127000
808,2776678,89,98000,0,92.0,28,2023-05-02T20:34,0,98000
809,2384620,90,93000,0,97.0,14,2023-05-02T20:34,0,93000
810,991339,1,19900,0,97.0,54271,2023-05-02T20:34,0,19900
811,1477845,2,15400,22000,96.0,10081,2023-05-02T20:34,-4620,10780
812,1986031,3,27900,0,97.0,11072,2023-05-02T20:34,0,27900
813,998051,4,15200,24000,97.0,166071,2023-05-02T20:34,0,15200
814,991340,5,17890,19900,97.0,31305,2023-05-02T20:34,0,17890
815,763821,6,16200,22000,96.0,31751,2023-05-02T20:34,0,16200
816,1094835,7,15900,0,97.0,6419,2023-05-02T20:34,0,15900
817,1342874,8,16900,33000,97.0,13367,2023-05-02T20:34,0,16900
818,479245,9,15400,22000,93.0,5523,2023-05-02T20:34,-4620,10780
819,1996702,10,27900,0,97.0,2045,2023-05-02T20:34,0,27900
820,1094748,11,19900,0,97.0,19459,2023-05-02T20:34,0,19900
821,792919,12,16900,0,96.0,18089,2023-05-02T20:34,0,16900
822,991570,13,13300,20000,97.0,19339,2023-05-02T20:34,0,13300
823,991341,14,17890,19900,96.0,10368,2023-05-02T20:34,0,17890
824,2845854,15,13800,18900,97.0,423,2023-05-02T20:34,0,13800
825,1477846,16,15400,22000,96.0,2733,2023-05-02T20:34,-4620,10780
826,1443937,17,12900,24000,97.0,8467,2023-05-02T20:34,0,12900
827,1986029,18,27900,0,97.0,4062,2023-05-02T20:34,0,27900
828,1996705,19,27900,0,98.0,2829,2023-05-02T20:34,0,27900
829,1092994,20,22900,0,96.0,2700,2023-05-02T20:34,0,22900
830,792920,21,16900,0,96.0,9768,2023-05-02T20:34,0,16900
831,734085,22,13200,19800,96.0,65519,2023-05-02T20:34,0,13200
832,2832613,23,11900,33000,97.0,931,2023-05-02T20:34,0,11900
833,1547562,24,15400,22000,95.0,1401,2023-05-02T20:34,-4620,10780
834,1346009,25,9900,12000,97.0,6828,2023-05-02T20:34,0,9900
835,746158,26,20590,22900,96.0,20655,2023-05-02T20:34,0,20590
836,2821598,27,19390,22900,97.0,184,2023-05-02T20:34,0,19390
837,1986030,28,27900,0,97.0,1752,2023-05-02T20:34,0,27900
838,1729576,29,9900,13900,97.0,16630,2023-05-02T20:34,0,9900
839,1094837,30,15900,0,96.0,1808,2023-05-02T20:34,0,15900
840,746154,31,17900,0,96.0,5267,2023-05-02T20:34,0,17900
841,3009680,32,12590,14900,98.0,212,2023-05-02T20:34,0,12590
842,3033249,33,15000,0,95.0,365,2023-05-02T20:34,0,15000
843,2960555,34,17100,19000,94.0,150,2023-05-02T20:34,0,17100
844,792921,35,15190,16900,95.0,7856,2023-05-02T20:34,0,15190
845,1974077,36,46900,0,97.0,917,2023-05-02T20:34,0,46900
846,3181894,37,22000,0,100.0,9,2023-05-02T20:34,-6600,15400
847,1996704,38,25090,27900,97.0,744,2023-05-02T20:34,0,25090
848,2477852,39,17890,19900,98.0,715,2023-05-02T20:34,0,17890
849,2829586,40,14900,18900,97.0,54,2023-05-02T20:34,0,14900
850,1821485,41,30000,0,96.0,1321,2023-05-02T20:34,0,30000
851,2295818,42,19900,22000,95.0,197,2023-05-02T20:34,-5970,13930
852,2011850,43,21490,23900,98.0,881,2023-05-02T20:34,0,21490
853,2477854,44,17890,19900,98.0,1515,2023-05-02T20:34,0,17890
854,2346958,45,18200,24000,97.0,577,2023-05-02T20:34,0,18200
855,1348077,46,10900,16500,97.0,1923,2023-05-02T20:34,0,10900
856,1094749,47,19900,0,96.0,5022,2023-05-02T20:34,0,19900
857,2293399,48,19900,22000,95.0,646,2023-05-02T20:34,-5970,13930
858,2347097,49,14900,24000,97.0,1694,2023-05-02T20:34,0,14900
859,2011852,50,21490,23900,97.0,1346,2023-05-02T20:34,0,21490
860,2956310,51,96000,184000,0.0,0,2023-05-02T20:34,0,96000
861,2821589,52,21900,0,96.0,51,2023-05-02T20:34,0,21900
862,746159,53,19390,22900,95.0,28795,2023-05-02T20:34,0,19390
863,1358721,54,14900,22000,96.0,1195,2023-05-02T20:34,0,14900
864,3096660,55,13800,18900,97.0,21,2023-05-02T20:34,0,13800
865,1062062,56,16890,19900,96.0,1471,2023-05-02T20:34,0,16890
866,1094836,57,15900,0,97.0,1351,2023-05-02T20:34,0,15900
867,1392777,58,11890,19900,96.0,401,2023-05-02T20:34,0,11890
868,1475055,59,16900,22000,96.0,1202,2023-05-02T20:34,0,16900
869,472686,60,9900,14800,94.0,817,2023-05-02T20:34,0,9900
870,2738095,61,19900,0,95.0,124,2023-05-02T20:34,0,19900
871,2003714,62,15200,22000,97.0,445,2023-05-02T20:34,0,15200
872,2929635,63,16800,27000,97.0,608,2023-05-02T20:34,0,16800
873,1062063,64,9490,15900,97.0,2272,2023-05-02T20:34,0,9490
874,2973095,65,20000,25000,98.0,36,2023-05-02T20:34,0,20000
875,1260383,66,19900,0,95.0,1482,2023-05-02T20:34,0,19900
876,746155,67,17900,0,95.0,1290,2023-05-02T20:34,0,17900
877,1094750,68,19900,0,97.0,3621,2023-05-02T20:34,0,19900
878,1260384,69,19900,0,95.0,1818,2023-05-02T20:34,0,19900
879,2821588,70,21900,0,96.0,71,2023-05-02T20:34,0,21900
880,3182850,71,37000,59000,100.0,1,2023-05-02T20:34,0,37000
881,1094833,72,19390,22900,95.0,2099,2023-05-02T20:34,0,19390
882,1286366,73,12500,24000,97.0,9905,2023-05-02T20:34,0,12500
883,2753271,74,88200,98000,85.0,4,2023-05-02T20:34,-15876,72324
884,3220488,75,18000,0,94.0,11,2023-05-02T20:34,0,18000
885,2812523,76,20000,25000,97.0,119,2023-05-02T20:34,-6000,14000
886,3220486,77,18000,0,87.0,11,2023-05-02T20:34,0,18000
887,2652523,78,9500,12000,98.0,133,2023-05-02T20:34,0,9500
888,1821487,79,30000,0,97.0,691,2023-05-02T20:34,0,30000
889,2011851,80,21490,23900,98.0,693,2023-05-02T20:34,0,21490
890,752821,81,9900,0,95.0,23947,2023-05-02T20:34,0,9900
891,2821599,82,22900,0,98.0,133,2023-05-02T20:34,0,22900
892,2477851,83,17890,19900,97.0,658,2023-05-02T20:34,0,17890
893,2738096,84,17890,19900,98.0,104,2023-05-02T20:34,0,17890
894,2738094,85,19900,0,96.0,188,2023-05-02T20:34,0,19900
895,2969449,86,43200,48000,100.0,1,2023-05-02T20:34,-7776,35424
896,1821480,87,30000,0,97.0,247,2023-05-02T20:34,0,30000
897,1274401,88,17900,22800,96.0,321,2023-05-02T20:34,0,17900
898,2973952,89,28800,48000,93.0,23,2023-05-02T20:34,-4320,24480
899,2973894,90,22000,27500,98.0,38,2023-05-02T20:34,0,22000
