,item_id,rank,price,del_price,rating,rating_count,time,coupon,real_price
0,2272830,1,35910,39900,97.0,19345,2023-04-08T21:02,-3591,32319
1,1848166,2,44100,49000,97.0,41089,2023-04-08T21:02,0,44100
2,345889,3,29900,47900,95.0,9840,2023-04-08T21:02,0,29900
3,2086653,4,16900,0,97.0,39582,2023-04-08T21:02,0,16900
4,1882578,5,35910,39900,97.0,9568,2023-04-08T21:02,0,35910
5,3201520,6,129000,0,0.0,0,2023-04-08T21:02,0,129000
6,2646350,7,59800,94000,95.0,4223,2023-04-08T21:02,-11960,47840
7,1763157,8,49400,52000,95.0,2648,2023-04-08T21:02,0,49400
8,3206068,9,52900,74000,98.0,247,2023-04-08T21:02,0,52900
9,2377269,10,38250,45000,97.0,3928,2023-04-08T21:02,0,38250
10,2442409,11,39000,78000,96.0,8947,2023-04-08T21:02,-5850,33150
11,2479911,12,49400,76000,97.0,4250,2023-04-08T21:02,0,49400
12,3187851,13,49900,110000,99.0,104,2023-04-08T21:02,0,49900
13,1921901,14,36900,70500,96.0,7599,2023-04-08T21:02,0,36900
14,2015684,15,39000,0,95.0,6396,2023-04-08T21:02,0,39000
15,2149254,16,37800,0,97.0,33383,2023-04-08T21:02,-5670,32130
16,3176385,17,35100,39000,100.0,1,2023-04-08T21:02,0,35100
17,2392759,18,39900,49600,95.0,4036,2023-04-08T21:02,-3990,35910
18,2996536,19,39900,59000,96.0,530,2023-04-08T21:02,-7980,31920
19,3010415,20,219000,0,98.0,21,2023-04-08T21:02,0,219000
20,3182754,21,25600,32000,0.0,0,2023-04-08T21:02,-5120,20480
21,3105468,22,71100,79000,98.0,47,2023-04-08T21:02,0,71100
22,2313388,23,76500,85000,96.0,2135,2023-04-08T21:02,0,76500
23,2034137,24,31800,0,97.0,17179,2023-04-08T21:02,-4770,27030
24,1884943,25,29900,39000,96.0,18911,2023-04-08T21:02,0,29900
25,2314616,26,39000,43000,97.0,8291,2023-04-08T21:02,0,39000
26,2409397,27,31500,45000,97.0,2763,2023-04-08T21:02,-3150,28350
27,1706633,28,199000,0,97.0,2396,2023-04-08T21:02,0,199000
28,3134405,29,44910,49900,98.0,55,2023-04-08T21:02,0,44910
29,1817394,30,59900,150000,93.0,7221,2023-04-08T21:02,0,59900
30,1420730,31,35000,58000,95.0,36001,2023-04-08T21:02,-7000,28000
31,2122566,32,33800,0,97.0,16092,2023-04-08T21:02,-5070,28730
32,2285512,33,49400,52000,96.0,1726,2023-04-08T21:02,0,49400
33,3092690,34,129000,0,98.0,32,2023-04-08T21:02,0,129000
34,3201519,35,139000,0,0.0,0,2023-04-08T21:02,0,139000
35,1582356,36,49200,82000,96.0,16176,2023-04-08T21:02,0,49200
36,3183158,37,25600,32000,0.0,0,2023-04-08T21:02,-5120,20480
37,2858494,38,119000,0,98.0,370,2023-04-08T21:02,0,119000
38,3143791,39,39900,68000,98.0,72,2023-04-08T21:02,-7980,31920
39,2364807,40,219000,0,96.0,708,2023-04-08T21:02,0,219000
40,2375962,41,59000,62000,98.0,5444,2023-04-08T21:02,-5900,53100
41,3034895,42,101150,119000,98.0,372,2023-04-08T21:02,0,101150
42,3180166,43,31200,39000,98.0,44,2023-04-08T21:02,0,31200
43,2693978,44,129000,149000,97.0,211,2023-04-08T21:02,0,129000
44,1005680,45,17500,35000,95.0,9145,2023-04-08T21:02,0,17500
45,3183108,46,25600,32000,0.0,0,2023-04-08T21:02,-5120,20480
46,2043036,47,59900,97900,95.0,7479,2023-04-08T21:02,-11980,47920
47,1503352,48,39900,42000,97.0,8432,2023-04-08T21:02,0,39900
48,2877493,49,59800,92000,95.0,1444,2023-04-08T21:02,0,59800
49,3187918,50,35000,58000,0.0,0,2023-04-08T21:02,0,35000
50,3176119,51,51750,69000,0.0,0,2023-04-08T21:02,0,51750
51,1939099,52,34300,49000,97.0,11773,2023-04-08T21:02,0,34300
52,3201518,53,139000,0,0.0,0,2023-04-08T21:02,0,139000
53,1899755,54,29900,39000,96.0,4962,2023-04-08T21:02,0,29900
54,3186870,55,35000,58000,0.0,0,2023-04-08T21:02,-7000,28000
55,3033496,56,129000,149000,97.0,94,2023-04-08T21:02,0,129000
56,1943792,57,34400,43000,96.0,5383,2023-04-08T21:02,0,34400
57,2326935,58,63200,79000,96.0,12967,2023-04-08T21:02,-6320,56880
58,1944612,59,35800,59700,97.0,2883,2023-04-08T21:02,0,35800
59,3092691,60,129000,0,98.0,30,2023-04-08T21:02,0,129000
60,2396645,61,39900,59000,96.0,23497,2023-04-08T21:02,-7980,31920
61,2122660,62,785000,1270000,100.0,5,2023-04-08T21:02,0,785000
62,3043301,63,189000,0,95.0,24,2023-04-08T21:02,0,189000
63,3182712,64,23200,29000,0.0,0,2023-04-08T21:02,-4640,18560
64,2368712,65,38700,43000,97.0,5588,2023-04-08T21:02,-1935,36765
65,996177,66,15900,0,95.0,77584,2023-04-08T21:02,0,15900
66,2716375,67,110600,158000,95.0,16,2023-04-08T21:02,-11060,99540
67,1779737,68,20800,32000,96.0,7243,2023-04-08T21:02,0,20800
68,2171559,69,39900,54000,96.0,4197,2023-04-08T21:02,-7980,31920
69,1336398,70,40200,67000,96.0,19068,2023-04-08T21:02,-4020,36180
70,3050518,71,49600,62000,98.0,345,2023-04-08T21:02,-9920,39680
71,3052036,72,59400,66000,96.0,162,2023-04-08T21:02,-11880,47520
72,2453556,73,39900,42000,97.0,6281,2023-04-08T21:02,0,39900
73,1828538,74,39900,69900,95.0,2948,2023-04-08T21:02,0,39900
74,3182657,75,23200,29000,0.0,0,2023-04-08T21:02,-4640,18560
75,2376229,76,36000,0,97.0,3840,2023-04-08T21:02,0,36000
76,3042516,77,42000,65000,96.0,81,2023-04-08T21:02,-8400,33600
77,3182326,78,29900,43000,0.0,0,2023-04-08T21:02,0,29900
78,2575342,79,39900,59000,96.0,845,2023-04-08T21:02,-7980,31920
79,2065703,80,59000,62000,98.0,5553,2023-04-08T21:02,-5900,53100
80,3186944,81,35000,58000,0.0,0,2023-04-08T21:02,-7000,28000
81,3039146,82,219000,0,100.0,8,2023-04-08T21:02,0,219000
82,2409894,83,39000,78000,97.0,5161,2023-04-08T21:02,-5850,33150
83,2398381,84,31500,45000,96.0,3588,2023-04-08T21:02,-3150,28350
84,2851724,85,49800,62000,94.0,55,2023-04-08T21:02,-2490,47310
85,3183162,86,25600,32000,0.0,0,2023-04-08T21:02,-5120,20480
86,2038497,87,36000,45000,95.0,16336,2023-04-08T21:02,-3600,32400
87,3182757,88,25600,32000,0.0,0,2023-04-08T21:02,-5120,20480
88,3180162,89,31200,39000,100.0,14,2023-04-08T21:02,0,31200
89,994588,90,39900,53000,93.0,6052,2023-04-08T21:02,-3990,35910
90,3132559,1,179100,199000,100.0,5,2023-04-08T21:02,0,179100
91,3201526,2,239000,0,100.0,2,2023-04-08T21:02,0,239000
92,1558197,3,73690,81900,97.0,32385,2023-04-08T21:02,0,73690
93,1778404,4,42000,45000,96.0,67287,2023-04-08T21:02,0,42000
94,1571879,5,79900,112900,96.0,7070,2023-04-08T21:02,-15980,63920
95,2723218,6,47900,109000,97.0,2280,2023-04-08T21:02,0,47900
96,3012082,7,59900,79000,96.0,994,2023-04-08T21:02,-11980,47920
97,1530516,8,69900,79000,96.0,2344,2023-04-08T21:02,-13980,55920
98,3201522,9,239000,0,0.0,0,2023-04-08T21:02,0,239000
99,2061715,10,83900,105000,97.0,2714,2023-04-08T21:02,0,83900
100,1571878,11,79900,112900,96.0,4681,2023-04-08T21:02,-15980,63920
101,2020732,12,70900,89000,95.0,824,2023-04-08T21:02,0,70900
102,1856181,13,35910,39900,97.0,7475,2023-04-08T21:02,-3591,32319
103,841230,14,154000,172000,96.0,7282,2023-04-08T21:02,0,154000
104,1790383,15,59000,86000,95.0,5504,2023-04-08T21:02,-5900,53100
105,2343198,16,119000,129000,97.0,5023,2023-04-08T21:02,0,119000
106,1530517,17,69900,79000,96.0,2093,2023-04-08T21:02,-13980,55920
107,1283757,18,75490,83900,96.0,26665,2023-04-08T21:02,0,75490
108,3033224,19,59900,74000,97.0,636,2023-04-08T21:02,-11980,47920
109,1778408,20,42000,45000,95.0,11712,2023-04-08T21:02,0,42000
110,2471405,21,89000,138000,97.0,2079,2023-04-08T21:02,-8900,80100
111,3030665,22,139200,174000,96.0,236,2023-04-08T21:02,0,139200
112,1576700,23,89000,129000,97.0,16781,2023-04-08T21:02,0,89000
113,1618312,24,83900,0,97.0,7131,2023-04-08T21:02,-8390,75510
114,2064545,25,59800,94000,97.0,11135,2023-04-08T21:02,-2990,56810
115,1776552,26,59000,69000,94.0,6128,2023-04-08T21:02,-5900,53100
116,3010527,27,237150,279000,98.0,215,2023-04-08T21:02,0,237150
117,2732486,28,109000,179000,98.0,701,2023-04-08T21:02,0,109000
118,1969617,29,162000,0,96.0,2652,2023-04-08T21:02,0,162000
119,2322836,30,139200,174000,97.0,1019,2023-04-08T21:02,0,139200
120,1195307,31,82400,103000,96.0,12619,2023-04-08T21:02,-8240,74160
121,2995690,32,1887000,3220000,0.0,0,2023-04-08T21:02,0,1887000
122,3025211,33,34500,69000,97.0,188,2023-04-08T21:02,0,34500
123,1737051,34,62300,89000,96.0,5101,2023-04-08T21:02,0,62300
124,3078900,35,148000,0,98.0,199,2023-04-08T21:02,-14800,133200
125,2572705,36,168300,198000,97.0,60,2023-04-08T21:02,-25245,143055
126,3096451,37,124200,138000,98.0,32,2023-04-08T21:02,0,124200
127,2288426,38,69000,109000,94.0,819,2023-04-08T21:02,-6900,62100
128,2329532,39,119200,149000,97.0,3970,2023-04-08T21:02,0,119200
129,2288704,40,121000,132000,97.0,3410,2023-04-08T21:02,0,121000
130,2555380,41,2010000,3950000,0.0,0,2023-04-08T21:02,-30000,1980000
131,2375909,42,80890,89900,98.0,1549,2023-04-08T21:02,0,80890
132,2343199,43,119000,129000,98.0,1815,2023-04-08T21:02,0,119000
133,1760177,44,139200,174000,97.0,326,2023-04-08T21:02,0,139200
134,2284220,45,79900,112900,96.0,1695,2023-04-08T21:02,-15980,63920
135,1108007,46,79900,0,95.0,47892,2023-04-08T21:02,0,79900
136,2074862,47,107900,218000,95.0,330,2023-04-08T21:02,0,107900
137,2699160,48,179000,0,96.0,88,2023-04-08T21:02,0,179000
138,3182503,49,59000,89000,0.0,0,2023-04-08T21:02,-11800,47200
139,3125671,50,148000,0,97.0,18,2023-04-08T21:02,0,148000
140,2752332,51,94700,105300,95.0,2573,2023-04-08T21:02,0,94700
141,3092698,52,179000,0,98.0,40,2023-04-08T21:02,0,179000
142,2668986,53,35910,39900,96.0,3511,2023-04-08T21:02,-3591,32319
143,1833230,54,108800,136000,97.0,5422,2023-04-08T21:02,0,108800
144,2710931,55,55300,79000,96.0,409,2023-04-08T21:02,0,55300
145,1291017,56,67900,96000,95.0,13005,2023-04-08T21:02,0,67900
146,965917,57,71890,79900,95.0,13071,2023-04-08T21:02,0,71890
147,2723216,58,69900,109000,97.0,1101,2023-04-08T21:02,0,69900
148,3075235,59,175000,219000,0.0,0,2023-04-08T21:02,0,175000
149,1817381,60,47900,69000,96.0,1075,2023-04-08T21:02,0,47900
150,2159724,61,29900,32000,95.0,2285,2023-04-08T21:02,0,29900
151,3061239,62,206000,229000,97.0,15,2023-04-08T21:02,-41200,164800
152,2788216,63,146000,159000,98.0,98,2023-04-08T21:02,0,146000
153,3037473,64,69900,85900,97.0,218,2023-04-08T21:02,0,69900
154,1337094,65,69900,0,95.0,5401,2023-04-08T21:02,0,69900
155,3037472,66,49900,85900,98.0,126,2023-04-08T21:02,0,49900
156,1751722,67,53910,59900,97.0,3392,2023-04-08T21:02,-5391,48519
157,1795629,68,112500,125000,97.0,1458,2023-04-08T21:02,-11250,101250
158,2293391,69,72000,124000,96.0,1837,2023-04-08T21:02,-3600,68400
159,2753690,70,281300,660000,80.0,1,2023-04-08T21:02,0,281300
160,1116010,71,154000,172000,96.0,2238,2023-04-08T21:02,0,154000
161,3039655,72,69700,83000,95.0,555,2023-04-08T21:02,-10455,59245
162,1139192,73,71100,94900,97.0,14412,2023-04-08T21:02,-7110,63990
163,1337096,74,69900,0,97.0,2953,2023-04-08T21:02,0,69900
164,3148956,75,279000,0,0.0,0,2023-04-08T21:02,0,279000
165,3036129,76,59800,94000,95.0,1711,2023-04-08T21:02,-2990,56810
166,3029811,77,63200,79000,97.0,255,2023-04-08T21:02,0,63200
167,3166979,78,99900,0,0.0,0,2023-04-08T21:02,-29970,69930
168,3096458,79,133200,148000,99.0,49,2023-04-08T21:02,0,133200
169,3114508,80,159000,177000,96.0,18,2023-04-08T21:02,-31800,127200
170,3033919,81,558000,0,98.0,42,2023-04-08T21:02,-55800,502200
171,709188,82,156700,209000,96.0,4198,2023-04-08T21:02,0,156700
172,2110493,83,389000,0,96.0,637,2023-04-08T21:02,0,389000
173,1776365,84,71200,89000,96.0,4620,2023-04-08T21:02,-7120,64080
174,1633664,85,87200,109000,97.0,4199,2023-04-08T21:02,0,87200
175,3092696,86,179000,0,97.0,9,2023-04-08T21:02,0,179000
176,1850100,87,79090,87900,97.0,1979,2023-04-08T21:02,0,79090
177,864404,88,108000,135000,95.0,13383,2023-04-08T21:02,0,108000
178,918039,89,69500,139000,93.0,11187,2023-04-08T21:02,0,69500
179,2712632,90,107000,0,97.0,1339,2023-04-08T21:02,0,107000
180,2112059,1,36400,0,97.0,43003,2023-04-08T21:02,0,36400
181,750908,2,34900,54000,96.0,84111,2023-04-08T21:02,0,34900
182,1149329,3,39900,0,96.0,86079,2023-04-08T21:02,0,39900
183,1551840,4,39000,0,97.0,83744,2023-04-08T21:02,0,39000
184,2351467,5,29000,54000,96.0,6203,2023-04-08T21:02,0,29000
185,1924274,6,49900,66000,95.0,22521,2023-04-08T21:02,-9980,39920
186,1168906,7,41900,0,97.0,71111,2023-04-08T21:02,0,41900
187,2112061,8,36400,52000,97.0,14710,2023-04-08T21:02,0,36400
188,2092852,9,42000,52800,96.0,11149,2023-04-08T21:02,-2100,39900
189,2028326,10,49900,0,97.0,6197,2023-04-08T21:02,0,49900
190,1149328,11,39900,0,96.0,94520,2023-04-08T21:02,0,39900
191,1370101,12,39000,89000,96.0,22951,2023-04-08T21:02,-1950,37050
192,3183544,13,205200,228000,0.0,0,2023-04-08T21:02,0,205200
193,2060719,14,55200,69000,96.0,5164,2023-04-08T21:02,-2760,52440
194,1552753,15,62400,78000,97.0,28187,2023-04-08T21:02,-6240,56160
195,3201506,16,169000,0,0.0,0,2023-04-08T21:02,0,169000
196,3141395,17,49900,73900,96.0,174,2023-04-08T21:02,-9980,39920
197,1568057,18,49600,62000,96.0,22360,2023-04-08T21:02,0,49600
198,2028327,19,49900,0,97.0,9093,2023-04-08T21:02,0,49900
199,858911,20,39000,49000,95.0,66952,2023-04-08T21:02,0,39000
200,1551839,21,39000,0,97.0,23554,2023-04-08T21:02,0,39000
201,2060759,22,59800,74800,97.0,7228,2023-04-08T21:02,-2990,56810
202,1926048,23,32000,0,97.0,14713,2023-04-08T21:02,0,32000
203,2060717,24,55200,69000,95.0,3819,2023-04-08T21:02,-2760,52440
204,2702931,25,90000,300000,98.0,14,2023-04-08T21:02,0,90000
205,2723714,26,52000,58000,96.0,1553,2023-04-08T21:02,0,52000
206,3201503,27,109000,0,0.0,0,2023-04-08T21:02,0,109000
207,2789091,28,79200,99000,96.0,786,2023-04-08T21:02,-3960,75240
208,2827702,29,69800,87500,96.0,448,2023-04-08T21:02,-3490,66310
209,2060720,30,55200,69000,95.0,2568,2023-04-08T21:02,-2760,52440
210,1736085,31,39900,59800,96.0,36789,2023-04-08T21:02,0,39900
211,883004,32,69900,89000,94.0,9473,2023-04-08T21:02,0,69900
212,1568032,33,49600,62000,96.0,6157,2023-04-08T21:02,0,49600
213,2789111,34,79200,99000,97.0,845,2023-04-08T21:02,-3960,75240
214,2150457,35,119250,159000,97.0,3836,2023-04-08T21:02,0,119250
215,1222184,36,41900,0,97.0,48395,2023-04-08T21:02,0,41900
216,3183542,37,205200,228000,0.0,0,2023-04-08T21:02,0,205200
217,2310312,38,109650,129000,98.0,641,2023-04-08T21:02,-21930,87720
218,3043508,39,71200,89000,97.0,113,2023-04-08T21:02,-3560,67640
219,2877984,40,59000,0,97.0,422,2023-04-08T21:02,0,59000
220,2184087,41,49000,89000,96.0,4095,2023-04-08T21:02,-2450,46550
221,2749153,42,66600,74000,97.0,568,2023-04-08T21:02,0,66600
222,1573215,43,133200,148000,98.0,9298,2023-04-08T21:02,0,133200
223,2713337,44,90000,300000,96.0,19,2023-04-08T21:02,0,90000
224,1826978,45,79000,0,96.0,7037,2023-04-08T21:02,0,79000
225,2060743,46,33000,55000,95.0,3557,2023-04-08T21:02,0,33000
226,1759490,47,84150,99000,96.0,7313,2023-04-08T21:02,-16830,67320
227,1595607,48,57900,89000,97.0,5723,2023-04-08T21:02,0,57900
228,2131950,49,39000,49000,96.0,3896,2023-04-08T21:02,0,39000
229,3031690,50,128000,0,93.0,170,2023-04-08T21:02,-6400,121600
230,2706287,51,39800,54000,95.0,3773,2023-04-08T21:02,-3980,35820
231,1477272,52,44200,68000,96.0,17860,2023-04-08T21:02,0,44200
232,2092849,53,42000,52800,96.0,9774,2023-04-08T21:02,-2100,39900
233,3091296,54,129000,0,94.0,64,2023-04-08T21:02,0,129000
234,1885631,55,39000,49000,96.0,23741,2023-04-08T21:02,0,39000
235,2713345,56,172000,430000,96.0,38,2023-04-08T21:02,0,172000
236,2751428,57,120000,300000,100.0,1,2023-04-08T21:02,0,120000
237,890521,58,39800,63000,94.0,11125,2023-04-08T21:02,0,39800
238,1985223,59,39000,89000,96.0,1661,2023-04-08T21:02,-1950,37050
239,3049798,60,96800,121000,96.0,72,2023-04-08T21:02,0,96800
240,890338,61,39000,49000,95.0,47732,2023-04-08T21:02,0,39000
241,2358429,62,143100,159000,98.0,2637,2023-04-08T21:02,0,143100
242,1666442,63,49900,0,97.0,10932,2023-04-08T21:02,0,49900
243,2562527,64,29400,42000,97.0,4028,2023-04-08T21:02,0,29400
244,2032901,65,31890,39900,97.0,6834,2023-04-08T21:02,0,31890
245,2495075,66,49800,72000,95.0,12018,2023-04-08T21:02,-9960,39840
246,2107115,67,121500,135000,98.0,11697,2023-04-08T21:02,0,121500
247,1168922,68,35090,43900,96.0,18202,2023-04-08T21:02,0,35090
248,2817384,69,59000,99000,97.0,146,2023-04-08T21:02,-5900,53100
249,3188768,70,156000,0,100.0,12,2023-04-08T21:02,0,156000
250,3087902,71,134000,149000,98.0,36,2023-04-08T21:02,-6700,127300
251,1246215,72,52000,65000,96.0,6312,2023-04-08T21:02,0,52000
252,1627892,73,43900,0,97.0,10973,2023-04-08T21:02,0,43900
253,3070909,74,139000,0,100.0,5,2023-04-08T21:02,0,139000
254,2049103,75,62400,78000,97.0,7180,2023-04-08T21:02,-6240,56160
255,3154647,76,49800,63000,100.0,12,2023-04-08T21:02,-4980,44820
256,2711142,77,39800,54000,96.0,991,2023-04-08T21:02,-3980,35820
257,2310310,78,109650,129000,98.0,935,2023-04-08T21:02,-21930,87720
258,1212776,79,28690,31900,96.0,23397,2023-04-08T21:02,0,28690
259,3200524,80,49900,66000,97.0,8,2023-04-08T21:02,-9980,39920
260,3034871,81,100800,126000,98.0,164,2023-04-08T21:02,0,100800
261,1350363,82,53600,68000,97.0,1180,2023-04-08T21:02,0,53600
262,890519,83,39800,63000,95.0,6770,2023-04-08T21:02,0,39800
263,3094527,84,126000,140000,97.0,14,2023-04-08T21:02,0,126000
264,1759491,85,84150,99000,96.0,2221,2023-04-08T21:02,-16830,67320
265,3201504,86,169000,0,0.0,0,2023-04-08T21:02,0,169000
266,1436218,87,39900,68000,95.0,19217,2023-04-08T21:02,-7980,31920
267,2351444,88,29000,54000,95.0,4391,2023-04-08T21:02,0,29000
268,1926034,89,32000,0,97.0,3099,2023-04-08T21:02,0,32000
269,2493711,90,66400,83000,96.0,804,2023-04-08T21:02,-13280,53120
270,3061969,1,80100,89000,96.0,25,2023-04-08T21:02,-4005,76095
271,1789507,2,69900,79000,98.0,25879,2023-04-08T21:02,-6990,62910
272,1034480,3,135000,150000,97.0,18078,2023-04-08T21:02,0,135000
273,2633441,4,1516000,0,0.0,0,2023-04-08T21:02,0,1516000
274,1969507,5,88000,0,98.0,5408,2023-04-08T21:02,0,88000
275,3061988,6,80100,89000,98.0,13,2023-04-08T21:02,-4005,76095
276,2770508,7,138000,0,97.0,337,2023-04-08T21:02,0,138000
277,2930267,8,107100,119000,97.0,83,2023-04-08T21:02,-5355,101745
278,2235274,9,145000,0,98.0,698,2023-04-08T21:02,0,145000
279,1323612,10,238000,0,97.0,3826,2023-04-08T21:02,-11900,226100
280,2705112,11,2696000,0,0.0,0,2023-04-08T21:02,0,2696000
281,1835080,12,98000,0,97.0,2801,2023-04-08T21:02,0,98000
282,2902216,13,584000,700000,99.0,24,2023-04-08T21:02,0,584000
283,3038000,14,74700,83000,96.0,370,2023-04-08T21:02,-14940,59760
284,2112607,15,178000,0,97.0,359,2023-04-08T21:02,0,178000
285,2793965,16,81900,91000,97.0,245,2023-04-08T21:02,-4095,77805
286,2344538,17,119000,0,98.0,6402,2023-04-08T21:02,0,119000
287,2558648,18,119000,0,98.0,1268,2023-04-08T21:02,0,119000
288,2344540,19,96000,0,98.0,9233,2023-04-08T21:02,0,96000
289,3050557,20,2027000,3290000,0.0,0,2023-04-08T21:02,0,2027000
290,3101111,21,143200,179000,96.0,44,2023-04-08T21:02,0,143200
291,2995683,22,1861000,2450000,0.0,0,2023-04-08T21:02,0,1861000
292,342189,23,39500,52000,95.0,15747,2023-04-08T21:02,0,39500
293,2902215,24,223000,400000,96.0,45,2023-04-08T21:02,0,223000
294,2271789,25,71100,79000,97.0,2525,2023-04-08T21:02,0,71100
295,1969488,26,88000,0,98.0,1754,2023-04-08T21:02,0,88000
296,3024801,27,138000,0,100.0,17,2023-04-08T21:02,0,138000
297,3034751,28,64800,72000,97.0,480,2023-04-08T21:02,0,64800
298,2673129,29,96500,129000,96.0,12,2023-04-08T21:02,-19300,77200
299,3011494,30,69900,79000,96.0,244,2023-04-08T21:02,-13980,55920
300,2812154,31,1535000,2290000,100.0,1,2023-04-08T21:02,0,1535000
301,3029926,32,285000,0,99.0,54,2023-04-08T21:02,0,285000
302,2422175,33,137700,162000,99.0,207,2023-04-08T21:02,0,137700
303,1581689,34,75600,89000,97.0,3980,2023-04-08T21:02,-3780,71820
304,2408317,35,145800,162000,96.0,384,2023-04-08T21:02,-14580,131220
305,3082387,36,139000,0,98.0,125,2023-04-08T21:02,-13900,125100
306,1910358,37,89100,99000,98.0,2478,2023-04-08T21:02,0,89100
307,2320927,38,39000,51000,97.0,2146,2023-04-08T21:02,-3900,35100
308,1564343,39,92800,119000,98.0,8098,2023-04-08T21:02,-6496,86304
309,3045584,40,130500,145000,97.0,3775,2023-04-08T21:02,0,130500
310,1528287,41,49000,0,96.0,4605,2023-04-08T21:02,0,49000
311,2066837,42,79000,119000,97.0,6497,2023-04-08T21:02,-7900,71100
312,1264107,43,65000,90000,97.0,6371,2023-04-08T21:02,0,65000
313,1842449,44,84000,99000,97.0,5376,2023-04-08T21:02,0,84000
314,2343665,45,89000,0,97.0,4625,2023-04-08T21:02,0,89000
315,2657250,46,125400,149000,98.0,122,2023-04-08T21:02,0,125400
316,1964770,47,59400,66000,97.0,2495,2023-04-08T21:02,-11880,47520
317,2558602,48,96000,0,98.0,589,2023-04-08T21:02,-4800,91200
318,1247560,49,69900,79000,96.0,4266,2023-04-08T21:02,-6990,62910
319,2754080,50,88000,0,97.0,485,2023-04-08T21:02,0,88000
320,2514819,51,55000,66000,97.0,843,2023-04-08T21:02,-2750,52250
321,2979861,52,1042000,1430000,100.0,6,2023-04-08T21:02,0,1042000
322,276256,53,58500,98000,96.0,14684,2023-04-08T21:02,-5850,52650
323,2630526,54,100000,0,96.0,632,2023-04-08T21:02,0,100000
324,1456515,55,49500,55000,97.0,8736,2023-04-08T21:02,-9900,39600
325,1744101,56,103500,109000,98.0,2932,2023-04-08T21:02,0,103500
326,2325729,57,87200,109000,97.0,799,2023-04-08T21:02,-17440,69760
327,2890575,58,118000,0,95.0,142,2023-04-08T21:02,0,118000
328,3047568,59,119970,129000,96.0,52,2023-04-08T21:02,0,119970
329,3038001,60,74700,83000,97.0,86,2023-04-08T21:02,-14940,59760
330,3034745,61,75600,84000,97.0,169,2023-04-08T21:02,0,75600
331,3070516,62,138000,0,98.0,23,2023-04-08T21:02,0,138000
332,1090160,63,99000,0,97.0,1312,2023-04-08T21:02,0,99000
333,938746,64,80100,89000,95.0,12525,2023-04-08T21:02,0,80100
334,1745100,65,103500,109000,97.0,989,2023-04-08T21:02,0,103500
335,3161077,66,169200,188000,100.0,1,2023-04-08T21:02,0,169200
336,2702033,67,127200,159000,97.0,405,2023-04-08T21:02,0,127200
337,2245910,68,46000,69000,95.0,737,2023-04-08T21:02,-4600,41400
338,3034749,69,64800,72000,97.0,440,2023-04-08T21:02,0,64800
339,2624678,70,145000,0,96.0,130,2023-04-08T21:02,0,145000
340,2117345,71,288000,0,99.0,73,2023-04-08T21:02,0,288000
341,2688604,72,139000,159000,97.0,865,2023-04-08T21:02,-13900,125100
342,2975285,73,55250,65000,98.0,317,2023-04-08T21:02,0,55250
343,2344134,74,89000,0,97.0,1850,2023-04-08T21:02,0,89000
344,2902211,75,390000,600000,100.0,14,2023-04-08T21:02,0,390000
345,2616436,76,199000,0,100.0,15,2023-04-08T21:02,0,199000
346,1597319,77,89100,99000,97.0,592,2023-04-08T21:02,-8910,80190
347,2973716,78,815000,1160000,93.0,6,2023-04-08T21:02,0,815000
348,3130030,79,74700,83000,98.0,14,2023-04-08T21:02,-14940,59760
349,1790465,80,141000,188000,98.0,613,2023-04-08T21:02,-28200,112800
350,3149665,81,88200,98000,100.0,3,2023-04-08T21:02,-8820,79380
351,2914924,82,369000,439000,95.0,9,2023-04-08T21:02,0,369000
352,3029931,83,365000,0,98.0,58,2023-04-08T21:02,0,365000
353,2002697,84,67900,76000,97.0,3476,2023-04-08T21:02,-6790,61110
354,2592796,85,385000,428000,100.0,3,2023-04-08T21:02,0,385000
355,2395671,86,98000,0,97.0,935,2023-04-08T21:02,0,98000
356,1969479,87,88000,0,98.0,1128,2023-04-08T21:02,0,88000
357,2679537,88,145800,162000,95.0,101,2023-04-08T21:02,-14580,131220
358,2580597,89,108600,129000,99.0,66,2023-04-08T21:02,0,108600
359,2869084,90,369000,0,97.0,33,2023-04-08T21:02,0,369000
360,3200836,1,179000,0,0.0,0,2023-04-08T21:02,0,179000
361,3176295,2,139000,0,100.0,1,2023-04-08T21:02,0,139000
362,2545799,3,149000,0,98.0,2117,2023-04-08T21:02,0,149000
363,2785168,4,179000,0,98.0,13,2023-04-08T21:02,0,179000
364,969541,5,69000,0,97.0,29580,2023-04-08T21:02,0,69000
365,1762407,6,260000,0,97.0,3263,2023-04-08T21:02,0,260000
366,186610,7,59900,85000,97.0,16544,2023-04-08T21:02,0,59900
367,1622069,8,119000,0,98.0,5801,2023-04-08T21:02,0,119000
368,810034,9,85500,95000,97.0,45241,2023-04-08T21:02,0,85500
369,2293400,10,129000,0,96.0,988,2023-04-08T21:02,0,129000
370,2638067,11,99000,139000,97.0,3091,2023-04-08T21:02,0,99000
371,311052,12,53100,59000,97.0,41196,2023-04-08T21:02,0,53100
372,2161992,13,55900,95000,98.0,3327,2023-04-08T21:02,0,55900
373,2784035,14,445800,743000,84.0,5,2023-04-08T21:02,0,445800
374,816033,15,57900,89000,96.0,13307,2023-04-08T21:02,0,57900
375,2320478,16,129000,0,97.0,514,2023-04-08T21:02,0,129000
376,2786814,17,149000,0,98.0,187,2023-04-08T21:02,0,149000
377,1990244,18,129000,0,98.0,1081,2023-04-08T21:02,0,129000
378,716244,19,54900,95000,98.0,1211,2023-04-08T21:02,0,54900
379,1622068,20,119000,0,97.0,6648,2023-04-08T21:02,0,119000
380,695334,21,78900,99000,96.0,9391,2023-04-08T21:02,0,78900
381,1762406,22,260000,0,98.0,3332,2023-04-08T21:02,0,260000
382,2849855,23,348500,970000,80.0,1,2023-04-08T21:02,0,348500
383,2233180,24,75900,109000,97.0,14212,2023-04-08T21:02,0,75900
384,181907,25,89900,119000,97.0,7131,2023-04-08T21:02,0,89900
385,490091,26,36900,69000,97.0,988,2023-04-08T21:02,0,36900
386,810033,27,89100,99000,97.0,34257,2023-04-08T21:02,0,89100
387,810032,28,85500,95000,97.0,13757,2023-04-08T21:02,0,85500
388,1493265,29,85500,95000,98.0,4918,2023-04-08T21:02,0,85500
389,577636,30,99900,139000,95.0,31193,2023-04-08T21:02,0,99900
390,3105764,31,139000,0,98.0,81,2023-04-08T21:02,0,139000
391,3186808,32,135000,0,100.0,7,2023-04-08T21:02,0,135000
392,1130307,33,109000,0,97.0,6057,2023-04-08T21:02,0,109000
393,311050,34,53100,59000,97.0,9047,2023-04-08T21:02,0,53100
394,1792640,35,99000,0,98.0,3556,2023-04-08T21:02,0,99000
395,1955217,36,69000,109000,96.0,5191,2023-04-08T21:02,-13800,55200
396,1231944,37,119000,0,97.0,1310,2023-04-08T21:02,0,119000
397,3096431,38,139000,0,99.0,51,2023-04-08T21:02,0,139000
398,3030422,39,139000,0,96.0,850,2023-04-08T21:02,0,139000
399,3091287,40,119000,0,98.0,306,2023-04-08T21:02,0,119000
400,2741233,41,109000,0,97.0,2728,2023-04-08T21:02,0,109000
401,1900420,42,129000,0,96.0,1501,2023-04-08T21:02,0,129000
402,2778805,43,99000,0,97.0,997,2023-04-08T21:02,0,99000
403,490136,44,76000,95000,98.0,2320,2023-04-08T21:02,0,76000
404,311051,45,58500,65000,97.0,19573,2023-04-08T21:02,0,58500
405,3023097,46,230000,0,98.0,99,2023-04-08T21:02,0,230000
406,490135,47,75900,95000,97.0,3279,2023-04-08T21:02,0,75900
407,1469860,48,51900,75000,97.0,6749,2023-04-08T21:02,0,51900
408,2631192,49,98100,109000,98.0,389,2023-04-08T21:02,0,98100
409,1470186,50,49900,75000,97.0,2965,2023-04-08T21:02,0,49900
410,930950,51,39900,85000,95.0,382,2023-04-08T21:02,0,39900
411,2268512,52,109000,0,97.0,458,2023-04-08T21:02,0,109000
412,3172975,53,260000,0,100.0,2,2023-04-08T21:02,0,260000
413,2849903,54,410000,1060000,100.0,10,2023-04-08T21:02,0,410000
414,1744960,55,119900,149000,97.0,8237,2023-04-08T21:02,0,119900
415,3033248,56,109000,0,97.0,649,2023-04-08T21:02,0,109000
416,2229208,57,109000,0,97.0,1610,2023-04-08T21:02,0,109000
417,2856924,58,588000,880000,96.0,13,2023-04-08T21:02,0,588000
418,2827287,59,488000,910000,81.0,11,2023-04-08T21:02,0,488000
419,3079037,60,195000,0,97.0,252,2023-04-08T21:02,0,195000
420,2493214,61,169000,0,98.0,179,2023-04-08T21:02,0,169000
421,2855992,62,159000,0,97.0,566,2023-04-08T21:02,0,159000
422,1493263,63,89100,99000,98.0,4236,2023-04-08T21:02,0,89100
423,957758,64,89000,0,97.0,4497,2023-04-08T21:02,0,89000
424,810031,65,89100,99000,97.0,7867,2023-04-08T21:02,0,89100
425,2839677,66,49900,109000,95.0,350,2023-04-08T21:02,0,49900
426,2233178,67,75900,109000,97.0,4953,2023-04-08T21:02,0,75900
427,2861392,68,124900,139000,97.0,589,2023-04-08T21:02,0,124900
428,2070761,69,329000,0,98.0,364,2023-04-08T21:02,0,329000
429,2899664,70,78900,159000,96.0,125,2023-04-08T21:02,0,78900
430,3115168,71,169000,0,94.0,11,2023-04-08T21:02,0,169000
431,2207771,72,44900,89000,95.0,462,2023-04-08T21:02,0,44900
432,1296778,73,99000,0,98.0,2113,2023-04-08T21:02,0,99000
433,1354129,74,67000,99000,95.0,8715,2023-04-08T21:02,-13400,53600
434,2985946,75,135000,150000,97.0,7,2023-04-08T21:02,0,135000
435,2139107,76,44900,89000,95.0,390,2023-04-08T21:02,0,44900
436,1817778,77,69000,0,97.0,4123,2023-04-08T21:02,0,69000
437,2851292,78,49900,89000,96.0,280,2023-04-08T21:02,0,49900
438,2886128,79,228000,595000,0.0,0,2023-04-08T21:02,0,228000
439,2312772,80,69900,139800,96.0,1389,2023-04-08T21:02,0,69900
440,102620,81,69000,0,97.0,17882,2023-04-08T21:02,0,69000
441,1473136,82,119900,149000,97.0,10785,2023-04-08T21:02,0,119900
442,165988,83,69000,0,96.0,4805,2023-04-08T21:02,0,69000
443,3048675,84,64000,89000,99.0,31,2023-04-08T21:02,-6400,57600
444,2809006,85,847000,1130000,99.0,34,2023-04-08T21:02,0,847000
445,2909716,86,119000,0,96.0,92,2023-04-08T21:02,0,119000
446,2851557,87,272000,915000,100.0,2,2023-04-08T21:02,0,272000
447,2825931,88,54900,79000,97.0,1949,2023-04-08T21:02,0,54900
448,2030626,89,103500,115000,97.0,8053,2023-04-08T21:02,0,103500
449,2440110,90,59900,0,97.0,1060,2023-04-08T21:02,0,59900
450,1092992,1,69000,0,97.0,37862,2023-04-08T21:02,0,69000
451,3124961,2,62100,69000,97.0,96,2023-04-08T21:02,-3105,58995
452,3134606,3,125100,139000,100.0,1,2023-04-08T21:02,-6255,118845
453,1720813,4,149000,0,97.0,451,2023-04-08T21:02,0,149000
454,3134621,5,136800,152000,0.0,0,2023-04-08T21:02,-6840,129960
455,3062046,6,78300,87000,96.0,123,2023-04-08T21:02,-3915,74385
456,3061996,7,88200,98000,98.0,82,2023-04-08T21:02,-4410,83790
457,2736221,8,104500,110000,96.0,257,2023-04-08T21:02,0,104500
458,2091749,9,80100,89000,95.0,6238,2023-04-08T21:02,0,80100
459,1339622,10,42900,59000,97.0,16308,2023-04-08T21:02,0,42900
460,1890398,11,138000,168000,96.0,2728,2023-04-08T21:02,-9660,128340
461,2736110,12,154000,220000,98.0,117,2023-04-08T21:02,0,154000
462,1568047,13,159000,0,95.0,12013,2023-04-08T21:02,0,159000
463,3134563,14,88200,98000,0.0,0,2023-04-08T21:02,-4410,83790
464,2555395,15,212000,600000,0.0,0,2023-04-08T21:02,0,212000
465,3062069,16,71100,79000,98.0,33,2023-04-08T21:02,-3555,67545
466,1720822,17,209000,0,97.0,298,2023-04-08T21:02,0,209000
467,2101924,18,99900,0,96.0,1372,2023-04-08T21:02,0,99900
468,1334438,19,170000,0,96.0,4399,2023-04-08T21:02,0,170000
469,2448938,20,230000,0,96.0,23,2023-04-08T21:02,0,230000
470,2816812,21,119900,0,92.0,1530,2023-04-08T21:02,0,119900
471,2414019,22,319000,980000,100.0,8,2023-04-08T21:02,0,319000
472,2237841,23,195000,0,98.0,62,2023-04-08T21:02,0,195000
473,2902065,24,1178000,1290000,100.0,2,2023-04-08T21:02,0,1178000
474,2433538,25,86700,102000,96.0,2398,2023-04-08T21:02,-6069,80631
475,3161736,26,67900,158000,0.0,0,2023-04-08T21:02,0,67900
476,3075621,27,339000,0,98.0,67,2023-04-08T21:02,0,339000
477,2432733,28,44900,59000,97.0,2821,2023-04-08T21:02,0,44900
478,1952910,29,265500,295000,98.0,1730,2023-04-08T21:02,0,265500
479,1129750,30,69000,0,97.0,3929,2023-04-08T21:02,0,69000
480,2664372,31,65000,0,97.0,1065,2023-04-08T21:02,0,65000
481,2363570,32,39900,55000,97.0,1014,2023-04-08T21:02,0,39900
482,2430426,33,169000,0,98.0,736,2023-04-08T21:02,0,169000
483,595039,34,210000,0,97.0,3516,2023-04-08T21:02,0,210000
484,1439535,35,49000,0,96.0,16320,2023-04-08T21:02,0,49000
485,1562990,36,230000,0,96.0,1277,2023-04-08T21:02,0,230000
486,2621831,37,59800,85000,95.0,718,2023-04-08T21:02,-5980,53820
487,1926895,38,49900,108000,93.0,4172,2023-04-08T21:02,0,49900
488,2880951,39,513000,980000,0.0,0,2023-04-08T21:02,0,513000
489,2114452,40,429900,478000,97.0,522,2023-04-08T21:02,0,429900
490,2143833,41,91800,108000,96.0,2419,2023-04-08T21:02,-6426,85374
491,3124959,42,52200,58000,96.0,39,2023-04-08T21:02,-2610,49590
492,2910086,43,265500,295000,98.0,194,2023-04-08T21:02,0,265500
493,2968825,44,804000,1360000,96.0,5,2023-04-08T21:02,0,804000
494,2305529,45,138000,168000,97.0,91,2023-04-08T21:02,-9660,128340
495,1815709,46,138000,168000,96.0,7133,2023-04-08T21:02,-9660,128340
496,3132539,47,69000,0,100.0,2,2023-04-08T21:02,-6900,62100
497,2379000,48,151500,159000,97.0,112,2023-04-08T21:02,0,151500
498,2664373,49,65000,0,97.0,1020,2023-04-08T21:02,0,65000
499,2816816,50,143890,159900,97.0,1865,2023-04-08T21:02,0,143890
500,2735953,51,207000,230000,98.0,416,2023-04-08T21:02,0,207000
501,2880952,52,490000,1050000,0.0,0,2023-04-08T21:02,0,490000
502,1010925,53,170000,0,96.0,2088,2023-04-08T21:02,0,170000
503,3113466,54,359100,399000,0.0,0,2023-04-08T21:02,0,359100
504,2910082,55,265500,295000,98.0,474,2023-04-08T21:02,0,265500
505,2650879,56,169000,0,100.0,20,2023-04-08T21:02,0,169000
506,2395327,57,149000,0,97.0,543,2023-04-08T21:02,0,149000
507,2440524,58,69000,0,97.0,1553,2023-04-08T21:02,-6900,62100
508,2686298,59,645000,980000,0.0,0,2023-04-08T21:02,0,645000
509,501198,60,129000,139000,95.0,2742,2023-04-08T21:02,0,129000
510,1699941,61,67150,79000,97.0,4859,2023-04-08T21:02,-3358,63792
511,3052437,62,139500,155000,97.0,47,2023-04-08T21:02,-27900,111600
512,2518112,63,89250,105000,96.0,972,2023-04-08T21:02,-6248,83002
513,2306631,64,19900,24900,96.0,2104,2023-04-08T21:02,-1393,18507
514,1903234,65,99000,168000,95.0,979,2023-04-08T21:02,0,99000
515,1021359,66,76000,100000,94.0,5382,2023-04-08T21:02,-5320,70680
516,595040,67,210000,0,95.0,8742,2023-04-08T21:02,0,210000
517,1897197,68,53100,59000,96.0,956,2023-04-08T21:02,0,53100
518,2437045,69,157000,218000,97.0,491,2023-04-08T21:02,-10990,146010
519,3049313,70,57100,64900,97.0,572,2023-04-08T21:02,0,57100
520,2435822,71,94500,99000,97.0,249,2023-04-08T21:02,0,94500
521,451851,72,268000,0,97.0,1951,2023-04-08T21:02,0,268000
522,1010923,73,190000,0,95.0,373,2023-04-08T21:02,0,190000
523,2624538,74,40900,59000,97.0,1470,2023-04-08T21:02,0,40900
524,2210246,75,299000,0,97.0,85,2023-04-08T21:02,0,299000
525,2791587,76,150000,300000,94.0,20,2023-04-08T21:02,0,150000
526,3130686,77,169000,0,0.0,0,2023-04-08T21:02,0,169000
527,3045271,78,73800,82000,98.0,27,2023-04-08T21:02,-3690,70110
528,2340324,79,179100,199000,97.0,185,2023-04-08T21:02,0,179100
529,1724193,80,251900,280000,98.0,1477,2023-04-08T21:02,0,251900
530,2789983,81,64800,81000,97.0,372,2023-04-08T21:02,-3240,61560
531,2434795,82,39900,59000,97.0,1491,2023-04-08T21:02,0,39900
532,3132541,83,69000,0,100.0,15,2023-04-08T21:02,-6900,62100
533,451852,84,268000,0,96.0,373,2023-04-08T21:02,0,268000
534,2852654,85,649500,1450000,100.0,1,2023-04-08T21:02,-30000,619500
535,3045291,86,73800,82000,98.0,26,2023-04-08T21:02,-3690,70110
536,2490287,87,687000,1300000,0.0,0,2023-04-08T21:02,0,687000
537,3097625,88,95000,0,90.0,6,2023-04-08T21:02,0,95000
538,2355318,89,109900,0,96.0,644,2023-04-08T21:02,0,109900
539,2101923,90,99900,0,96.0,614,2023-04-08T21:02,0,99900
540,2929166,1,415000,630000,0.0,0,2023-04-08T21:02,0,415000
541,1822717,2,56050,59000,97.0,4311,2023-04-08T21:02,0,56050
542,1214164,3,36000,0,96.0,24927,2023-04-08T21:02,0,36000
543,2280117,4,35100,39000,97.0,6274,2023-04-08T21:02,0,35100
544,1771137,5,26100,29000,97.0,12513,2023-04-08T21:02,0,26100
545,2134140,6,39000,0,97.0,3517,2023-04-08T21:02,0,39000
546,2287131,7,27750,37000,95.0,1634,2023-04-08T21:02,0,27750
547,2879419,8,46900,55000,98.0,713,2023-04-08T21:02,0,46900
548,3201500,9,49000,0,0.0,0,2023-04-08T21:02,0,49000
549,1022014,10,79000,0,96.0,11437,2023-04-08T21:02,0,79000
550,1214173,11,36000,0,96.0,5563,2023-04-08T21:02,0,36000
551,2356713,12,39000,0,97.0,1456,2023-04-08T21:02,0,39000
552,2879425,13,46900,55000,98.0,291,2023-04-08T21:02,0,46900
553,2286829,14,37000,0,95.0,4954,2023-04-08T21:02,0,37000
554,1214174,15,36000,0,97.0,15027,2023-04-08T21:02,0,36000
555,1771132,16,26100,29000,96.0,5247,2023-04-08T21:02,0,26100
556,1272626,17,36000,0,96.0,14132,2023-04-08T21:02,0,36000
557,2123132,18,39000,0,97.0,6395,2023-04-08T21:02,-3900,35100
558,2864918,19,49000,0,99.0,125,2023-04-08T21:02,0,49000
559,1214317,20,36000,0,97.0,11482,2023-04-08T21:02,0,36000
560,2134158,21,39000,0,97.0,2498,2023-04-08T21:02,0,39000
561,1214109,22,36000,0,97.0,8121,2023-04-08T21:02,0,36000
562,2329375,23,34710,39000,96.0,2088,2023-04-08T21:02,0,34710
563,2859190,24,27750,37000,96.0,427,2023-04-08T21:02,0,27750
564,2953795,25,207450,461000,0.0,0,2023-04-08T21:02,0,207450
565,1452917,26,69000,0,96.0,2415,2023-04-08T21:02,0,69000
566,1524720,27,36000,0,96.0,3379,2023-04-08T21:02,0,36000
567,1920929,28,39000,0,97.0,3968,2023-04-08T21:02,0,39000
568,1925814,29,35100,39000,96.0,1651,2023-04-08T21:02,0,35100
569,2221221,30,35100,39000,96.0,1861,2023-04-08T21:02,0,35100
570,1771133,31,26100,29000,97.0,5697,2023-04-08T21:02,0,26100
571,3201499,32,49000,0,0.0,0,2023-04-08T21:02,0,49000
572,1214106,33,36000,0,96.0,9735,2023-04-08T21:02,0,36000
573,1022013,34,79000,0,96.0,6260,2023-04-08T21:02,0,79000
574,2630072,35,33750,45000,96.0,192,2023-04-08T21:02,0,33750
575,2560668,36,58650,69000,97.0,1249,2023-04-08T21:02,0,58650
576,2384630,37,42000,0,98.0,759,2023-04-08T21:02,0,42000
577,2356711,38,39000,0,98.0,1489,2023-04-08T21:02,0,39000
578,3010891,39,398000,0,0.0,0,2023-04-08T21:02,0,398000
579,1214193,40,39000,0,97.0,15350,2023-04-08T21:02,0,39000
580,2028240,41,39000,0,98.0,3345,2023-04-08T21:02,0,39000
581,1497550,42,29600,37000,95.0,5679,2023-04-08T21:02,0,29600
582,1906772,43,39900,42000,97.0,3065,2023-04-08T21:02,0,39900
583,1855444,44,39900,42000,97.0,3014,2023-04-08T21:02,0,39900
584,3012243,45,29900,39900,98.0,67,2023-04-08T21:02,-2093,27807
585,1335132,46,29000,0,95.0,1105,2023-04-08T21:02,0,29000
586,2089719,47,36000,0,97.0,2408,2023-04-08T21:02,0,36000
587,2879417,48,46900,55000,98.0,201,2023-04-08T21:02,0,46900
588,2356693,49,39000,0,97.0,1523,2023-04-08T21:02,0,39000
589,2358733,50,39000,0,97.0,430,2023-04-08T21:02,0,39000
590,2953794,51,207450,461000,0.0,0,2023-04-08T21:02,0,207450
591,2715553,52,68000,0,95.0,257,2023-04-08T21:02,0,68000
592,2683883,53,69000,0,97.0,123,2023-04-08T21:02,0,69000
593,2707659,54,37800,42000,97.0,520,2023-04-08T21:02,0,37800
594,2687157,55,45000,0,97.0,1038,2023-04-08T21:02,0,45000
595,2716310,56,27750,37000,96.0,163,2023-04-08T21:02,0,27750
596,1214169,57,36000,0,97.0,5324,2023-04-08T21:02,0,36000
597,2107999,58,36000,0,97.0,2670,2023-04-08T21:02,0,36000
598,2591291,59,39200,49000,97.0,1022,2023-04-08T21:02,0,39200
599,2725904,60,332000,630000,0.0,0,2023-04-08T21:02,0,332000
600,2289281,61,29640,38000,96.0,881,2023-04-08T21:02,0,29640
601,2672186,62,20900,30000,96.0,579,2023-04-08T21:02,-2090,18810
602,3099387,63,99000,0,100.0,5,2023-04-08T21:02,0,99000
603,2134287,64,39000,0,98.0,707,2023-04-08T21:02,0,39000
604,2920868,65,52000,0,94.0,108,2023-04-08T21:02,0,52000
605,3201497,66,55000,0,0.0,0,2023-04-08T21:02,0,55000
606,1086824,67,29600,37000,95.0,18624,2023-04-08T21:02,0,29600
607,3092582,68,29400,42000,99.0,31,2023-04-08T21:02,0,29400
608,1907733,69,29900,39000,96.0,3834,2023-04-08T21:02,0,29900
609,2287105,70,38000,0,95.0,1475,2023-04-08T21:02,0,38000
610,3099130,71,54000,0,97.0,22,2023-04-08T21:02,0,54000
611,1632175,72,39000,0,97.0,2709,2023-04-08T21:02,-3900,35100
612,2998516,73,29000,0,96.0,153,2023-04-08T21:02,0,29000
613,3170707,74,36270,39000,0.0,0,2023-04-08T21:02,-10881,25389
614,2810075,75,288500,550000,100.0,2,2023-04-08T21:02,-30000,258500
615,363169,76,17900,26000,95.0,4356,2023-04-08T21:02,0,17900
616,1433907,77,29250,39000,93.0,1495,2023-04-08T21:02,0,29250
617,3012258,78,29900,39900,97.0,36,2023-04-08T21:02,-2093,27807
618,3057129,79,37800,42000,94.0,7,2023-04-08T21:02,-3780,34020
619,2416509,80,79000,0,99.0,51,2023-04-08T21:02,0,79000
620,2424822,81,35100,39000,96.0,1047,2023-04-08T21:02,0,35100
621,1126959,82,29250,39000,91.0,2556,2023-04-08T21:02,0,29250
622,1214171,83,36000,0,97.0,1709,2023-04-08T21:02,0,36000
623,3039055,84,43000,0,93.0,38,2023-04-08T21:02,0,43000
624,2974979,85,39000,0,96.0,26,2023-04-08T21:02,0,39000
625,1760824,86,49700,59000,97.0,305,2023-04-08T21:02,0,49700
626,2650965,87,46900,53000,98.0,370,2023-04-08T21:02,0,46900
627,2622521,88,98800,104000,97.0,79,2023-04-08T21:02,0,98800
628,3163662,89,44100,49000,100.0,6,2023-04-08T21:02,0,44100
629,3203657,90,68000,0,0.0,0,2023-04-08T21:02,0,68000
630,2457512,1,237300,339000,98.0,37,2023-04-08T21:02,0,237300
631,2798634,2,910000,1470000,0.0,0,2023-04-08T21:02,-30000,880000
632,3190599,3,292000,418000,0.0,0,2023-04-08T21:02,-29200,262800
633,2781047,4,495500,991000,96.0,6,2023-04-08T21:02,-49550,445950
634,2781049,5,642500,1285000,100.0,3,2023-04-08T21:02,-30000,612500
635,3106487,6,148000,0,99.0,26,2023-04-08T21:02,0,148000
636,1103286,7,94000,0,94.0,781,2023-04-08T21:02,0,94000
637,3059119,8,179000,0,92.0,20,2023-04-08T21:02,-32220,146780
638,3050856,9,189000,0,93.0,12,2023-04-08T21:02,0,189000
639,3196932,10,151050,159000,0.0,0,2023-04-08T21:02,-7553,143497
640,3196917,11,151050,159000,0.0,0,2023-04-08T21:02,-7553,143497
641,2605850,12,94000,0,97.0,167,2023-04-08T21:02,0,94000
642,2457508,13,153300,219000,97.0,31,2023-04-08T21:02,0,153300
643,3173662,14,160200,178000,0.0,0,2023-04-08T21:02,0,160200
644,2982348,15,306900,341000,0.0,0,2023-04-08T21:02,0,306900
645,3196981,16,122550,129000,0.0,0,2023-04-08T21:02,-6128,116422
646,3098628,17,235690,259000,0.0,0,2023-04-08T21:02,-35354,200336
647,3145635,18,249000,0,0.0,0,2023-04-08T21:02,-12450,236550
648,1455772,19,94000,0,96.0,209,2023-04-08T21:02,0,94000
649,3145607,20,249000,0,0.0,0,2023-04-08T21:02,-12450,236550
650,3146600,21,235600,248000,0.0,0,2023-04-08T21:02,0,235600
651,2478652,22,57800,68000,94.0,329,2023-04-08T21:02,0,57800
652,3070522,23,218000,0,0.0,0,2023-04-08T21:02,0,218000
653,2377832,24,195000,0,95.0,174,2023-04-08T21:02,0,195000
654,1341924,25,98800,152000,96.0,81,2023-04-08T21:02,0,98800
655,2714524,26,41400,69000,95.0,400,2023-04-08T21:02,-8280,33120
656,3147411,27,218000,0,0.0,0,2023-04-08T21:02,0,218000
657,3147461,28,218000,0,0.0,0,2023-04-08T21:02,0,218000
658,3050173,29,166600,238000,100.0,1,2023-04-08T21:02,0,166600
659,3206551,30,106400,112000,0.0,0,2023-04-08T21:02,0,106400
660,3073259,31,196200,218000,100.0,5,2023-04-08T21:02,-29430,166770
661,1489950,32,198000,0,95.0,27,2023-04-08T21:02,0,198000
662,3053223,33,179000,0,100.0,4,2023-04-08T21:02,0,179000
663,2621108,34,192000,240000,100.0,3,2023-04-08T21:02,0,192000
664,3111732,35,67200,84000,100.0,3,2023-04-08T21:02,-3360,63840
665,3146756,36,188100,209000,0.0,0,2023-04-08T21:02,-28215,159885
666,3171882,37,149000,0,100.0,2,2023-04-08T21:02,0,149000
667,3050535,38,179000,0,0.0,0,2023-04-08T21:02,0,179000
668,3138205,39,139500,155000,0.0,0,2023-04-08T21:02,-6975,132525
669,3030948,40,68000,0,99.0,35,2023-04-08T21:02,-3400,64600
670,1579103,41,126400,158000,96.0,99,2023-04-08T21:02,0,126400
671,3206552,42,106400,112000,0.0,0,2023-04-08T21:02,0,106400
672,3085850,43,128000,0,0.0,0,2023-04-08T21:02,0,128000
673,2786207,44,167300,239000,0.0,0,2023-04-08T21:02,-8365,158935
674,3174230,45,161100,179000,0.0,0,2023-04-08T21:02,-24165,136935
675,3135234,46,80100,89000,88.0,5,2023-04-08T21:02,-12015,68085
676,2799321,47,159600,228000,0.0,0,2023-04-08T21:02,0,159600
677,2407246,48,167300,239000,0.0,0,2023-04-08T21:02,-8365,158935
678,2585187,49,148000,0,95.0,12,2023-04-08T21:02,0,148000
679,2620217,50,159600,228000,97.0,7,2023-04-08T21:02,0,159600
680,3111357,51,158000,0,0.0,0,2023-04-08T21:02,0,158000
681,3203937,52,159000,0,0.0,0,2023-04-08T21:02,0,159000
682,3100428,53,149000,0,0.0,0,2023-04-08T21:02,0,149000
683,3196948,54,122550,129000,0.0,0,2023-04-08T21:02,-6128,116422
684,3181379,55,149000,0,0.0,0,2023-04-08T21:02,0,149000
685,1739376,56,139000,0,100.0,2,2023-04-08T21:02,0,139000
686,1156787,57,116000,145000,94.0,85,2023-04-08T21:02,0,116000
687,2489894,58,142200,158000,98.0,104,2023-04-08T21:02,0,142200
688,3152277,59,119000,178000,0.0,0,2023-04-08T21:02,0,119000
689,2773865,60,124000,177000,94.0,19,2023-04-08T21:02,0,124000
690,3084760,61,119000,0,100.0,1,2023-04-08T21:02,0,119000
691,1779568,62,57600,64000,95.0,291,2023-04-08T21:02,0,57600
692,3105864,63,129000,0,0.0,0,2023-04-08T21:02,-12900,116100
693,1485817,64,129000,0,0.0,0,2023-04-08T21:02,0,129000
694,1955908,65,55800,93000,91.0,68,2023-04-08T21:02,0,55800
695,3171848,66,119000,0,0.0,0,2023-04-08T21:02,0,119000
696,3121891,67,109000,119000,0.0,0,2023-04-08T21:02,0,109000
697,3031171,68,68000,0,98.0,52,2023-04-08T21:02,-3400,64600
698,2391959,69,112800,188000,100.0,2,2023-04-08T21:02,0,112800
699,1603082,70,108800,128000,96.0,11,2023-04-08T21:02,0,108800
700,2544365,71,63200,79000,0.0,0,2023-04-08T21:02,-3160,60040
701,2306207,72,19880,28000,93.0,511,2023-04-08T21:02,0,19880
702,2482650,73,111200,139000,0.0,0,2023-04-08T21:02,0,111200
703,2512635,74,35400,59000,96.0,206,2023-04-08T21:02,0,35400
704,1537416,75,57800,68000,90.0,132,2023-04-08T21:02,0,57800
705,2393504,76,94000,0,99.0,49,2023-04-08T21:02,0,94000
706,3198137,77,79800,0,0.0,0,2023-04-08T21:02,0,79800
707,2848613,78,86900,0,100.0,3,2023-04-08T21:02,0,86900
708,2776650,79,98000,0,94.0,10,2023-04-08T21:02,0,98000
709,3130645,80,119000,0,0.0,0,2023-04-08T21:02,0,119000
710,2714533,81,41400,69000,93.0,232,2023-04-08T21:02,-8280,33120
711,2567006,82,1563000,2906000,0.0,0,2023-04-08T21:02,0,1563000
712,3155024,83,50700,78000,0.0,0,2023-04-08T21:02,-10140,40560
713,2731616,84,47400,79000,95.0,80,2023-04-08T21:02,0,47400
714,2396014,85,83000,0,96.0,41,2023-04-08T21:02,0,83000
715,2714317,86,48600,54000,93.0,70,2023-04-08T21:02,-9720,38880
716,2612357,87,69000,139000,96.0,15,2023-04-08T21:02,0,69000
717,2836338,88,79230,139000,93.0,38,2023-04-08T21:02,0,79230
718,2051097,89,94500,105000,100.0,6,2023-04-08T21:02,0,94500
719,1586290,90,94000,0,96.0,26,2023-04-08T21:02,0,94000
720,2713339,1,141000,470000,100.0,1,2023-04-08T21:02,0,141000
721,3051039,2,95200,119000,100.0,26,2023-04-08T21:02,0,95200
722,2378594,3,88200,98000,95.0,126,2023-04-08T21:02,0,88200
723,2978105,4,49900,0,0.0,0,2023-04-08T21:02,-4990,44910
724,3031104,5,55200,69000,98.0,60,2023-04-08T21:02,0,55200
725,2496634,6,358000,0,100.0,2,2023-04-08T21:02,-42960,315040
726,3081767,7,169000,0,85.0,4,2023-04-08T21:02,0,169000
727,3073254,8,160200,178000,92.0,8,2023-04-08T21:02,-24030,136170
728,2551400,9,39900,0,93.0,137,2023-04-08T21:02,0,39900
729,2978106,10,49900,0,0.0,0,2023-04-08T21:02,-4990,44910
730,3118976,11,318000,0,0.0,0,2023-04-08T21:02,-38160,279840
731,2749471,12,192600,417000,0.0,0,2023-04-08T21:02,-30000,162600
732,3183520,13,133200,148000,0.0,0,2023-04-08T21:02,0,133200
733,3118977,14,318000,0,0.0,0,2023-04-08T21:02,-38160,279840
734,3190568,15,278000,398000,0.0,0,2023-04-08T21:02,-27800,250200
735,3088704,16,270000,0,0.0,0,2023-04-08T21:02,-27000,243000
736,2391576,17,33640,58000,96.0,308,2023-04-08T21:02,-6728,26912
737,2864414,18,69300,99000,94.0,86,2023-04-08T21:02,0,69300
738,3190557,19,250000,358000,0.0,0,2023-04-08T21:02,-25000,225000
739,3122267,20,124200,138000,0.0,0,2023-04-08T21:02,-18630,105570
740,2551401,21,37900,0,94.0,310,2023-04-08T21:02,0,37900
741,2836351,22,35280,72000,96.0,457,2023-04-08T21:02,0,35280
742,2969304,23,239000,0,0.0,0,2023-04-08T21:02,-43020,195980
743,2416846,24,54000,67900,92.0,92,2023-04-08T21:02,-8100,45900
744,3144374,25,71100,79000,100.0,3,2023-04-08T21:02,0,71100
745,2686263,26,205000,0,0.0,0,2023-04-08T21:02,0,205000
746,2377804,27,188100,198000,93.0,37,2023-04-08T21:02,-22572,165528
747,3070528,28,168000,0,93.0,3,2023-04-08T21:02,0,168000
748,2830788,29,139000,0,96.0,26,2023-04-08T21:02,0,139000
749,2854586,30,198000,0,100.0,2,2023-04-08T21:02,-35640,162360
750,3206525,31,84550,89000,0.0,0,2023-04-08T21:02,0,84550
751,3123863,32,160200,178000,0.0,0,2023-04-08T21:02,-24030,136170
752,3125460,33,171000,0,80.0,2,2023-04-08T21:02,-17100,153900
753,3206323,34,186000,0,0.0,0,2023-04-08T21:02,-33480,152520
754,3071323,35,189000,0,0.0,0,2023-04-08T21:02,0,189000
755,3070530,36,168000,0,0.0,0,2023-04-08T21:02,0,168000
756,2551407,37,37900,0,97.0,166,2023-04-08T21:02,0,37900
757,2377814,38,188100,198000,97.0,74,2023-04-08T21:02,-22572,165528
758,2771725,39,166600,238000,95.0,14,2023-04-08T21:02,-16660,149940
759,3142895,40,89100,99000,0.0,0,2023-04-08T21:02,0,89100
760,3089308,41,169000,0,0.0,0,2023-04-08T21:02,0,169000
761,3051036,42,95200,119000,100.0,7,2023-04-08T21:02,0,95200
762,3124643,43,178200,198000,0.0,0,2023-04-08T21:02,-26730,151470
763,3193136,44,141550,149000,0.0,0,2023-04-08T21:02,-7078,134472
764,3074719,45,89000,0,88.0,5,2023-04-08T21:02,0,89000
765,2867750,46,135000,0,97.0,41,2023-04-08T21:02,0,135000
766,3149629,47,125100,139000,0.0,0,2023-04-08T21:02,-18765,106335
767,3170471,48,139000,0,0.0,0,2023-04-08T21:02,0,139000
768,3006062,49,168000,0,100.0,3,2023-04-08T21:02,0,168000
769,3125331,50,169000,0,0.0,0,2023-04-08T21:02,0,169000
770,3098355,51,161100,179000,0.0,0,2023-04-08T21:02,-24165,136935
771,3133721,52,146000,154000,100.0,1,2023-04-08T21:02,-29200,116800
772,2738716,53,151200,168000,94.0,28,2023-04-08T21:02,0,151200
773,3125453,54,55200,89900,95.0,4,2023-04-08T21:02,-2760,52440
774,2830762,55,139000,0,99.0,46,2023-04-08T21:02,0,139000
775,3066950,56,55500,74000,100.0,4,2023-04-08T21:02,0,55500
776,3120581,57,152100,169000,100.0,1,2023-04-08T21:02,-22815,129285
777,3183517,58,133200,148000,0.0,0,2023-04-08T21:02,0,133200
778,3206524,59,131100,138000,0.0,0,2023-04-08T21:02,0,131100
779,3056185,60,160000,0,0.0,0,2023-04-08T21:02,0,160000
780,1944554,61,36900,0,96.0,537,2023-04-08T21:02,-3690,33210
781,2448900,62,43900,0,95.0,97,2023-04-08T21:02,0,43900
782,3133720,63,146000,154000,0.0,0,2023-04-08T21:02,-29200,116800
783,3120598,64,152100,169000,100.0,1,2023-04-08T21:02,-22815,129285
784,3120257,65,149000,0,100.0,1,2023-04-08T21:02,0,149000
785,2533486,66,35200,44000,96.0,72,2023-04-08T21:02,-3520,31680
786,3142894,67,80100,89000,100.0,1,2023-04-08T21:02,0,80100
787,3154653,68,143100,159000,0.0,0,2023-04-08T21:02,-21465,121635
788,2390975,69,34160,56000,93.0,90,2023-04-08T21:02,-6832,27328
789,3073229,70,151200,168000,100.0,1,2023-04-08T21:02,-22680,128520
790,2448899,71,43900,0,95.0,137,2023-04-08T21:02,0,43900
791,3120591,72,143100,159000,80.0,2,2023-04-08T21:02,-21465,121635
792,2362484,73,80100,89000,96.0,204,2023-04-08T21:02,0,80100
793,2843974,74,185000,391500,0.0,0,2023-04-08T21:02,0,185000
794,2316503,75,51200,64000,94.0,321,2023-04-08T21:02,0,51200
795,3149612,76,125100,139000,0.0,0,2023-04-08T21:02,-18765,106335
796,3133860,77,93000,98000,100.0,3,2023-04-08T21:02,-18600,74400
797,1807814,78,65550,69000,97.0,248,2023-04-08T21:02,0,65550
798,2925522,79,58500,65000,95.0,103,2023-04-08T21:02,0,58500
799,3101514,80,122500,129000,100.0,4,2023-04-08T21:02,-24500,98000
800,1645760,81,43900,0,96.0,342,2023-04-08T21:02,0,43900
801,2781746,82,138000,0,100.0,1,2023-04-08T21:02,0,138000
802,3206527,83,112100,118000,0.0,0,2023-04-08T21:02,0,112100
803,3120202,84,110400,138000,100.0,1,2023-04-08T21:02,-13248,97152
804,3121771,85,129000,0,100.0,1,2023-04-08T21:02,-23220,105780
805,2413525,86,129000,0,94.0,37,2023-04-08T21:02,-23220,105780
806,2836289,87,39530,59000,95.0,207,2023-04-08T21:02,-7906,31624
807,3062946,88,124200,138000,100.0,5,2023-04-08T21:02,0,124200
808,2849847,89,176000,388000,0.0,0,2023-04-08T21:02,0,176000
809,3154861,90,36400,56000,95.0,4,2023-04-08T21:02,-7280,29120
810,991339,1,17890,19900,97.0,52748,2023-04-08T21:02,0,17890
811,1986031,2,24990,27900,97.0,10578,2023-04-08T21:02,0,24990
812,1094748,3,19900,0,97.0,19128,2023-04-08T21:02,0,19900
813,998051,4,12900,24000,97.0,162762,2023-04-08T21:02,0,12900
814,991340,5,17890,19900,97.0,30848,2023-04-08T21:02,0,17890
815,763821,6,13900,22000,96.0,31378,2023-04-08T21:02,0,13900
816,1477845,7,15400,22000,96.0,9664,2023-04-08T21:02,0,15400
817,792919,8,15190,16900,96.0,17921,2023-04-08T21:02,0,15190
818,2959925,9,22000,27500,99.0,103,2023-04-08T21:02,-2200,19800
819,1996702,10,23690,27900,97.0,1929,2023-04-08T21:02,0,23690
820,1094835,11,14290,15900,97.0,6208,2023-04-08T21:02,0,14290
821,991570,12,12900,20000,97.0,19055,2023-04-08T21:02,0,12900
822,1996705,13,23690,27900,98.0,2686,2023-04-08T21:02,0,23690
823,2297277,14,19900,22000,95.0,289,2023-04-08T21:02,0,19900
824,746158,15,18290,22900,96.0,20521,2023-04-08T21:02,0,18290
825,734085,16,10900,19800,96.0,64784,2023-04-08T21:02,0,10900
826,1821485,17,30000,0,96.0,1261,2023-04-08T21:02,0,30000
827,1986029,18,27900,0,97.0,3939,2023-04-08T21:02,0,27900
828,3033249,19,15000,0,96.0,204,2023-04-08T21:02,-750,14250
829,746154,20,17900,0,96.0,5170,2023-04-08T21:02,0,17900
830,1342874,21,16900,33000,97.0,12777,2023-04-08T21:02,0,16900
831,1729576,22,9500,13900,97.0,16080,2023-04-08T21:02,0,9500
832,746159,23,18290,22900,95.0,28729,2023-04-08T21:02,0,18290
833,1443937,24,24000,0,97.0,7943,2023-04-08T21:02,0,24000
834,479245,25,15400,22000,93.0,5397,2023-04-08T21:02,0,15400
835,1986030,26,23690,27900,97.0,1670,2023-04-08T21:02,0,23690
836,1094749,27,19900,0,96.0,4955,2023-04-08T21:02,0,19900
837,991341,28,16890,19900,96.0,10213,2023-04-08T21:02,0,16890
838,792920,29,15190,16900,96.0,9669,2023-04-08T21:02,0,15190
839,1094834,30,21490,23900,96.0,2457,2023-04-08T21:02,0,21490
840,2832613,31,11200,33000,97.0,676,2023-04-08T21:02,0,11200
841,1346009,32,9900,12000,97.0,6695,2023-04-08T21:02,0,9900
842,2960555,33,19000,0,93.0,103,2023-04-08T21:02,0,19000
843,2845854,34,13200,18900,97.0,217,2023-04-08T21:02,0,13200
844,3118094,35,28800,32000,95.0,4,2023-04-08T21:02,0,28800
845,792921,36,15190,16900,95.0,7808,2023-04-08T21:02,0,15190
846,1260384,37,19900,0,95.0,1801,2023-04-08T21:02,0,19900
847,3009680,38,12590,14900,98.0,110,2023-04-08T21:02,0,12590
848,746155,39,17900,0,95.0,1261,2023-04-08T21:02,0,17900
849,1094750,40,16890,19900,97.0,3557,2023-04-08T21:02,0,16890
850,1094836,41,14290,15900,97.0,1313,2023-04-08T21:02,0,14290
851,1358721,42,14200,22000,96.0,1127,2023-04-08T21:02,0,14200
852,2347097,43,14900,24000,98.0,1558,2023-04-08T21:02,0,14900
853,2649999,44,12800,16000,94.0,80,2023-04-08T21:02,0,12800
854,2011852,45,21490,23900,97.0,1308,2023-04-08T21:02,0,21490
855,1348077,46,10900,16500,97.0,1859,2023-04-08T21:02,0,10900
856,1996704,47,22290,27900,97.0,707,2023-04-08T21:02,0,22290
857,2011850,48,21490,23900,98.0,864,2023-04-08T21:02,0,21490
858,2812523,49,20000,25000,97.0,100,2023-04-08T21:02,0,20000
859,1062063,50,9490,15900,96.0,2148,2023-04-08T21:02,0,9490
860,1094837,51,13490,15900,96.0,1753,2023-04-08T21:02,0,13490
861,1360044,52,19900,0,97.0,1755,2023-04-08T21:02,0,19900
862,2821589,53,19690,21900,96.0,36,2023-04-08T21:02,0,19690
863,1547562,54,15400,22000,95.0,1367,2023-04-08T21:02,0,15400
864,752821,55,9900,0,94.0,23767,2023-04-08T21:02,0,9900
865,746161,56,18290,22900,95.0,7734,2023-04-08T21:02,0,18290
866,1475031,57,16900,27000,96.0,1726,2023-04-08T21:02,0,16900
867,1475055,58,16200,22000,96.0,1174,2023-04-08T21:02,0,16200
868,2973095,59,20000,25000,98.0,28,2023-04-08T21:02,-2000,18000
869,1286366,60,11900,24000,97.0,9796,2023-04-08T21:02,0,11900
870,2990345,61,27900,0,98.0,48,2023-04-08T21:02,0,27900
871,1341061,62,13300,26500,97.0,2622,2023-04-08T21:02,0,13300
872,2433154,63,30000,0,95.0,88,2023-04-08T21:02,0,30000
873,2738095,64,19900,0,96.0,104,2023-04-08T21:02,0,19900
874,2467197,65,30000,0,95.0,134,2023-04-08T21:02,0,30000
875,3125337,66,56000,0,86.0,3,2023-04-08T21:02,-5600,50400
876,2821598,67,19390,22900,97.0,145,2023-04-08T21:02,0,19390
877,2546992,68,9500,13000,96.0,380,2023-04-08T21:02,0,9500
878,922009,69,14800,23800,96.0,508,2023-04-08T21:02,0,14800
879,1647682,70,14900,23600,97.0,948,2023-04-08T21:02,0,14900
880,2929635,71,15900,27000,97.0,517,2023-04-08T21:02,0,15900
881,2835702,72,13900,15800,97.0,67,2023-04-08T21:02,-1390,12510
882,2738096,73,19900,0,97.0,99,2023-04-08T21:02,0,19900
883,2821588,74,19690,21900,97.0,53,2023-04-08T21:02,0,19690
884,2584266,75,9900,12000,98.0,404,2023-04-08T21:02,0,9900
885,2912120,76,25000,0,95.0,19,2023-04-08T21:02,0,25000
886,2618262,77,39200,49000,97.0,27,2023-04-08T21:02,-1960,37240
887,2711708,78,26100,29000,98.0,69,2023-04-08T21:02,-5220,20880
888,472686,79,9500,14800,94.0,720,2023-04-08T21:02,0,9500
889,3065854,80,21250,25000,95.0,18,2023-04-08T21:02,0,21250
890,1477846,81,15400,22000,96.0,2674,2023-04-08T21:02,0,15400
891,1094833,82,20590,22900,95.0,2082,2023-04-08T21:02,0,20590
892,3147709,83,49000,0,0.0,0,2023-04-08T21:02,0,49000
893,2773510,84,24700,27500,100.0,41,2023-04-08T21:02,0,24700
894,2937242,85,13900,18500,98.0,34,2023-04-08T21:02,0,13900
895,746157,86,17900,0,95.0,987,2023-04-08T21:02,0,17900
896,2376087,87,17100,18000,96.0,347,2023-04-08T21:02,0,17100
897,1102050,88,20590,22900,96.0,839,2023-04-08T21:02,0,20590
898,3135857,89,25000,0,0.0,0,2023-04-08T21:02,0,25000
899,2667536,90,25000,31000,95.0,8,2023-04-08T21:02,-3750,21250
